"DayIndex";"Date";"Hour";"Price";"Windinfeed";"Load";"ResLoad"
1;"01.01.2006";1;"32.1";4730;47823;43093
1;"01.01.2006";2;"30.1";4783;47823;43040
1;"01.01.2006";3;"27.9";4435;43444;39009
1;"01.01.2006";4;"21.7";4352;41432;37080
1;"01.01.2006";5;"8.2";4025;40508;36483
1;"01.01.2006";6;"1.1";3776;38865;35089
1;"01.01.2006";7;0;3500;35817;32317
1;"01.01.2006";8;0;3485;35555;32070
1;"01.01.2006";9;0;3351;36263;32912
1;"01.01.2006";10;"0.6";3049;38569;35520
1;"01.01.2006";11;7;2634;41078;38444
1;"01.01.2006";12;"27.1";2139;44206;42067
1;"01.01.2006";13;"28.3";1742;45108;43366
1;"01.01.2006";14;"27.2";1353;44216;42863
1;"01.01.2006";15;"26.7";986;43870;42884
1;"01.01.2006";16;"27.4";847;43922;43075
1;"01.01.2006";17;"31.9";780;46880;46100
1;"01.01.2006";18;"44.1";706;51673;50967
1;"01.01.2006";19;"44.5";643;52934;52291
1;"01.01.2006";20;45;596;52123;51527
1;"01.01.2006";21;"35.6";510;50288;49778
1;"01.01.2006";22;"34.9";404;50209;49805
1;"01.01.2006";23;"41.9";364;51361;50997
1;"01.01.2006";24;"32.4";306;48050;47744
2;"02.01.2006";1;"34.3";259;44990;44731
2;"02.01.2006";2;32;294;43319;43025
2;"02.01.2006";3;"28.2";278;42327;42049
2;"02.01.2006";4;"25.1";305;41921;41616
2;"02.01.2006";5;"26.9";403;42697;42294
2;"02.01.2006";6;"29.1";371;44602;44231
2;"02.01.2006";7;"36.7";398;48751;48353
2;"02.01.2006";8;"49.9";396;55363;54967
2;"02.01.2006";9;"53.5";409;59779;59370
2;"02.01.2006";10;"67.6";430;62054;61624
2;"02.01.2006";11;"76.2";479;63978;63499
2;"02.01.2006";12;"80.4";454;65766;65312
2;"02.01.2006";13;"88.6";486;65965;65479
2;"02.01.2006";14;90;555;65178;64623
2;"02.01.2006";15;76;552;64080;63528
2;"02.01.2006";16;"67.7";471;63669;63198
2;"02.01.2006";17;"69.1";480;64871;64391
2;"02.01.2006";18;"89.9";449;67751;67302
2;"02.01.2006";19;"88.7";430;65494;65064
2;"02.01.2006";20;"73.7";385;65395;65010
2;"02.01.2006";21;60;431;61546;61115
2;"02.01.2006";22;"49.5";425;59784;59359
2;"02.01.2006";23;"49.6";423;59486;59063
2;"02.01.2006";24;"39.3";379;54916;54537
3;"03.01.2006";1;"38.1";328;51829;51501
3;"03.01.2006";2;"35.9";404;49637;49233
3;"03.01.2006";3;"32.6";420;48680;48260
3;"03.01.2006";4;"32.3";410;48487;48077
3;"03.01.2006";5;"32.4";400;48975;48575
3;"03.01.2006";6;"31.5";353;49969;49616
3;"03.01.2006";7;"27.9";362;53502;53140
3;"03.01.2006";8;"57.6";377;59379;59002
3;"03.01.2006";9;"73.5";374;62764;62390
3;"03.01.2006";10;"87.4";394;64240;63846
3;"03.01.2006";11;"90.1";280;65613;65333
3;"03.01.2006";12;"78.1";230;66924;66694
3;"03.01.2006";13;"77.3";236;66890;66654
3;"03.01.2006";14;"74.1";246;65817;65571
3;"03.01.2006";15;73;265;64798;64533
3;"03.01.2006";16;"70.2";278;64358;64080
3;"03.01.2006";17;"69.6";282;65730;65448
3;"03.01.2006";18;"92.6";266;68930;68664
3;"03.01.2006";19;91;348;68462;68114
3;"03.01.2006";20;"84.3";341;66270;65929
3;"03.01.2006";21;"68.1";374;62782;62408
3;"03.01.2006";22;"60.3";358;60977;60619
3;"03.01.2006";23;"60.8";285;60251;59966
3;"03.01.2006";24;"41.1";213;56239;56026
4;"04.01.2006";1;"39.1";187;52859;52672
4;"04.01.2006";2;"35.3";132;50821;50689
4;"04.01.2006";3;35;104;49464;49360
4;"04.01.2006";4;"32.6";107;49190;49083
4;"04.01.2006";5;"32.6";148;49824;49676
4;"04.01.2006";6;37;172;50895;50723
4;"04.01.2006";7;"36.1";188;54410;54222
4;"04.01.2006";8;"49.9";262;60466;60204
4;"04.01.2006";9;69;412;63306;62894
4;"04.01.2006";10;"82.4";532;64676;64144
4;"04.01.2006";11;"86.6";610;66058;65448
4;"04.01.2006";12;95;670;67349;66679
4;"04.01.2006";13;"92.1";698;66987;66289
4;"04.01.2006";14;"85.1";767;66125;65358
4;"04.01.2006";15;82;852;65285;64433
4;"04.01.2006";16;"82.4";1024;64981;63957
4;"04.01.2006";17;81;1286;66346;65060
4;"04.01.2006";18;96;1351;69083;67732
4;"04.01.2006";19;"92.9";1527;69137;67610
4;"04.01.2006";20;"86.6";1591;66793;65202
4;"04.01.2006";21;"68.1";1586;63158;61572
4;"04.01.2006";22;"51.4";1706;61444;59738
4;"04.01.2006";23;"53.7";1720;60893;59173
4;"04.01.2006";24;"44.5";1785;56914;55129
5;"05.01.2006";1;"49.1";2038;53612;51574
5;"05.01.2006";2;"45.3";2168;51393;49225
5;"05.01.2006";3;"40.4";2304;50016;47712
5;"05.01.2006";4;"43.5";2603;49765;47162
5;"05.01.2006";5;"44.2";2934;50219;47285
5;"05.01.2006";6;"43.1";3315;51527;48212
5;"05.01.2006";7;"34.5";3553;54993;51440
5;"05.01.2006";8;"49.1";3958;60864;56906
5;"05.01.2006";9;"66.6";4447;64401;59954
5;"05.01.2006";10;82;4722;65923;61201
5;"05.01.2006";11;"82.4";5054;67398;62344
5;"05.01.2006";12;"82.5";5237;68884;63647
5;"05.01.2006";13;"86.5";5396;68619;63223
5;"05.01.2006";14;"82.5";5716;67762;62046
5;"05.01.2006";15;"79.6";5977;66904;60927
5;"05.01.2006";16;78;6078;66747;60669
5;"05.01.2006";17;"86.7";5985;67559;61574
5;"05.01.2006";18;"97.3";6237;69811;63574
5;"05.01.2006";19;"90.7";6365;69336;62971
5;"05.01.2006";20;"85.2";6119;67075;60956
5;"05.01.2006";21;65;5904;63324;57420
5;"05.01.2006";22;"47.9";5631;61663;56032
5;"05.01.2006";23;"55.2";5443;61344;55901
5;"05.01.2006";24;"44.1";5283;57473;52190
6;"06.01.2006";1;"42.8";5180;54131;48951
6;"06.01.2006";2;"42.7";5024;51659;46635
6;"06.01.2006";3;"38.7";5098;50412;45314
6;"06.01.2006";4;"32.6";5193;50107;44914
6;"06.01.2006";5;"27.4";5314;49880;44566
6;"06.01.2006";6;"32.1";5182;50353;45171
6;"06.01.2006";7;"11.1";4834;52352;47518
6;"06.01.2006";8;"31.1";4868;56965;52097
6;"06.01.2006";9;"34.2";4880;60110;55230
6;"06.01.2006";10;"40.7";4761;61737;56976
6;"06.01.2006";11;"47.1";4732;63287;58555
6;"06.01.2006";12;53;4390;64673;60283
6;"06.01.2006";13;"48.5";4039;64465;60426
6;"06.01.2006";14;"42.2";3999;62666;58667
6;"06.01.2006";15;"37.3";3848;61315;57467
6;"06.01.2006";16;"32.9";3808;61032;57224
6;"06.01.2006";17;"40.2";3972;62412;58440
6;"06.01.2006";18;"62.3";3841;65597;61756
6;"06.01.2006";19;"63.1";3680;65062;61382
6;"06.01.2006";20;"49.6";3629;62910;59281
6;"06.01.2006";21;"53.3";3444;59585;56141
6;"06.01.2006";22;43;3582;58447;54865
6;"06.01.2006";23;"47.9";3511;59013;55502
6;"06.01.2006";24;"36.1";3277;56004;52727
7;"07.01.2006";1;41;2908;53384;50476
7;"07.01.2006";2;"37.3";2834;51189;48355
7;"07.01.2006";3;"39.5";2869;49771;46902
7;"07.01.2006";4;"35.4";2686;48814;46128
7;"07.01.2006";5;35;2596;48256;45660
7;"07.01.2006";6;"36.9";2415;46955;44540
7;"07.01.2006";7;"32.8";2376;45335;42959
7;"07.01.2006";8;"40.7";2292;47965;45673
7;"07.01.2006";9;"45.2";2247;52069;49822
7;"07.01.2006";10;53;2206;55080;52874
7;"07.01.2006";11;65;2244;57131;54887
7;"07.01.2006";12;"64.6";2208;58541;56333
7;"07.01.2006";13;"65.1";2166;58389;56223
7;"07.01.2006";14;"53.3";2239;57023;54784
7;"07.01.2006";15;"43.2";2470;55879;53409
7;"07.01.2006";16;"40.9";2499;56123;53624
7;"07.01.2006";17;"53.1";2561;58006;55445
7;"07.01.2006";18;"79.9";2783;61971;59188
7;"07.01.2006";19;"69.9";2925;61729;58804
7;"07.01.2006";20;"54.7";2677;59280;56603
7;"07.01.2006";21;"44.1";2617;55797;53180
7;"07.01.2006";22;"43.3";2661;54680;52019
7;"07.01.2006";23;60;2678;55846;53168
7;"07.01.2006";24;"42.8";2791;53643;50852
8;"08.01.2006";1;41;2758;50815;48057
8;"08.01.2006";2;36;2751;48068;45317
8;"08.01.2006";3;"35.1";2824;46263;43439
8;"08.01.2006";4;"32.9";2867;45595;42728
8;"08.01.2006";5;"32.6";2870;44661;41791
8;"08.01.2006";6;"30.6";2709;42921;40212
8;"08.01.2006";7;"23.7";2543;40004;37461
8;"08.01.2006";8;"27.4";2511;40877;38366
8;"08.01.2006";9;"27.1";2466;43548;41082
8;"08.01.2006";10;"32.5";2329;47348;45019
8;"08.01.2006";11;"36.9";2208;50425;48217
8;"08.01.2006";12;"49.4";2108;53722;51614
8;"08.01.2006";13;"45.1";1844;53304;51460
8;"08.01.2006";14;"36.9";1591;51111;49520
8;"08.01.2006";15;"34.6";1655;49698;48043
8;"08.01.2006";16;34;1772;49188;47416
8;"08.01.2006";17;"35.3";1896;51425;49529
8;"08.01.2006";18;45;2358;57200;54842
8;"08.01.2006";19;"47.9";2264;59011;56747
8;"08.01.2006";20;50;2361;58199;55838
8;"08.01.2006";21;"49.2";2350;55698;53348
8;"08.01.2006";22;"46.9";2360;55811;53451
8;"08.01.2006";23;"55.5";2221;57368;55147
8;"08.01.2006";24;45;2027;54557;52530
9;"09.01.2006";1;"37.9";1911;51983;50072
9;"09.01.2006";2;"34.5";1792;50296;48504
9;"09.01.2006";3;"33.9";1711;49342;47631
9;"09.01.2006";4;"31.3";1669;49050;47381
9;"09.01.2006";5;31;1584;49604;48020
9;"09.01.2006";6;"34.5";1708;52273;50565
9;"09.01.2006";7;41;1751;57473;55722
9;"09.01.2006";8;"90.3";1685;66508;64823
9;"09.01.2006";9;"101.9";1681;69029;67349
9;"09.01.2006";10;"100.1";1672;68969;67297
9;"09.01.2006";11;"100.1";1337;69553;68216
9;"09.01.2006";12;"104.4";976;70171;69195
9;"09.01.2006";13;101;751;69877;69126
9;"09.01.2006";14;110;662;69598;68936
9;"09.01.2006";15;"100.9";597;68650;68053
9;"09.01.2006";16;"96.3";666;68137;67471
9;"09.01.2006";17;97;942;68817;67875
9;"09.01.2006";18;"150.1";1406;72790;71384
9;"09.01.2006";19;147;1802;72365;70563
9;"09.01.2006";20;"107.5";1994;70682;68688
9;"09.01.2006";21;"92.6";2059;67282;65223
9;"09.01.2006";22;"68.1";2076;65125;63049
9;"09.01.2006";23;"66.4";2196;64316;62120
9;"09.01.2006";24;"52.4";2273;60893;58620
10;"10.01.2006";1;"48.3";2134;58523;56389
10;"10.01.2006";2;"42.1";2211;57376;55165
10;"10.01.2006";3;"42.1";2621;56567;53946
10;"10.01.2006";4;"35.4";2671;55771;53100
10;"10.01.2006";5;"35.4";2480;55879;53399
10;"10.01.2006";6;44;2384;56020;53636
10;"10.01.2006";7;"64.9";2610;61632;59022
10;"10.01.2006";8;"120.1";2872;68683;65811
10;"10.01.2006";9;"111.9";3154;70489;67335
10;"10.01.2006";10;"146.9";3229;69878;66649
10;"10.01.2006";11;"138.9";2954;70404;67450
10;"10.01.2006";12;120;2560;71033;68473
10;"10.01.2006";13;97;2528;70751;68223
10;"10.01.2006";14;"96.9";2730;70261;67531
10;"10.01.2006";15;95;2856;69471;66615
10;"10.01.2006";16;93;3108;68884;65776
10;"10.01.2006";17;"95.8";3514;69466;65952
10;"10.01.2006";18;"122.8";4129;73225;69096
10;"10.01.2006";19;"105.2";4628;72929;68301
10;"10.01.2006";20;96;5109;70986;65877
10;"10.01.2006";21;90;5366;67225;61859
10;"10.01.2006";22;"66.3";5923;65453;59530
10;"10.01.2006";23;"65.1";6529;64891;58362
10;"10.01.2006";24;"47.8";6876;61245;54369
11;"11.01.2006";1;"45.9";6605;58392;51787
11;"11.01.2006";2;"41.2";6388;56713;50325
11;"11.01.2006";3;"39.8";6579;55458;48879
11;"11.01.2006";4;"33.1";6652;54832;48180
11;"11.01.2006";5;"37.2";6542;55110;48568
11;"11.01.2006";6;"41.2";6908;56961;50053
11;"11.01.2006";7;"42.1";6633;62184;55551
11;"11.01.2006";8;"86.6";7086;69025;61939
11;"11.01.2006";9;"95.1";7767;70903;63136
11;"11.01.2006";10;93;7800;70365;62565
11;"11.01.2006";11;93;7703;70814;63111
11;"11.01.2006";12;93;7433;71364;63931
11;"11.01.2006";13;"92.8";7377;70875;63498
11;"11.01.2006";14;93;7290;70344;63054
11;"11.01.2006";15;"92.7";7144;69729;62585
11;"11.01.2006";16;"90.1";7248;69409;62161
11;"11.01.2006";17;"90.1";7543;70701;63158
11;"11.01.2006";18;"95.2";6998;74262;67264
11;"11.01.2006";19;"98.5";6586;73501;66915
11;"11.01.2006";20;"93.8";5457;71085;65628
11;"11.01.2006";21;"82.5";5084;67118;62034
11;"11.01.2006";22;"70.8";4544;65233;60689
11;"11.01.2006";23;"68.1";4167;64196;60029
11;"11.01.2006";24;"51.2";3501;59993;56492
12;"12.01.2006";1;"40.4";2722;57001;54279
12;"12.01.2006";2;52;2239;54934;52695
12;"12.01.2006";3;"40.1";1857;53541;51684
12;"12.01.2006";4;"35.7";1380;53067;51687
12;"12.01.2006";5;"35.3";1063;53492;52429
12;"12.01.2006";6;"39.5";806;55126;54320
12;"12.01.2006";7;"58.8";658;60726;60068
12;"12.01.2006";8;110;539;67752;67213
12;"12.01.2006";9;"126.6";464;70029;69565
12;"12.01.2006";10;"120.1";461;69734;69273
12;"12.01.2006";11;120;494;70332;69838
12;"12.01.2006";12;"115.7";575;71067;70492
12;"12.01.2006";13;"105.1";698;70494;69796
12;"12.01.2006";14;"104.1";680;70016;69336
12;"12.01.2006";15;"92.8";661;69271;68610
12;"12.01.2006";16;90;697;68649;67952
12;"12.01.2006";17;94;717;69322;68605
12;"12.01.2006";18;"262.4";955;72563;71608
12;"12.01.2006";19;"158.1";1016;72136;71120
12;"12.01.2006";20;120;1038;70231;69193
12;"12.01.2006";21;"94.2";1580;66672;65092
12;"12.01.2006";22;"72.1";1916;64643;62727
12;"12.01.2006";23;69;1930;63672;61742
12;"12.01.2006";24;"50.1";1922;59577;57655
13;"13.01.2006";1;"45.5";1965;56234;54269
13;"13.01.2006";2;"46.1";1986;54669;52683
13;"13.01.2006";3;"38.8";2141;53601;51460
13;"13.01.2006";4;37;2184;53106;50922
13;"13.01.2006";5;"37.3";2304;53766;51462
13;"13.01.2006";6;"37.9";2247;55346;53099
13;"13.01.2006";7;"51.7";2281;60940;58659
13;"13.01.2006";8;"88.2";2306;67878;65572
13;"13.01.2006";9;"103.2";2695;70179;67484
13;"13.01.2006";10;"108.2";2840;70016;67176
13;"13.01.2006";11;"100.6";2754;70674;67920
13;"13.01.2006";12;94;2758;70803;68045
13;"13.01.2006";13;"88.1";3025;70154;67129
13;"13.01.2006";14;"75.1";3010;68727;65717
13;"13.01.2006";15;"66.4";3098;67281;64183
13;"13.01.2006";16;"63.1";3456;66457;63001
13;"13.01.2006";17;"64.9";3841;67659;63818
13;"13.01.2006";18;"88.2";3932;72132;68200
13;"13.01.2006";19;"88.2";4037;71849;67812
13;"13.01.2006";20;"82.4";3960;69042;65082
13;"13.01.2006";21;"67.8";4007;64744;60737
13;"13.01.2006";22;"51.9";3703;63176;59473
13;"13.01.2006";23;"45.2";3767;63396;59629
13;"13.01.2006";24;"38.2";3570;60863;57293
14;"14.01.2006";1;"57.9";3178;58544;55366
14;"14.01.2006";2;"42.1";3070;56780;53710
14;"14.01.2006";3;38;2855;55523;52668
14;"14.01.2006";4;"37.4";2583;54112;51529
14;"14.01.2006";5;"35.9";2520;52934;50414
14;"14.01.2006";6;"30.2";2639;51216;48577
14;"14.01.2006";7;"27.8";2729;49198;46469
14;"14.01.2006";8;"39.5";2643;51779;49136
14;"14.01.2006";9;"48.1";2576;55118;52542
14;"14.01.2006";10;"55.8";2435;57858;55423
14;"14.01.2006";11;65;1951;59637;57686
14;"14.01.2006";12;70;1572;60472;58900
14;"14.01.2006";13;"66.8";1220;59843;58623
14;"14.01.2006";14;53;992;57838;56846
14;"14.01.2006";15;46;882;56117;55235
14;"14.01.2006";16;"41.7";891;55618;54727
14;"14.01.2006";17;"44.8";1363;56848;55485
14;"14.01.2006";18;"69.9";2071;62758;60687
14;"14.01.2006";19;85;2339;63510;61171
14;"14.01.2006";20;"76.5";2399;61141;58742
14;"14.01.2006";21;53;2408;57637;55229
14;"14.01.2006";22;"45.3";2437;56597;54160
14;"14.01.2006";23;"55.8";2333;58090;55757
14;"14.01.2006";24;"41.9";2222;55881;53659
15;"15.01.2006";1;"47.1";2123;53440;51317
15;"15.01.2006";2;"40.7";2315;51353;49038
15;"15.01.2006";3;"36.4";2400;50067;47667
15;"15.01.2006";4;"34.9";2472;49013;46541
15;"15.01.2006";5;"34.8";2658;48102;45444
15;"15.01.2006";6;32;2528;46038;43510
15;"15.01.2006";7;"21.9";2341;42470;40129
15;"15.01.2006";8;"26.3";2333;43319;40986
15;"15.01.2006";9;"30.5";2399;46616;44217
15;"15.01.2006";10;"35.9";2600;50455;47855
15;"15.01.2006";11;"39.6";2560;53355;50795
15;"15.01.2006";12;"44.9";2314;56000;53686
15;"15.01.2006";13;"43.9";2070;54976;52906
15;"15.01.2006";14;"37.1";2008;52784;50776
15;"15.01.2006";15;"33.1";2044;51228;49184
15;"15.01.2006";16;"29.9";2490;50602;48112
15;"15.01.2006";17;"34.5";3149;52076;48927
15;"15.01.2006";18;"52.8";3930;58460;54530
15;"15.01.2006";19;67;4294;60698;56404
15;"15.01.2006";20;"62.7";4164;59731;55567
15;"15.01.2006";21;"40.9";3924;57711;53787
15;"15.01.2006";22;"41.2";3692;57750;54058
15;"15.01.2006";23;"45.5";3456;59727;56271
15;"15.01.2006";24;"42.9";3321;57482;54161
16;"16.01.2006";1;"42.4";3281;55462;52181
16;"16.01.2006";2;"38.6";3200;54198;50998
16;"16.01.2006";3;"37.7";3318;52872;49554
16;"16.01.2006";4;"35.7";3225;51882;48657
16;"16.01.2006";5;"35.3";3029;52067;49038
16;"16.01.2006";6;"37.9";2962;54993;52031
16;"16.01.2006";7;"43.3";2857;61382;58525
16;"16.01.2006";8;"94.1";3008;68988;65980
16;"16.01.2006";9;"92.9";3004;70782;67778
16;"16.01.2006";10;"92.8";3097;70579;67482
16;"16.01.2006";11;"92.9";2443;70854;68411
16;"16.01.2006";12;93;1729;70963;69234
16;"16.01.2006";13;"90.3";1495;70635;69140
16;"16.01.2006";14;"90.1";1360;70194;68834
16;"16.01.2006";15;90;1499;69364;67865
16;"16.01.2006";16;"86.2";1863;68518;66655
16;"16.01.2006";17;90;2462;68274;65812
16;"16.01.2006";18;"93.9";3442;73090;69648
16;"16.01.2006";19;"94.1";4102;73515;69413
16;"16.01.2006";20;93;4619;71415;66796
16;"16.01.2006";21;"82.8";4871;68137;63266
16;"16.01.2006";22;"61.8";4858;65873;61015
16;"16.01.2006";23;"62.4";4862;65062;60200
16;"16.01.2006";24;49;4994;61461;56467
17;"17.01.2006";1;"43.5";4939;58640;53701
17;"17.01.2006";2;"35.8";5094;57136;52042
17;"17.01.2006";3;"34.4";5076;55883;50807
17;"17.01.2006";4;"32.3";5273;55199;49926
17;"17.01.2006";5;"33.3";5348;55369;50021
17;"17.01.2006";6;"33.3";5505;57191;51686
17;"17.01.2006";7;"42.9";5431;62659;57228
17;"17.01.2006";8;"74.3";5391;69861;64470
17;"17.01.2006";9;"86.2";5580;71750;66170
17;"17.01.2006";10;91;5226;71830;66604
17;"17.01.2006";11;"90.8";5041;72505;67464
17;"17.01.2006";12;"87.3";5073;73261;68188
17;"17.01.2006";13;"79.4";5295;72945;67650
17;"17.01.2006";14;"79.7";5270;72364;67094
17;"17.01.2006";15;"82.6";5363;71928;66565
17;"17.01.2006";16;"79.6";5379;71694;66315
17;"17.01.2006";17;"82.5";5181;71736;66555
17;"17.01.2006";18;91;4931;74611;69680
17;"17.01.2006";19;"92.3";4962;74040;69078
17;"17.01.2006";20;"85.1";4967;71763;66796
17;"17.01.2006";21;71;4697;67807;63110
17;"17.01.2006";22;"57.8";5078;65824;60746
17;"17.01.2006";23;"50.2";5192;64234;59042
17;"17.01.2006";24;"43.5";5262;59951;54689
18;"18.01.2006";1;41;5579;56762;51183
18;"18.01.2006";2;"33.4";5748;54922;49174
18;"18.01.2006";3;"35.6";5508;53690;48182
18;"18.01.2006";4;"38.2";5702;53535;47833
18;"18.01.2006";5;"34.9";5701;54712;49011
18;"18.01.2006";6;"38.4";5827;56915;51088
18;"18.01.2006";7;"49.5";6283;62686;56403
18;"18.01.2006";8;78;6370;69322;62952
18;"18.01.2006";9;"88.4";6050;71029;64979
18;"18.01.2006";10;"86.3";5416;70669;65253
18;"18.01.2006";11;"88.4";4410;71503;67093
18;"18.01.2006";12;"90.1";3891;72536;68645
18;"18.01.2006";13;85;3534;71628;68094
18;"18.01.2006";14;85;3436;71081;67645
18;"18.01.2006";15;84;3209;70395;67186
18;"18.01.2006";16;"80.8";3062;69831;66769
18;"18.01.2006";17;"84.5";2704;69647;66943
18;"18.01.2006";18;"102.1";2294;73000;70706
18;"18.01.2006";19;"97.2";1945;73145;71200
18;"18.01.2006";20;"91.1";1543;70824;69281
18;"18.01.2006";21;"83.9";1186;66901;65715
18;"18.01.2006";22;"68.1";1087;65054;63967
18;"18.01.2006";23;"61.6";918;63689;62771
18;"18.01.2006";24;"52.3";705;59799;59094
19;"19.01.2006";1;"47.8";444;56471;56027
19;"19.01.2006";2;"44.8";359;55079;54720
19;"19.01.2006";3;"41.7";322;54167;53845
19;"19.01.2006";4;"33.5";359;53879;53520
19;"19.01.2006";5;"33.6";480;54474;53994
19;"19.01.2006";6;"38.2";534;56059;55525
19;"19.01.2006";7;"47.8";589;61441;60852
19;"19.01.2006";8;"80.8";786;68450;67664
19;"19.01.2006";9;89;981;70127;69146
19;"19.01.2006";10;"88.9";1239;69535;68296
19;"19.01.2006";11;89;1284;70160;68876
19;"19.01.2006";12;"90.2";1266;70900;69634
19;"19.01.2006";13;"87.3";1299;70204;68905
19;"19.01.2006";14;"83.4";1518;69809;68291
19;"19.01.2006";15;"75.5";1869;69361;67492
19;"19.01.2006";16;"75.9";2238;68744;66506
19;"19.01.2006";17;"79.8";2590;68714;66124
19;"19.01.2006";18;89;2966;72615;69649
19;"19.01.2006";19;"88.7";3119;73013;69894
19;"19.01.2006";20;"85.2";3258;70881;67623
19;"19.01.2006";21;"68.5";3229;66842;63613
19;"19.01.2006";22;59;3313;64411;61098
19;"19.01.2006";23;"49.1";3224;63733;60509
19;"19.01.2006";24;"41.9";3383;59865;56482
20;"20.01.2006";1;47;3576;55827;52251
20;"20.01.2006";2;"43.1";3547;54134;50587
20;"20.01.2006";3;"36.1";4045;53218;49173
20;"20.01.2006";4;"37.5";4306;52750;48444
20;"20.01.2006";5;"38.2";4408;53250;48842
20;"20.01.2006";6;"38.3";4416;55246;50830
20;"20.01.2006";7;"46.5";4346;61120;56774
20;"20.01.2006";8;"84.8";4261;68225;63964
20;"20.01.2006";9;"87.1";4261;70518;66257
20;"20.01.2006";10;"84.7";3947;70103;66156
20;"20.01.2006";11;"85.3";4300;71179;66879
20;"20.01.2006";12;84;4957;72009;67052
20;"20.01.2006";13;79;5501;70971;65470
20;"20.01.2006";14;"78.2";5884;69452;63568
20;"20.01.2006";15;"65.7";5687;68096;62409
20;"20.01.2006";16;"62.5";5959;67289;61330
20;"20.01.2006";17;"59.2";6401;67797;61396
20;"20.01.2006";18;"76.9";6616;71366;64750
20;"20.01.2006";19;"82.6";6621;71186;64565
20;"20.01.2006";20;"61.3";6602;68354;61752
20;"20.01.2006";21;55;6624;64330;57706
20;"20.01.2006";22;"46.8";6694;62694;56000
20;"20.01.2006";23;46;6711;62658;55947
20;"20.01.2006";24;"37.3";6919;58997;52078
21;"21.01.2006";1;"38.6";7108;55662;48554
21;"21.01.2006";2;"31.5";7172;53171;45999
21;"21.01.2006";3;"37.1";7589;51979;44390
21;"21.01.2006";4;"28.5";8135;51398;43263
21;"21.01.2006";5;28;7899;51245;43346
21;"21.01.2006";6;"23.2";7681;49679;41998
21;"21.01.2006";7;"4.4";7634;48471;40837
21;"21.01.2006";8;"28.5";7400;51982;44582
21;"21.01.2006";9;"38.4";6993;55722;48729
21;"21.01.2006";10;"43.9";6272;58462;52190
21;"21.01.2006";11;"48.6";5946;60227;54281
21;"21.01.2006";12;"52.9";5846;61434;55588
21;"21.01.2006";13;"48.2";6010;60470;54460
21;"21.01.2006";14;"45.2";5836;58661;52825
21;"21.01.2006";15;43;5160;57230;52070
21;"21.01.2006";16;"41.9";4483;56431;51948
21;"21.01.2006";17;"45.7";3796;57284;53488
21;"21.01.2006";18;"58.2";3462;61878;58416
21;"21.01.2006";19;"67.2";3815;62456;58641
21;"21.01.2006";20;60;4224;60868;56644
21;"21.01.2006";21;"46.4";4551;58336;53785
21;"21.01.2006";22;"44.6";4519;57527;53008
21;"21.01.2006";23;"45.8";4494;57049;52555
21;"21.01.2006";24;"39.6";3894;54569;50675
22;"22.01.2006";1;"49.9";3509;51659;48150
22;"22.01.2006";2;39;3287;49437;46150
22;"22.01.2006";3;"36.1";3082;47976;44894
22;"22.01.2006";4;"35.3";2712;47039;44327
22;"22.01.2006";5;"35.3";2385;46697;44312
22;"22.01.2006";6;"33.2";2204;44887;42683
22;"22.01.2006";7;"23.4";1885;41694;39809
22;"22.01.2006";8;28;1750;42850;41100
22;"22.01.2006";9;"31.3";1357;45748;44391
22;"22.01.2006";10;"39.9";1115;49565;48450
22;"22.01.2006";11;"42.2";1102;53051;51949
22;"22.01.2006";12;"46.6";1159;56057;54898
22;"22.01.2006";13;"44.8";1267;55343;54076
22;"22.01.2006";14;"41.8";1163;53291;52128
22;"22.01.2006";15;38;1081;51715;50634
22;"22.01.2006";16;"33.2";1008;51055;50047
22;"22.01.2006";17;"34.8";1120;51724;50604
22;"22.01.2006";18;"49.5";1290;56974;55684
22;"22.01.2006";19;"68.1";1579;59535;57956
22;"22.01.2006";20;71;1780;58877;57097
22;"22.01.2006";21;60;1827;56611;54784
22;"22.01.2006";22;"48.5";1952;56619;54667
22;"22.01.2006";23;"56.9";1893;59304;57411
22;"22.01.2006";24;"48.7";1779;57239;55460
23;"23.01.2006";1;"42.2";1751;54823;53072
23;"23.01.2006";2;"39.7";1680;53797;52117
23;"23.01.2006";3;"38.6";1600;52935;51335
23;"23.01.2006";4;"37.1";1460;51962;50502
23;"23.01.2006";5;"37.6";1411;51961;50550
23;"23.01.2006";6;"40.8";1409;54562;53153
23;"23.01.2006";7;"49.4";1518;61313;59795
23;"23.01.2006";8;"89.9";1626;68150;66524
23;"23.01.2006";9;95;1745;70131;68386
23;"23.01.2006";10;"93.9";1770;69931;68161
23;"23.01.2006";11;94;1620;70574;68954
23;"23.01.2006";12;91;1483;71190;69707
23;"23.01.2006";13;"90.1";1323;70705;69382
23;"23.01.2006";14;95;1346;70464;69118
23;"23.01.2006";15;90;1352;69544;68192
23;"23.01.2006";16;89;1366;68679;67313
23;"23.01.2006";17;"88.5";1462;68049;66587
23;"23.01.2006";18;"93.6";1899;72610;70711
23;"23.01.2006";19;"94.9";2405;73838;71433
23;"23.01.2006";20;90;2681;72169;69488
23;"23.01.2006";21;"82.5";2781;68908;66127
23;"23.01.2006";22;"66.3";2529;66732;64203
23;"23.01.2006";23;"65.8";2553;66707;64154
23;"23.01.2006";24;52;2441;63624;61183
24;"24.01.2006";1;"53.1";2248;61156;58908
24;"24.01.2006";2;"55.2";2212;59789;57577
24;"24.01.2006";3;"48.2";2263;57968;55705
24;"24.01.2006";4;"44.1";2155;56617;54462
24;"24.01.2006";5;"38.3";2044;56322;54278
24;"24.01.2006";6;49;2165;57976;55811
24;"24.01.2006";7;"54.6";2136;63302;61166
24;"24.01.2006";8;98;2264;69829;67565
24;"24.01.2006";9;150;2137;71080;68943
24;"24.01.2006";10;131;2002;70507;68505
24;"24.01.2006";11;"125.9";1432;71095;69663
24;"24.01.2006";12;"128.9";1072;71458;70386
24;"24.01.2006";13;"103.6";932;70855;69923
24;"24.01.2006";14;"96.4";844;70431;69587
24;"24.01.2006";15;"95.1";806;69674;68868
24;"24.01.2006";16;"91.1";1025;69004;67979
24;"24.01.2006";17;89;1548;68765;67217
24;"24.01.2006";18;"99.3";2215;73373;71158
24;"24.01.2006";19;"98.4";2552;74295;71743
24;"24.01.2006";20;"90.1";2839;72864;70025
24;"24.01.2006";21;"91.2";2861;69337;66476
24;"24.01.2006";22;"76.9";2796;67352;64556
24;"24.01.2006";23;"69.6";2693;67025;64332
24;"24.01.2006";24;"54.1";2511;63627;61116
25;"25.01.2006";1;"55.3";2507;60707;58200
25;"25.01.2006";2;"53.9";2509;58792;56283
25;"25.01.2006";3;"46.4";2648;57385;54737
25;"25.01.2006";4;"43.4";3005;56534;53529
25;"25.01.2006";5;"45.2";3271;56656;53385
25;"25.01.2006";6;45;3313;58151;54838
25;"25.01.2006";7;"57.9";3351;63584;60233
25;"25.01.2006";8;"106.2";3363;70476;67113
25;"25.01.2006";9;"100.1";3303;72075;68772
25;"25.01.2006";10;105;3228;71808;68580
25;"25.01.2006";11;"118.1";3434;72618;69184
25;"25.01.2006";12;110;3085;73233;70148
25;"25.01.2006";13;"92.7";2847;73041;70194
25;"25.01.2006";14;"90.3";2747;72327;69580
25;"25.01.2006";15;"94.9";2572;71527;68955
25;"25.01.2006";16;"91.1";2906;70749;67843
25;"25.01.2006";17;"88.8";3220;70631;67411
25;"25.01.2006";18;"119.5";3521;73973;70452
25;"25.01.2006";19;"122.8";3725;74232;70507
25;"25.01.2006";20;"112.3";4018;72158;68140
25;"25.01.2006";21;85;4036;68702;64666
25;"25.01.2006";22;72;4633;66655;62022
25;"25.01.2006";23;"59.9";4949;65995;61046
25;"25.01.2006";24;"48.5";4534;62344;57810
26;"26.01.2006";1;"50.2";4393;59666;55273
26;"26.01.2006";2;45;4230;57826;53596
26;"26.01.2006";3;"40.8";4373;56697;52324
26;"26.01.2006";4;"41.1";3913;56011;52098
26;"26.01.2006";5;"40.6";3740;56168;52428
26;"26.01.2006";6;"48.5";4088;57609;53521
26;"26.01.2006";7;"57.6";4129;62782;58653
26;"26.01.2006";8;"90.5";3880;69361;65481
26;"26.01.2006";9;"114.8";3863;71284;67421
26;"26.01.2006";10;"116.7";3845;71315;67470
26;"26.01.2006";11;"117.8";3595;71572;67977
26;"26.01.2006";12;"119.4";3429;72472;69043
26;"26.01.2006";13;"93.6";3203;72145;68942
26;"26.01.2006";14;"92.7";2937;71426;68489
26;"26.01.2006";15;93;2630;70727;68097
26;"26.01.2006";16;"92.6";2445;69963;67518
26;"26.01.2006";17;"92.9";2578;68986;66408
26;"26.01.2006";18;"134.2";2586;72798;70212
26;"26.01.2006";19;"699.9";2421;73799;71378
26;"26.01.2006";20;"101.6";2360;72320;69960
26;"26.01.2006";21;"96.3";2186;69013;66827
26;"26.01.2006";22;81;1953;67000;65047
26;"26.01.2006";23;"75.8";1719;66376;64657
26;"26.01.2006";24;"61.4";1672;63230;61558
27;"27.01.2006";1;"53.4";1412;60793;59381
27;"27.01.2006";2;"51.4";1170;59272;58102
27;"27.01.2006";3;"45.9";1130;57996;56866
27;"27.01.2006";4;"43.9";1037;56825;55788
27;"27.01.2006";5;"43.9";816;56575;55759
27;"27.01.2006";6;"45.1";835;57859;57024
27;"27.01.2006";7;"63.4";751;62832;62081
27;"27.01.2006";8;"94.3";625;69610;68985
27;"27.01.2006";9;"299.9";622;71149;70527
27;"27.01.2006";10;300;612;70958;70346
27;"27.01.2006";11;"298.4";489;71237;70748
27;"27.01.2006";12;"200.1";498;71738;71240
27;"27.01.2006";13;"101.3";571;71330;70759
27;"27.01.2006";14;"100.9";736;69877;69141
27;"27.01.2006";15;91;804;68334;67530
27;"27.01.2006";16;"93.5";813;67428;66615
27;"27.01.2006";17;"90.5";813;67009;66196
27;"27.01.2006";18;"149.9";1120;71360;70240
27;"27.01.2006";19;150;1504;72689;71185
27;"27.01.2006";20;"103.9";1747;70302;68555
27;"27.01.2006";21;90;1874;66843;64969
27;"27.01.2006";22;"76.9";1979;64977;62998
27;"27.01.2006";23;"63.7";1924;65691;63767
27;"27.01.2006";24;"52.3";1867;63141;61274
28;"28.01.2006";1;"66.2";1697;61033;59336
28;"28.01.2006";2;"64.4";1616;58903;57287
28;"28.01.2006";3;"56.9";1648;56838;55190
28;"28.01.2006";4;"54.1";1590;55160;53570
28;"28.01.2006";5;"49.9";1596;53816;52220
28;"28.01.2006";6;"45.4";1614;51995;50381
28;"28.01.2006";7;"40.7";1635;49539;47904
28;"28.01.2006";8;"46.6";1625;52270;50645
28;"28.01.2006";9;52;1765;55770;54005
28;"28.01.2006";10;"83.4";1630;58737;57107
28;"28.01.2006";11;"89.1";1395;60352;58957
28;"28.01.2006";12;"87.1";1078;61157;60079
28;"28.01.2006";13;"79.7";1060;59894;58834
28;"28.01.2006";14;"66.4";1060;58004;56944
28;"28.01.2006";15;"59.9";1007;56167;55160
28;"28.01.2006";16;"56.1";1034;55702;54668
28;"28.01.2006";17;"58.6";1104;56004;54900
28;"28.01.2006";18;76;1463;61561;60098
28;"28.01.2006";19;90;1739;64034;62295
28;"28.01.2006";20;"77.9";1804;61722;59918
28;"28.01.2006";21;"53.4";1866;58021;56155
28;"28.01.2006";22;"44.1";1720;56896;55176
28;"28.01.2006";23;"55.1";1685;58704;57019
28;"28.01.2006";24;"47.2";1575;56834;55259
29;"29.01.2006";1;"49.4";1403;54950;53547
29;"29.01.2006";2;"41.6";1323;52723;51400
29;"29.01.2006";3;"40.5";1368;51140;49772
29;"29.01.2006";4;"39.9";1382;49673;48291
29;"29.01.2006";5;"39.2";1439;48587;47148
29;"29.01.2006";6;"38.3";1364;46390;45026
29;"29.01.2006";7;25;1384;42936;41552
29;"29.01.2006";8;"28.8";1381;44122;42741
29;"29.01.2006";9;"35.4";1185;47093;45908
29;"29.01.2006";10;40;1180;50550;49370
29;"29.01.2006";11;"43.3";940;53056;52116
29;"29.01.2006";12;50;822;55359;54537
29;"29.01.2006";13;"47.1";716;53893;53177
29;"29.01.2006";14;"42.5";707;51361;50654
29;"29.01.2006";15;39;759;49652;48893
29;"29.01.2006";16;"36.2";806;48948;48142
29;"29.01.2006";17;39;857;49690;48833
29;"29.01.2006";18;"51.6";967;55201;54234
29;"29.01.2006";19;"65.1";1021;59406;58385
29;"29.01.2006";20;"58.1";968;58939;57971
29;"29.01.2006";21;"48.3";982;56888;55906
29;"29.01.2006";22;"45.9";953;56687;55734
29;"29.01.2006";23;"59.7";808;58519;57711
29;"29.01.2006";24;"44.9";765;56542;55777
30;"30.01.2006";1;"41.4";857;54860;54003
30;"30.01.2006";2;40;738;53272;52534
30;"30.01.2006";3;"38.6";753;52268;51515
30;"30.01.2006";4;"37.2";943;51832;50889
30;"30.01.2006";5;"36.5";1005;52459;51454
30;"30.01.2006";6;"39.9";1100;54800;53700
30;"30.01.2006";7;"47.6";1112;61058;59946
30;"30.01.2006";8;"96.4";1073;68066;66993
30;"30.01.2006";9;100;1174;70054;68880
30;"30.01.2006";10;"97.9";1101;70030;68929
30;"30.01.2006";11;"100.1";898;70205;69307
30;"30.01.2006";12;"103.5";767;70911;70144
30;"30.01.2006";13;95;1042;70461;69419
30;"30.01.2006";14;"95.2";1335;69944;68609
30;"30.01.2006";15;"91.1";1508;69100;67592
30;"30.01.2006";16;88;1763;68371;66608
30;"30.01.2006";17;"82.6";1843;67674;65831
30;"30.01.2006";18;"94.5";2133;71147;69014
30;"30.01.2006";19;"99.9";2202;73155;70953
30;"30.01.2006";20;"92.9";2279;71548;69269
30;"30.01.2006";21;90;2353;68136;65783
30;"30.01.2006";22;"72.1";2114;65951;63837
30;"30.01.2006";23;"65.1";2112;64868;62756
30;"30.01.2006";24;"52.3";2009;60961;58952
31;"31.01.2006";1;"54.1";2010;58451;56441
31;"31.01.2006";2;60;2039;56616;54577
31;"31.01.2006";3;"55.1";2189;55494;53305
31;"31.01.2006";4;"45.1";2315;54877;52562
31;"31.01.2006";5;"38.1";2423;55501;53078
31;"31.01.2006";6;50;2400;57107;54707
31;"31.01.2006";7;"59.4";2317;62319;60002
31;"31.01.2006";8;"92.5";2057;69417;67360
31;"31.01.2006";9;93;1879;70802;68923
31;"31.01.2006";10;"106.6";1732;70624;68892
31;"31.01.2006";11;"101.8";1638;71182;69544
31;"31.01.2006";12;108;1454;71682;70228
31;"31.01.2006";13;"94.3";1306;70836;69530
31;"31.01.2006";14;"94.3";1374;70308;68934
31;"31.01.2006";15;"92.9";1346;69238;67892
31;"31.01.2006";16;"91.4";1382;68305;66923
31;"31.01.2006";17;"92.9";1615;67315;65700
31;"31.01.2006";18;96;1778;70886;69108
31;"31.01.2006";19;"111.9";1748;73201;71453
31;"31.01.2006";20;108;1494;71503;70009
31;"31.01.2006";21;91;1278;67844;66566
31;"31.01.2006";22;"75.8";1237;65699;64462
31;"31.01.2006";23;"74.8";1048;64565;63517
31;"31.01.2006";24;"65.1";970;60994;60024
32;"01.02.2006";1;"47.7";935;58814;57879
32;"01.02.2006";2;"47.8";938;57268;56330
32;"01.02.2006";3;"45.3";928;56160;55232
32;"01.02.2006";4;"33.6";863;55850;54987
32;"01.02.2006";5;"30.2";833;56080;55247
32;"01.02.2006";6;"46.7";751;57626;56875
32;"01.02.2006";7;61;719;62822;62103
32;"01.02.2006";8;90;656;69618;68962
32;"01.02.2006";9;"94.4";604;71052;70448
32;"01.02.2006";10;"110.3";528;70725;70197
32;"01.02.2006";11;"118.4";425;70800;70375
32;"01.02.2006";12;"130.9";396;71404;71008
32;"01.02.2006";13;"93.1";478;70831;70353
32;"01.02.2006";14;91;469;70048;69579
32;"01.02.2006";15;"92.4";450;68970;68520
32;"01.02.2006";16;"91.2";419;67979;67560
32;"01.02.2006";17;"91.3";428;67275;66847
32;"01.02.2006";18;"129.9";430;70876;70446
32;"01.02.2006";19;"146.9";480;73290;72810
32;"01.02.2006";20;"97.2";466;71448;70982
32;"01.02.2006";21;90;448;68343;67895
32;"01.02.2006";22;"83.6";470;66246;65776
32;"01.02.2006";23;"66.9";491;65771;65280
32;"01.02.2006";24;"55.9";537;62108;61571
33;"02.02.2006";1;"50.4";622;59544;58922
33;"02.02.2006";2;"57.5";701;57983;57282
33;"02.02.2006";3;"51.5";864;56812;55948
33;"02.02.2006";4;"40.6";827;56010;55183
33;"02.02.2006";5;"40.5";798;56008;55210
33;"02.02.2006";6;"63.1";802;57706;56904
33;"02.02.2006";7;"75.2";847;62758;61911
33;"02.02.2006";8;"95.5";828;69385;68557
33;"02.02.2006";9;113;707;70899;70192
33;"02.02.2006";10;"119.4";694;70697;70003
33;"02.02.2006";11;"106.5";655;71305;70650
33;"02.02.2006";12;"105.7";600;71914;71314
33;"02.02.2006";13;"100.3";662;71703;71041
33;"02.02.2006";14;"94.1";680;71166;70486
33;"02.02.2006";15;91;696;70462;69766
33;"02.02.2006";16;"90.2";677;69752;69075
33;"02.02.2006";17;"90.8";694;68934;68240
33;"02.02.2006";18;95;708;71966;71258
33;"02.02.2006";19;"100.1";785;73483;72698
33;"02.02.2006";20;100;804;72144;71340
33;"02.02.2006";21;"92.2";867;68734;67867
33;"02.02.2006";22;"82.8";966;66740;65774
33;"02.02.2006";23;78;993;66296;65303
33;"02.02.2006";24;"65.1";1088;62725;61637
34;"03.02.2006";1;64;1089;60135;59046
34;"03.02.2006";2;"63.1";1103;58241;57138
34;"03.02.2006";3;"59.8";1094;56815;55721
34;"03.02.2006";4;"46.9";1164;56007;54843
34;"03.02.2006";5;49;1254;56169;54915
34;"03.02.2006";6;57;1140;57642;56502
34;"03.02.2006";7;"72.1";1034;62769;61735
34;"03.02.2006";8;"110.4";974;69496;68522
34;"03.02.2006";9;"140.7";955;71153;70198
34;"03.02.2006";10;"149.9";945;71433;70488
34;"03.02.2006";11;"149.9";870;72136;71266
34;"03.02.2006";12;"157.1";653;72280;71627
34;"03.02.2006";13;"116.2";562;71594;71032
34;"03.02.2006";14;"116.2";465;70217;69752
34;"03.02.2006";15;96;380;68857;68477
34;"03.02.2006";16;"90.8";311;67904;67593
34;"03.02.2006";17;"90.2";241;67415;67174
34;"03.02.2006";18;"97.9";189;70710;70521
34;"03.02.2006";19;"152.6";162;71740;71578
34;"03.02.2006";20;"112.6";113;69540;69427
34;"03.02.2006";21;"92.9";93;66222;66129
34;"03.02.2006";22;"75.9";97;64390;64293
34;"03.02.2006";23;"77.9";87;64506;64419
34;"03.02.2006";24;"63.4";88;61741;61653
35;"04.02.2006";1;"74.5";77;58809;58732
35;"04.02.2006";2;"67.8";114;56479;56365
35;"04.02.2006";3;"58.3";166;54705;54539
35;"04.02.2006";4;"53.1";191;53644;53453
35;"04.02.2006";5;50;303;52855;52552
35;"04.02.2006";6;"52.9";383;50972;50589
35;"04.02.2006";7;"49.1";602;48820;48218
35;"04.02.2006";8;54;738;51550;50812
35;"04.02.2006";9;"65.8";1230;55565;54335
35;"04.02.2006";10;"82.8";1296;59190;57894
35;"04.02.2006";11;89;1583;61426;59843
35;"04.02.2006";12;"88.5";1916;62254;60338
35;"04.02.2006";13;85;1845;61145;59300
35;"04.02.2006";14;"77.2";1702;59275;57573
35;"04.02.2006";15;"58.3";1773;57494;55721
35;"04.02.2006";16;"50.5";1688;57057;55369
35;"04.02.2006";17;"47.5";1461;56859;55398
35;"04.02.2006";18;"68.5";1408;61179;59771
35;"04.02.2006";19;"94.1";1348;63122;61774
35;"04.02.2006";20;86;1235;60987;59752
35;"04.02.2006";21;"73.7";961;57326;56365
35;"04.02.2006";22;"57.6";833;56063;55230
35;"04.02.2006";23;"64.5";802;57893;57091
35;"04.02.2006";24;"54.1";689;56210;55521
36;"05.02.2006";1;"55.3";610;54252;53642
36;"05.02.2006";2;"48.1";551;51759;51208
36;"05.02.2006";3;"43.7";485;50086;49601
36;"05.02.2006";4;42;426;49136;48710
36;"05.02.2006";5;"40.6";305;48269;47964
36;"05.02.2006";6;38;213;46437;46224
36;"05.02.2006";7;"29.8";185;42845;42660
36;"05.02.2006";8;"31.5";177;43759;43582
36;"05.02.2006";9;"36.9";187;47068;46881
36;"05.02.2006";10;43;160;50847;50687
36;"05.02.2006";11;49;149;53535;53386
36;"05.02.2006";12;"60.2";137;56061;55924
36;"05.02.2006";13;"54.9";133;55154;55021
36;"05.02.2006";14;"46.9";130;52950;52820
36;"05.02.2006";15;"43.8";160;51687;51527
36;"05.02.2006";16;"42.3";131;50822;50691
36;"05.02.2006";17;"42.6";116;51106;50990
36;"05.02.2006";18;"50.8";123;55861;55738
36;"05.02.2006";19;"75.1";120;59991;59871
36;"05.02.2006";20;"65.4";106;59079;58973
36;"05.02.2006";21;60;133;56781;56648
36;"05.02.2006";22;"53.4";164;56613;56449
36;"05.02.2006";23;60;187;58698;58511
36;"05.02.2006";24;"45.9";198;55764;55566
37;"06.02.2006";1;"45.5";189;53705;53516
37;"06.02.2006";2;"46.3";268;52115;51847
37;"06.02.2006";3;45;307;50976;50669
37;"06.02.2006";4;"41.6";393;50573;50180
37;"06.02.2006";5;"38.1";460;51088;50628
37;"06.02.2006";6;"44.3";537;53777;53240
37;"06.02.2006";7;"51.2";709;60841;60132
37;"06.02.2006";8;"94.4";888;67798;66910
37;"06.02.2006";9;"131.1";1125;69706;68581
37;"06.02.2006";10;"115.1";1323;70330;69007
37;"06.02.2006";11;117;1425;71163;69738
37;"06.02.2006";12;120;1516;72101;70585
37;"06.02.2006";13;"119.9";1796;71776;69980
37;"06.02.2006";14;118;2057;71296;69239
37;"06.02.2006";15;"118.9";2450;70687;68237
37;"06.02.2006";16;102;2839;69870;67031
37;"06.02.2006";17;"93.1";3516;69004;65488
37;"06.02.2006";18;106;4253;70746;66493
37;"06.02.2006";19;146;5067;73428;68361
37;"06.02.2006";20;"117.3";5692;71517;65825
37;"06.02.2006";21;91;6594;67960;61366
37;"06.02.2006";22;"73.1";7277;66153;58876
37;"06.02.2006";23;"72.1";8080;65168;57088
37;"06.02.2006";24;52;8354;61214;52860
38;"07.02.2006";1;"49.1";8999;58238;49239
38;"07.02.2006";2;"43.2";9501;56512;47011
38;"07.02.2006";3;35;10004;56020;46016
38;"07.02.2006";4;"29.6";10426;55499;45073
38;"07.02.2006";5;"32.5";10618;55947;45329
38;"07.02.2006";6;38;10491;57668;47177
38;"07.02.2006";7;"44.1";10511;63832;53321
38;"07.02.2006";8;"80.1";10535;70205;59670
38;"07.02.2006";9;81;10835;72506;61671
38;"07.02.2006";10;81;10823;72783;61960
38;"07.02.2006";11;"87.9";10947;73586;62639
38;"07.02.2006";12;"90.2";10997;74526;63529
38;"07.02.2006";13;88;11000;74138;63138
38;"07.02.2006";14;90;10538;73805;63267
38;"07.02.2006";15;"87.1";9942;73193;63251
38;"07.02.2006";16;"81.1";9582;72295;62713
38;"07.02.2006";17;"77.1";9416;71279;61863
38;"07.02.2006";18;"87.9";8815;72841;64026
38;"07.02.2006";19;90;8232;73968;65736
38;"07.02.2006";20;"88.8";7859;71464;63605
38;"07.02.2006";21;"82.6";7769;67673;59904
38;"07.02.2006";22;"60.4";7300;65532;58232
38;"07.02.2006";23;"53.1";7568;64485;56917
38;"07.02.2006";24;"44.5";7829;60141;52312
39;"08.02.2006";1;"35.5";8370;56769;48399
39;"08.02.2006";2;"32.4";8765;54765;46000
39;"08.02.2006";3;"38.4";8998;53457;44459
39;"08.02.2006";4;38;9181;53461;44280
39;"08.02.2006";5;"32.9";9636;54166;44530
39;"08.02.2006";6;"42.2";9891;56418;46527
39;"08.02.2006";7;"43.6";10031;62317;52286
39;"08.02.2006";8;"68.1";9277;68739;59462
39;"08.02.2006";9;"69.7";8760;70878;62118
39;"08.02.2006";10;"77.1";8677;71334;62657
39;"08.02.2006";11;79;8505;72492;63987
39;"08.02.2006";12;"82.6";8964;73343;64379
39;"08.02.2006";13;"83.4";9304;72525;63221
39;"08.02.2006";14;"78.7";9666;72141;62475
39;"08.02.2006";15;"79.9";9493;71379;61886
39;"08.02.2006";16;"70.2";9676;70398;60722
39;"08.02.2006";17;"57.2";9629;69161;59532
39;"08.02.2006";18;"72.5";9957;71766;61809
39;"08.02.2006";19;75;10718;74162;63444
39;"08.02.2006";20;"62.4";11738;72540;60802
39;"08.02.2006";21;"56.9";12018;68895;56877
39;"08.02.2006";22;"46.5";12440;67450;55010
39;"08.02.2006";23;"44.2";12871;66452;53581
39;"08.02.2006";24;"29.1";12821;62719;49898
40;"09.02.2006";1;"43.7";13175;59938;46763
40;"09.02.2006";2;"42.6";13201;58050;44849
40;"09.02.2006";3;"38.3";12822;56692;43870
40;"09.02.2006";4;"35.2";12425;56397;43972
40;"09.02.2006";5;"35.2";12215;56783;44568
40;"09.02.2006";6;"42.4";12101;58539;46438
40;"09.02.2006";7;"44.3";11822;63848;52026
40;"09.02.2006";8;"82.6";11443;69651;58208
40;"09.02.2006";9;"87.9";11124;70904;59780
40;"09.02.2006";10;"80.7";10834;71329;60495
40;"09.02.2006";11;"81.6";11177;72193;61016
40;"09.02.2006";12;"87.6";11317;73004;61687
40;"09.02.2006";13;"85.6";11075;72635;61560
40;"09.02.2006";14;"87.6";10975;72308;61333
40;"09.02.2006";15;"85.8";10493;71489;60996
40;"09.02.2006";16;"80.6";10110;70756;60646
40;"09.02.2006";17;81;10082;69391;59309
40;"09.02.2006";18;"100.1";9615;71259;61644
40;"09.02.2006";19;"102.3";9187;73561;64374
40;"09.02.2006";20;"90.6";8708;71507;62799
40;"09.02.2006";21;"79.9";8341;67844;59503
40;"09.02.2006";22;"55.3";8067;66068;58001
40;"09.02.2006";23;"51.7";7949;65298;57349
40;"09.02.2006";24;"42.9";7984;61322;53338
41;"10.02.2006";1;"42.1";8049;58301;50252
41;"10.02.2006";2;"35.3";8116;56541;48425
41;"10.02.2006";3;"38.7";8184;55246;47062
41;"10.02.2006";4;"38.4";8080;54605;46525
41;"10.02.2006";5;37;7979;55304;47325
41;"10.02.2006";6;"45.6";7608;57055;49447
41;"10.02.2006";7;52;7158;62044;54886
41;"10.02.2006";8;90;6720;68149;61429
41;"10.02.2006";9;"92.5";6339;70075;63736
41;"10.02.2006";10;91;5742;70466;64724
41;"10.02.2006";11;"95.9";5120;71130;66010
41;"10.02.2006";12;"97.2";4667;71900;67233
41;"10.02.2006";13;100;4435;71237;66802
41;"10.02.2006";14;97;4080;69903;65823
41;"10.02.2006";15;"94.5";3800;68691;64891
41;"10.02.2006";16;"90.1";3467;67556;64089
41;"10.02.2006";17;"88.9";2983;66887;63904
41;"10.02.2006";18;"96.2";2546;69544;66998
41;"10.02.2006";19;125;2080;71286;69206
41;"10.02.2006";20;115;1645;68790;67145
41;"10.02.2006";21;"96.9";1406;64868;63462
41;"10.02.2006";22;"78.3";1196;63272;62076
41;"10.02.2006";23;"79.9";958;63034;62076
41;"10.02.2006";24;"58.6";721;59942;59221
42;"11.02.2006";1;63;693;57106;56413
42;"11.02.2006";2;52;617;54840;54223
42;"11.02.2006";3;"45.1";516;53399;52883
42;"11.02.2006";4;"42.7";456;52743;52287
42;"11.02.2006";5;"38.4";438;52197;51759
42;"11.02.2006";6;"42.8";345;50607;50262
42;"11.02.2006";7;"42.9";291;48829;48538
42;"11.02.2006";8;50;221;51236;51015
42;"11.02.2006";9;"64.2";209;54801;54592
42;"11.02.2006";10;81;183;58363;58180
42;"11.02.2006";11;"91.8";214;59888;59674
42;"11.02.2006";12;91;242;61064;60822
42;"11.02.2006";13;89;228;60221;59993
42;"11.02.2006";14;"79.5";229;58207;57978
42;"11.02.2006";15;"64.3";248;56545;56297
42;"11.02.2006";16;"56.2";212;55903;55691
42;"11.02.2006";17;"56.1";160;55773;55613
42;"11.02.2006";18;81;176;59438;59262
42;"11.02.2006";19;93;220;63007;62787
42;"11.02.2006";20;"89.5";165;61075;60910
42;"11.02.2006";21;"77.1";162;57247;57085
42;"11.02.2006";22;"59.6";204;56202;55998
42;"11.02.2006";23;"72.4";230;57390;57160
42;"11.02.2006";24;"59.4";264;55044;54780
43;"12.02.2006";1;"55.4";253;52085;51832
43;"12.02.2006";2;"45.1";325;49957;49632
43;"12.02.2006";3;42;448;48738;48290
43;"12.02.2006";4;"42.6";622;48004;47382
43;"12.02.2006";5;"43.1";752;47284;46532
43;"12.02.2006";6;"41.2";893;45498;44605
43;"12.02.2006";7;"29.8";946;42254;41308
43;"12.02.2006";8;"30.5";946;42983;42037
43;"12.02.2006";9;34;992;46197;45205
43;"12.02.2006";10;"42.1";940;49983;49043
43;"12.02.2006";11;46;850;52576;51726
43;"12.02.2006";12;"63.7";855;55166;54311
43;"12.02.2006";13;"52.8";958;53882;52924
43;"12.02.2006";14;"46.2";1036;51468;50432
43;"12.02.2006";15;45;1084;49888;48804
43;"12.02.2006";16;"41.5";1014;49256;48242
43;"12.02.2006";17;"40.7";972;49414;48442
43;"12.02.2006";18;"58.7";994;53973;52979
43;"12.02.2006";19;81;1234;59232;57998
43;"12.02.2006";20;"80.9";1533;58818;57285
43;"12.02.2006";21;"73.1";1552;56552;55000
43;"12.02.2006";22;"64.9";1439;55969;54530
43;"12.02.2006";23;"70.1";1378;57992;56614
43;"12.02.2006";24;"60.1";1200;54998;53798
44;"13.02.2006";1;"51.1";1198;52486;51288
44;"13.02.2006";2;"49.2";1231;50702;49471
44;"13.02.2006";3;"45.3";1225;49891;48666
44;"13.02.2006";4;"41.8";1192;49758;48566
44;"13.02.2006";5;"43.1";1105;50652;49547
44;"13.02.2006";6;52;1303;53352;52049
44;"13.02.2006";7;"59.4";1476;60355;58879
44;"13.02.2006";8;98;1442;66809;65367
44;"13.02.2006";9;"118.9";1631;68566;66935
44;"13.02.2006";10;"115.1";1526;69022;67496
44;"13.02.2006";11;115;1178;69322;68144
44;"13.02.2006";12;"115.1";1088;70128;69040
44;"13.02.2006";13;115;1050;69374;68324
44;"13.02.2006";14;115;997;68828;67831
44;"13.02.2006";15;"109.7";770;67768;66998
44;"13.02.2006";16;"95.6";579;66903;66324
44;"13.02.2006";17;91;531;65363;64832
44;"13.02.2006";18;"109.5";625;67997;67372
44;"13.02.2006";19;140;895;72597;71702
44;"13.02.2006";20;"118.5";1198;70873;69675
44;"13.02.2006";21;"92.3";1310;67427;66117
44;"13.02.2006";22;"81.1";1234;65053;63819
44;"13.02.2006";23;82;1161;63882;62721
44;"13.02.2006";24;"61.3";1128;59995;58867
45;"14.02.2006";1;"56.1";965;56839;55874
45;"14.02.2006";2;"58.2";873;55348;54475
45;"14.02.2006";3;"53.8";812;54092;53280
45;"14.02.2006";4;"47.7";850;53550;52700
45;"14.02.2006";5;"44.8";848;54263;53415
45;"14.02.2006";6;"57.3";831;55901;55070
45;"14.02.2006";7;"79.9";976;61619;60643
45;"14.02.2006";8;126;1108;67701;66593
45;"14.02.2006";9;"121.1";1218;69344;68126
45;"14.02.2006";10;"127.6";1171;69622;68451
45;"14.02.2006";11;120;974;70321;69347
45;"14.02.2006";12;"119.1";987;71203;70216
45;"14.02.2006";13;"100.9";1220;70379;69159
45;"14.02.2006";14;"105.1";1295;70055;68760
45;"14.02.2006";15;"95.6";1597;69364;67767
45;"14.02.2006";16;"90.8";1938;68321;66383
45;"14.02.2006";17;89;2342;67054;64712
45;"14.02.2006";18;"92.4";2861;69167;66306
45;"14.02.2006";19;"99.9";3328;72506;69178
45;"14.02.2006";20;100;3525;70930;67405
45;"14.02.2006";21;"100.9";3538;66994;63456
45;"14.02.2006";22;"86.3";3488;64703;61215
45;"14.02.2006";23;"73.5";3383;63608;60225
45;"14.02.2006";24;"58.4";3391;59390;55999
46;"15.02.2006";1;"54.9";3628;55938;52310
46;"15.02.2006";2;"50.4";3787;53715;49928
46;"15.02.2006";3;48;3911;52746;48835
46;"15.02.2006";4;"47.6";3918;52617;48699
46;"15.02.2006";5;"43.9";3933;53517;49584
46;"15.02.2006";6;"50.1";4433;55601;51168
46;"15.02.2006";7;"56.1";5243;61192;55949
46;"15.02.2006";8;"87.3";6215;67404;61189
46;"15.02.2006";9;"87.9";6800;69717;62917
46;"15.02.2006";10;"90.1";7197;70107;62910
46;"15.02.2006";11;"89.9";8065;71230;63165
46;"15.02.2006";12;88;8645;72607;63962
46;"15.02.2006";13;87;9280;72483;63203
46;"15.02.2006";14;82;10209;72280;62071
46;"15.02.2006";15;"83.2";10506;71335;60829
46;"15.02.2006";16;79;9796;70631;60835
46;"15.02.2006";17;"72.2";9345;69703;60358
46;"15.02.2006";18;"79.1";8675;71401;62726
46;"15.02.2006";19;82;7941;73483;65542
46;"15.02.2006";20;"87.8";6858;71205;64347
46;"15.02.2006";21;"84.1";6187;67336;61149
46;"15.02.2006";22;"62.3";5381;64841;59460
46;"15.02.2006";23;64;4990;63663;58673
46;"15.02.2006";24;53;4633;58958;54325
47;"16.02.2006";1;"50.1";4127;54884;50757
47;"16.02.2006";2;"48.8";3324;52466;49142
47;"16.02.2006";3;48;3009;51381;48372
47;"16.02.2006";4;42;2509;51597;49088
47;"16.02.2006";5;"44.2";2171;52845;50674
47;"16.02.2006";6;48;1817;54911;53094
47;"16.02.2006";7;"55.3";1770;60709;58939
47;"16.02.2006";8;"83.1";1690;66686;64996
47;"16.02.2006";9;"87.5";1684;68677;66993
47;"16.02.2006";10;"89.1";1607;68791;67184
47;"16.02.2006";11;"91.5";1709;69552;67843
47;"16.02.2006";12;"93.9";1794;70783;68989
47;"16.02.2006";13;"87.2";1599;69783;68184
47;"16.02.2006";14;87;1620;69235;67615
47;"16.02.2006";15;"88.7";1870;68101;66231
47;"16.02.2006";16;"83.1";2004;66936;64932
47;"16.02.2006";17;"77.2";2192;66280;64088
47;"16.02.2006";18;87;2380;68438;66058
47;"16.02.2006";19;"91.9";2670;71759;69089
47;"16.02.2006";20;"89.1";2869;70116;67247
47;"16.02.2006";21;85;2978;66095;63117
47;"16.02.2006";22;"70.2";3120;63652;60532
47;"16.02.2006";23;72;2780;62419;59639
47;"16.02.2006";24;"54.4";2829;58064;55235
48;"17.02.2006";1;"52.7";2866;54443;51577
48;"17.02.2006";2;"52.1";2868;52011;49143
48;"17.02.2006";3;"43.3";2643;50974;48331
48;"17.02.2006";4;"37.2";2765;51212;48447
48;"17.02.2006";5;"39.6";3007;52463;49456
48;"17.02.2006";6;"42.7";3210;54539;51329
48;"17.02.2006";7;"55.4";3205;59907;56702
48;"17.02.2006";8;"92.1";3192;65721;62529
48;"17.02.2006";9;"83.2";3417;67595;64178
48;"17.02.2006";10;"88.6";3596;67797;64201
48;"17.02.2006";11;"89.6";3907;68805;64898
48;"17.02.2006";12;"90.5";3890;69558;65668
48;"17.02.2006";13;"83.3";4405;68678;64273
48;"17.02.2006";14;80;4355;67468;63113
48;"17.02.2006";15;73;3887;66314;62427
48;"17.02.2006";16;"69.2";3576;65294;61718
48;"17.02.2006";17;"65.7";3392;64392;61000
48;"17.02.2006";18;"82.5";3713;66884;63171
48;"17.02.2006";19;"89.1";4091;70416;66325
48;"17.02.2006";20;"79.9";4726;68141;63415
48;"17.02.2006";21;"77.2";5009;63760;58751
48;"17.02.2006";22;"52.5";5327;61692;56365
48;"17.02.2006";23;"46.7";5653;61158;55505
48;"17.02.2006";24;50;5847;57333;51486
49;"18.02.2006";1;"48.9";5303;53801;48498
49;"18.02.2006";2;"46.9";5007;51278;46271
49;"18.02.2006";3;48;4541;49945;45404
49;"18.02.2006";4;"46.9";4984;50011;45027
49;"18.02.2006";5;47;4646;50149;45503
49;"18.02.2006";6;47;4482;49030;44548
49;"18.02.2006";7;"46.1";4057;47682;43625
49;"18.02.2006";8;"49.4";3374;50429;47055
49;"18.02.2006";9;"55.3";2828;54049;51221
49;"18.02.2006";10;"58.2";2555;57241;54686
49;"18.02.2006";11;"72.5";2355;58543;56188
49;"18.02.2006";12;"74.7";2431;59853;57422
49;"18.02.2006";13;"70.4";2788;58796;56008
49;"18.02.2006";14;"55.4";2665;56812;54147
49;"18.02.2006";15;"50.4";2782;55152;52370
49;"18.02.2006";16;"48.8";2410;54070;51660
49;"18.02.2006";17;46;2349;53719;51370
49;"18.02.2006";18;"50.5";2274;56689;54415
49;"18.02.2006";19;75;2475;61191;58716
49;"18.02.2006";20;"64.3";2753;59246;56493
49;"18.02.2006";21;52;2914;55433;52519
49;"18.02.2006";22;"54.1";2570;54014;51444
49;"18.02.2006";23;"64.9";2643;54539;51896
49;"18.02.2006";24;"48.9";2391;51432;49041
50;"19.02.2006";1;"46.9";2266;48082;45816
50;"19.02.2006";2;"40.2";2248;45719;43471
50;"19.02.2006";3;40;2250;44586;42336
50;"19.02.2006";4;"38.3";2478;44415;41937
50;"19.02.2006";5;"38.2";2263;44553;42290
50;"19.02.2006";6;"36.5";2184;43517;41333
50;"19.02.2006";7;"26.1";1818;40719;38901
50;"19.02.2006";8;"29.8";1505;41556;40051
50;"19.02.2006";9;"34.6";1223;44553;43330
50;"19.02.2006";10;"39.2";957;47955;46998
50;"19.02.2006";11;47;813;50588;49775
50;"19.02.2006";12;"52.1";622;53117;52495
50;"19.02.2006";13;"53.5";613;51742;51129
50;"19.02.2006";14;"43.2";655;49190;48535
50;"19.02.2006";15;"39.1";766;47695;46929
50;"19.02.2006";16;"36.2";848;46778;45930
50;"19.02.2006";17;"35.3";906;47043;46137
50;"19.02.2006";18;"42.7";1113;50452;49339
50;"19.02.2006";19;"61.1";1770;56769;54999
50;"19.02.2006";20;"55.4";2217;57048;54831
50;"19.02.2006";21;"46.7";2490;54633;52143
50;"19.02.2006";22;"44.8";2560;54160;51600
50;"19.02.2006";23;"54.7";2645;55741;53096
50;"19.02.2006";24;"43.2";2508;51842;49334
51;"20.02.2006";1;"43.9";2462;48679;46217
51;"20.02.2006";2;"41.9";2584;46430;43846
51;"20.02.2006";3;"39.8";2716;45914;43198
51;"20.02.2006";4;"37.2";3007;46519;43512
51;"20.02.2006";5;"34.5";2977;48183;45206
51;"20.02.2006";6;41;3143;51804;48661
51;"20.02.2006";7;"46.6";3217;59178;55961
51;"20.02.2006";8;"83.9";3393;65762;62369
51;"20.02.2006";9;94;3485;68027;64542
51;"20.02.2006";10;"89.4";2976;68619;65643
51;"20.02.2006";11;"80.4";2718;69511;66793
51;"20.02.2006";12;83;2663;70869;68206
51;"20.02.2006";13;"90.1";2649;70401;67752
51;"20.02.2006";14;"87.9";2684;70136;67452
51;"20.02.2006";15;"86.5";2794;69200;66406
51;"20.02.2006";16;"82.5";3178;68544;65366
51;"20.02.2006";17;"75.1";3195;67150;63955
51;"20.02.2006";18;"86.5";2667;68539;65872
51;"20.02.2006";19;93;2523;71558;69035
51;"20.02.2006";20;"81.1";2688;70059;67371
51;"20.02.2006";21;"86.4";2886;65985;63099
51;"20.02.2006";22;62;3046;63537;60491
51;"20.02.2006";23;"57.1";3063;62714;59651
51;"20.02.2006";24;"44.9";3111;57990;54879
52;"21.02.2006";1;"44.7";3110;54617;51507
52;"21.02.2006";2;44;3088;52941;49853
52;"21.02.2006";3;"42.5";3136;51899;48763
52;"21.02.2006";4;"40.8";3245;52142;48897
52;"21.02.2006";5;"42.8";3293;53310;50017
52;"21.02.2006";6;"44.8";3596;55681;52085
52;"21.02.2006";7;"57.5";3631;61334;57703
52;"21.02.2006";8;"84.4";3905;67092;63187
52;"21.02.2006";9;"83.2";3936;69081;65145
52;"21.02.2006";10;"80.5";4218;69624;65406
52;"21.02.2006";11;"82.5";4486;70250;65764
52;"21.02.2006";12;"86.4";4695;71302;66607
52;"21.02.2006";13;89;4869;70647;65778
52;"21.02.2006";14;"90.2";4818;69984;65166
52;"21.02.2006";15;90;4948;69231;64283
52;"21.02.2006";16;"87.9";5254;68701;63447
52;"21.02.2006";17;"69.6";5589;67582;61993
52;"21.02.2006";18;"84.1";5738;69223;63485
52;"21.02.2006";19;"87.9";6019;72778;66759
52;"21.02.2006";20;84;6232;71120;64888
52;"21.02.2006";21;"82.3";6770;67704;60934
52;"21.02.2006";22;"63.3";6500;64867;58367
52;"21.02.2006";23;"60.9";6446;63270;56824
52;"21.02.2006";24;"49.4";6373;58842;52469
53;"22.02.2006";1;"44.7";6225;55507;49282
53;"22.02.2006";2;"39.9";5649;53246;47597
53;"22.02.2006";3;"40.1";4969;52072;47103
53;"22.02.2006";4;"40.2";4541;52048;47507
53;"22.02.2006";5;"38.2";4132;52911;48779
53;"22.02.2006";6;"42.9";3984;55235;51251
53;"22.02.2006";7;"49.9";3599;60860;57261
53;"22.02.2006";8;"81.9";3322;66787;63465
53;"22.02.2006";9;"96.7";3152;69273;66121
53;"22.02.2006";10;"89.5";2950;69648;66698
53;"22.02.2006";11;"97.1";2916;70916;68000
53;"22.02.2006";12;"91.5";2971;72046;69075
53;"22.02.2006";13;"94.9";2429;71409;68980
53;"22.02.2006";14;"95.5";2092;70744;68652
53;"22.02.2006";15;"91.6";1806;69973;68167
53;"22.02.2006";16;"89.5";1548;68777;67229
53;"22.02.2006";17;"80.5";1366;67315;65949
53;"22.02.2006";18;89;1326;68834;67508
53;"22.02.2006";19;"103.8";1244;71819;70575
53;"22.02.2006";20;92;1048;70520;69472
53;"22.02.2006";21;"86.3";874;66722;65848
53;"22.02.2006";22;79;685;64525;63840
53;"22.02.2006";23;"78.5";501;63122;62621
53;"22.02.2006";24;"54.9";397;58637;58240
54;"23.02.2006";1;"57.7";327;55668;55341
54;"23.02.2006";2;"46.7";285;53591;53306
54;"23.02.2006";3;"45.2";284;52639;52355
54;"23.02.2006";4;"39.9";292;52542;52250
54;"23.02.2006";5;46;312;53286;52974
54;"23.02.2006";6;50;256;54985;54729
54;"23.02.2006";7;"68.1";261;60620;60359
54;"23.02.2006";8;"98.2";245;66050;65805
54;"23.02.2006";9;"120.4";222;67836;67614
54;"23.02.2006";10;150;168;68342;68174
54;"23.02.2006";11;148;113;69221;69108
54;"23.02.2006";12;"140.1";128;70559;70431
54;"23.02.2006";13;"101.9";170;69960;69790
54;"23.02.2006";14;"104.1";178;69375;69197
54;"23.02.2006";15;"97.3";182;68296;68114
54;"23.02.2006";16;"89.9";223;67110;66887
54;"23.02.2006";17;"88.9";291;65819;65528
54;"23.02.2006";18;"89.4";330;66915;66585
54;"23.02.2006";19;"108.9";512;70376;69864
54;"23.02.2006";20;"91.2";755;69273;68518
54;"23.02.2006";21;"87.8";1002;65612;64610
54;"23.02.2006";22;"78.9";1359;63328;61969
54;"23.02.2006";23;"63.3";1904;62770;60866
54;"23.02.2006";24;54;2446;58976;56530
55;"24.02.2006";1;60;2653;56010;53357
55;"24.02.2006";2;50;3224;54421;51197
55;"24.02.2006";3;"47.1";3652;53279;49627
55;"24.02.2006";4;"47.1";4094;53124;49030
55;"24.02.2006";5;47;4621;53554;48933
55;"24.02.2006";6;"44.2";5200;55208;50008
55;"24.02.2006";7;"57.4";5464;59929;54465
55;"24.02.2006";8;90;5668;64891;59223
55;"24.02.2006";9;"99.4";5776;66761;60985
55;"24.02.2006";10;"91.4";6271;67514;61243
55;"24.02.2006";11;90;6625;68427;61802
55;"24.02.2006";12;88;6935;69387;62452
55;"24.02.2006";13;"82.5";7618;68589;60971
55;"24.02.2006";14;"69.7";8707;67503;58796
55;"24.02.2006";15;"65.5";9586;66520;56934
55;"24.02.2006";16;"50.9";10025;65311;55286
55;"24.02.2006";17;"47.5";9467;64353;54886
55;"24.02.2006";18;"53.6";9061;65654;56593
55;"24.02.2006";19;68;9376;69776;60400
55;"24.02.2006";20;"55.4";9432;68727;59295
55;"24.02.2006";21;"63.9";9325;64912;55587
55;"24.02.2006";22;"50.8";8649;62604;53955
55;"24.02.2006";23;"49.4";8221;62118;53897
55;"24.02.2006";24;"43.7";7571;58753;51182
56;"25.02.2006";1;"40.8";7303;55920;48617
56;"25.02.2006";2;"38.8";7144;53940;46796
56;"25.02.2006";3;"35.3";6808;52384;45576
56;"25.02.2006";4;"40.9";6887;51658;44771
56;"25.02.2006";5;"41.8";6976;51187;44211
56;"25.02.2006";6;"37.4";6667;49483;42816
56;"25.02.2006";7;"28.8";6551;47764;41213
56;"25.02.2006";8;30;6336;49589;43253
56;"25.02.2006";9;"38.3";6112;53594;47482
56;"25.02.2006";10;"46.5";5556;56749;51193
56;"25.02.2006";11;"49.6";4921;58375;53454
56;"25.02.2006";12;"48.6";4413;59640;55227
56;"25.02.2006";13;"47.9";3730;58222;54492
56;"25.02.2006";14;"43.9";3305;56295;52990
56;"25.02.2006";15;"41.1";3241;54689;51448
56;"25.02.2006";16;"38.4";3131;54021;50890
56;"25.02.2006";17;"39.7";3158;53774;50616
56;"25.02.2006";18;"45.6";3117;56307;53190
56;"25.02.2006";19;"79.9";3175;60836;57661
56;"25.02.2006";20;"48.5";3117;59651;56534
56;"25.02.2006";21;"41.5";2866;55981;53115
56;"25.02.2006";22;"37.7";2595;54770;52175
56;"25.02.2006";23;"41.9";2449;55893;53444
56;"25.02.2006";24;"37.4";2302;53574;51272
57;"26.02.2006";1;"43.9";2088;51227;49139
57;"26.02.2006";2;"41.5";1879;48984;47105
57;"26.02.2006";3;"40.3";1748;47745;45997
57;"26.02.2006";4;"41.1";1731;46770;45039
57;"26.02.2006";5;"40.5";1777;46053;44276
57;"26.02.2006";6;"39.2";1777;44418;42641
57;"26.02.2006";7;"28.8";1799;41299;39500
57;"26.02.2006";8;"25.5";1786;41682;39896
57;"26.02.2006";9;"33.5";1705;45453;43748
57;"26.02.2006";10;"36.6";1685;49129;47444
57;"26.02.2006";11;"43.2";1829;51991;50162
57;"26.02.2006";12;"45.6";1920;54957;53037
57;"26.02.2006";13;"43.5";1977;53720;51743
57;"26.02.2006";14;"41.7";1950;50842;48892
57;"26.02.2006";15;39;1942;48932;46990
57;"26.02.2006";16;36;1818;48044;46226
57;"26.02.2006";17;"34.6";1591;47771;46180
57;"26.02.2006";18;41;1193;49904;48711
57;"26.02.2006";19;53;981;56205;55224
57;"26.02.2006";20;55;878;57088;56210
57;"26.02.2006";21;"47.4";769;54919;54150
57;"26.02.2006";22;"47.1";718;54789;54071
57;"26.02.2006";23;"67.3";787;56954;56167
57;"26.02.2006";24;"46.2";787;54514;53727
58;"27.02.2006";1;"45.5";850;52603;51753
58;"27.02.2006";2;44;893;51093;50200
58;"27.02.2006";3;"43.5";849;50064;49215
58;"27.02.2006";4;"41.9";873;49552;48679
58;"27.02.2006";5;"42.2";948;50027;49079
58;"27.02.2006";6;"43.2";984;51763;50779
58;"27.02.2006";7;"43.6";982;55703;54721
58;"27.02.2006";8;"63.9";942;59894;58952
58;"27.02.2006";9;80;652;62862;62210
58;"27.02.2006";10;"82.5";414;64512;64098
58;"27.02.2006";11;"86.9";317;65946;65629
58;"27.02.2006";12;"89.9";391;66909;66518
58;"27.02.2006";13;"86.9";407;66156;65749
58;"27.02.2006";14;"87.9";495;64631;64136
58;"27.02.2006";15;"86.2";590;63253;62663
58;"27.02.2006";16;76;620;62081;61461
58;"27.02.2006";17;"61.9";544;61166;60622
58;"27.02.2006";18;"70.1";480;62638;62158
58;"27.02.2006";19;"89.9";671;67475;66804
58;"27.02.2006";20;"89.9";1017;67145;66128
58;"27.02.2006";21;"82.5";1564;64033;62469
58;"27.02.2006";22;"56.3";2055;62159;60104
58;"27.02.2006";23;"52.8";2547;61858;59311
58;"27.02.2006";24;"45.3";2960;58257;55297
59;"28.02.2006";1;"46.1";3172;55722;52550
59;"28.02.2006";2;"43.4";3658;53994;50336
59;"28.02.2006";3;"40.7";4152;52838;48686
59;"28.02.2006";4;"37.4";4419;52365;47946
59;"28.02.2006";5;"36.4";4487;52827;48340
59;"28.02.2006";6;"40.6";4706;54581;49875
59;"28.02.2006";7;"45.7";4967;58734;53767
59;"28.02.2006";8;"72.7";4948;63084;58136
59;"28.02.2006";9;"88.8";4615;65927;61312
59;"28.02.2006";10;"84.7";4381;67266;62885
59;"28.02.2006";11;"85.1";4426;68627;64201
59;"28.02.2006";12;89;4262;69808;65546
59;"28.02.2006";13;"79.2";3911;68961;65050
59;"28.02.2006";14;"67.7";3668;67926;64258
59;"28.02.2006";15;"79.4";3551;66877;63326
59;"28.02.2006";16;"68.4";3549;65804;62255
59;"28.02.2006";17;"58.7";3185;64563;61378
59;"28.02.2006";18;"76.9";3118;66058;62940
59;"28.02.2006";19;95;3381;69921;66540
59;"28.02.2006";20;"89.4";3398;69109;65711
59;"28.02.2006";21;"89.5";3394;65699;62305
59;"28.02.2006";22;"65.6";3477;63966;60489
59;"28.02.2006";23;"63.4";3381;63042;59661
59;"28.02.2006";24;"50.1";3301;59290;55989
60;"01.03.2006";1;"44.6";3425;56223;52798
60;"01.03.2006";2;"43.9";3365;54236;50871
60;"01.03.2006";3;"42.8";2853;52733;49880
60;"01.03.2006";4;"43.8";2844;52792;49948
60;"01.03.2006";5;"44.9";3020;53517;50497
60;"01.03.2006";6;"48.6";2995;55396;52401
60;"01.03.2006";7;"55.8";3024;60149;57125
60;"01.03.2006";8;"84.1";3190;64137;60947
60;"01.03.2006";9;"100.7";3262;66676;63414
60;"01.03.2006";10;"87.1";3603;67688;64085
60;"01.03.2006";11;"82.5";4353;68898;64545
60;"01.03.2006";12;89;4917;70378;65461
60;"01.03.2006";13;"85.1";5390;69751;64361
60;"01.03.2006";14;"89.1";5831;69328;63497
60;"01.03.2006";15;84;6136;68458;62322
60;"01.03.2006";16;76;6098;67416;61318
60;"01.03.2006";17;"61.1";5930;65636;59706
60;"01.03.2006";18;"56.6";5552;66024;60472
60;"01.03.2006";19;"85.6";5784;70381;64597
60;"01.03.2006";20;"75.1";6563;70240;63677
60;"01.03.2006";21;"51.4";7664;67279;59615
60;"01.03.2006";22;"46.5";8153;65330;57177
60;"01.03.2006";23;"44.8";8176;64776;56600
60;"01.03.2006";24;41;7805;61315;53510
61;"02.03.2006";1;"56.5";8118;58639;50521
61;"02.03.2006";2;"49.1";7890;56850;48960
61;"02.03.2006";3;"49.6";8267;55579;47312
61;"02.03.2006";4;"44.6";8043;54838;46795
61;"02.03.2006";5;"44.1";7694;55030;47336
61;"02.03.2006";6;"44.8";7067;56193;49126
61;"02.03.2006";7;"53.2";6695;61045;54350
61;"02.03.2006";8;"85.2";6379;64969;58590
61;"02.03.2006";9;80;6447;67296;60849
61;"02.03.2006";10;85;6690;67806;61116
61;"02.03.2006";11;"90.1";6099;68834;62735
61;"02.03.2006";12;"112.2";6862;69884;63022
61;"02.03.2006";13;101;6506;69374;62868
61;"02.03.2006";14;"93.3";7259;68811;61552
61;"02.03.2006";15;"91.9";7281;68249;60968
61;"02.03.2006";16;"88.4";7383;67365;59982
61;"02.03.2006";17;80;6658;65689;59031
61;"02.03.2006";18;"80.5";5825;66035;60210
61;"02.03.2006";19;"135.8";5210;70214;65004
61;"02.03.2006";20;130;5671;70618;64947
61;"02.03.2006";21;"97.4";5926;67086;61160
61;"02.03.2006";22;81;6205;64886;58681
61;"02.03.2006";23;85;6061;64333;58272
61;"02.03.2006";24;"65.5";5959;60890;54931
62;"03.03.2006";1;"53.2";5802;58077;52275
62;"03.03.2006";2;"43.4";5460;55886;50426
62;"03.03.2006";3;"41.1";4971;54512;49541
62;"03.03.2006";4;"43.5";4633;53941;49308
62;"03.03.2006";5;48;3741;53960;50219
62;"03.03.2006";6;"53.2";3515;55727;52212
62;"03.03.2006";7;"63.8";3048;60424;57376
62;"03.03.2006";8;92;2898;64833;61935
62;"03.03.2006";9;96;2220;67064;64844
62;"03.03.2006";10;"94.2";1943;68009;66066
62;"03.03.2006";11;98;1900;69399;67499
62;"03.03.2006";12;99;1737;70090;68353
62;"03.03.2006";13;"87.1";1589;69290;67701
62;"03.03.2006";14;"86.9";1566;67788;66222
62;"03.03.2006";15;85;1412;66510;65098
62;"03.03.2006";16;"82.6";1141;65236;64095
62;"03.03.2006";17;"72.1";1029;63924;62895
62;"03.03.2006";18;"82.8";882;64929;64047
62;"03.03.2006";19;"96.6";820;68638;67818
62;"03.03.2006";20;"86.9";785;68283;67498
62;"03.03.2006";21;"84.9";766;64124;63358
62;"03.03.2006";22;"63.3";894;61727;60833
62;"03.03.2006";23;"62.1";943;61905;60962
62;"03.03.2006";24;"49.8";958;58682;57724
63;"04.03.2006";1;"72.1";887;56003;55116
63;"04.03.2006";2;"63.2";1034;53862;52828
63;"04.03.2006";3;"50.2";1401;52342;50941
63;"04.03.2006";4;"49.8";1749;51996;50247
63;"04.03.2006";5;"43.3";1964;51500;49536
63;"04.03.2006";6;"49.5";2266;49956;47690
63;"04.03.2006";7;"39.6";2382;48082;45700
63;"04.03.2006";8;43;2580;49975;47395
63;"04.03.2006";9;"50.8";2627;54094;51467
63;"04.03.2006";10;"69.9";2408;57259;54851
63;"04.03.2006";11;80;2327;58775;56448
63;"04.03.2006";12;"81.5";2809;59917;57108
63;"04.03.2006";13;"64.3";3499;59035;55536
63;"04.03.2006";14;"50.5";3878;57342;53464
63;"04.03.2006";15;"47.5";3757;55905;52148
63;"04.03.2006";16;"45.5";3422;55071;51649
63;"04.03.2006";17;"46.5";3193;54403;51210
63;"04.03.2006";18;"56.5";2786;55781;52995
63;"04.03.2006";19;"85.4";2848;60542;57694
63;"04.03.2006";20;"83.1";3536;60754;57218
63;"04.03.2006";21;"50.5";4167;57334;53167
63;"04.03.2006";22;"47.6";4228;55594;51366
63;"04.03.2006";23;"53.2";4339;56659;52320
63;"04.03.2006";24;44;4321;54739;50418
64;"05.03.2006";1;"53.1";4155;52386;48231
64;"05.03.2006";2;"46.9";3691;50117;46426
64;"05.03.2006";3;"44.5";3449;48416;44967
64;"05.03.2006";4;"42.2";3449;47529;44080
64;"05.03.2006";5;"41.1";3645;46928;43283
64;"05.03.2006";6;"40.1";3858;45236;41378
64;"05.03.2006";7;"33.5";4297;42565;38268
64;"05.03.2006";8;"32.5";4658;43066;38408
64;"05.03.2006";9;"38.5";4795;46455;41660
64;"05.03.2006";10;"43.3";4835;49823;44988
64;"05.03.2006";11;"47.3";5179;52088;46909
64;"05.03.2006";12;"51.2";5288;55166;49878
64;"05.03.2006";13;"49.4";5179;53926;48747
64;"05.03.2006";14;"46.3";5430;51733;46303
64;"05.03.2006";15;43;5967;50027;44060
64;"05.03.2006";16;"41.1";5729;49127;43398
64;"05.03.2006";17;"37.3";5174;48775;43601
64;"05.03.2006";18;"45.6";4971;50659;45688
64;"05.03.2006";19;"56.7";4962;56650;51688
64;"05.03.2006";20;"74.9";4478;58219;53741
64;"05.03.2006";21;"52.4";4416;55969;51553
64;"05.03.2006";22;"49.8";4139;55105;50966
64;"05.03.2006";23;"53.9";3662;57008;53346
64;"05.03.2006";24;"50.2";3103;54108;51005
65;"06.03.2006";1;"49.2";2646;51700;49054
65;"06.03.2006";2;"46.2";2191;49732;47541
65;"06.03.2006";3;45;2079;48845;46766
65;"06.03.2006";4;"43.6";2177;48836;46659
65;"06.03.2006";5;"42.9";2290;49604;47314
65;"06.03.2006";6;"45.3";2506;52680;50174
65;"06.03.2006";7;"55.1";2696;59450;56754
65;"06.03.2006";8;"89.2";3094;64382;61288
65;"06.03.2006";9;86;3292;67245;63953
65;"06.03.2006";10;86;3381;67829;64448
65;"06.03.2006";11;86;3568;68943;65375
65;"06.03.2006";12;"106.2";3704;69989;66285
65;"06.03.2006";13;"91.5";4108;69797;65689
65;"06.03.2006";14;"97.1";4281;69279;64998
65;"06.03.2006";15;"91.6";4076;68331;64255
65;"06.03.2006";16;"85.9";4029;67504;63475
65;"06.03.2006";17;"80.5";3549;65688;62139
65;"06.03.2006";18;"83.2";3655;65923;62268
65;"06.03.2006";19;"120.3";3508;69566;66058
65;"06.03.2006";20;116;3172;70246;67074
65;"06.03.2006";21;"85.4";3325;66264;62939
65;"06.03.2006";22;"77.8";3502;63966;60464
65;"06.03.2006";23;"74.6";3523;63099;59576
65;"06.03.2006";24;"55.2";3596;58880;55284
66;"07.03.2006";1;49;3572;56113;52541
66;"07.03.2006";2;"49.6";3249;53842;50593
66;"07.03.2006";3;"45.1";3008;52650;49642
66;"07.03.2006";4;"46.4";2858;52579;49721
66;"07.03.2006";5;"49.6";2586;53465;50879
66;"07.03.2006";6;"59.2";2440;55406;52966
66;"07.03.2006";7;"75.9";2033;60507;58474
66;"07.03.2006";8;"91.5";1761;64788;63027
66;"07.03.2006";9;"89.1";1357;67121;65764
66;"07.03.2006";10;"100.9";837;67535;66698
66;"07.03.2006";11;105;674;68386;67712
66;"07.03.2006";12;"122.5";581;69461;68880
66;"07.03.2006";13;98;476;68917;68441
66;"07.03.2006";14;"97.9";386;68285;67899
66;"07.03.2006";15;"94.9";274;67172;66898
66;"07.03.2006";16;"94.9";304;66083;65779
66;"07.03.2006";17;86;208;64463;64255
66;"07.03.2006";18;"85.1";205;64845;64640
66;"07.03.2006";19;117;344;68820;68476
66;"07.03.2006";20;"140.3";474;69808;69334
66;"07.03.2006";21;"100.9";782;66012;65230
66;"07.03.2006";22;"79.9";1103;64031;62928
66;"07.03.2006";23;"77.6";1299;63249;61950
66;"07.03.2006";24;63;1500;59536;58036
67;"08.03.2006";1;68;1705;57051;55346
67;"08.03.2006";2;"54.1";1933;55368;53435
67;"08.03.2006";3;"51.5";2236;54264;52028
67;"08.03.2006";4;"45.7";2514;53981;51467
67;"08.03.2006";5;"38.9";2786;54667;51881
67;"08.03.2006";6;"40.5";3048;56584;53536
67;"08.03.2006";7;51;3023;61278;58255
67;"08.03.2006";8;"82.8";3148;65409;62261
67;"08.03.2006";9;85;3346;67603;64257
67;"08.03.2006";10;88;3427;68237;64810
67;"08.03.2006";11;85;3690;69559;65869
67;"08.03.2006";12;"87.3";4229;70517;66288
67;"08.03.2006";13;"86.1";4763;70498;65735
67;"08.03.2006";14;93;5128;70197;65069
67;"08.03.2006";15;"80.6";5518;69773;64255
67;"08.03.2006";16;"75.1";5957;68897;62940
67;"08.03.2006";17;"59.5";6094;67352;61258
67;"08.03.2006";18;"60.9";5948;67685;61737
67;"08.03.2006";19;"82.8";6121;71320;65199
67;"08.03.2006";20;"84.9";6712;71028;64316
67;"08.03.2006";21;78;6855;67231;60376
67;"08.03.2006";22;"59.9";6283;64931;58648
67;"08.03.2006";23;"56.1";5720;64023;58303
67;"08.03.2006";24;"50.9";5613;59622;54009
68;"09.03.2006";1;"44.7";5270;55810;50540
68;"09.03.2006";2;"47.6";4841;53297;48456
68;"09.03.2006";3;46;4441;51834;47393
68;"09.03.2006";4;"43.1";3955;51432;47477
68;"09.03.2006";5;"39.7";3589;52003;48414
68;"09.03.2006";6;"51.8";3288;54048;50760
68;"09.03.2006";7;"63.4";2975;59570;56595
68;"09.03.2006";8;"84.2";2722;64147;61425
68;"09.03.2006";9;"86.3";2658;66574;63916
68;"09.03.2006";10;"93.9";2376;67063;64687
68;"09.03.2006";11;"91.2";2192;68000;65808
68;"09.03.2006";12;"87.9";2164;69189;67025
68;"09.03.2006";13;"87.9";2245;68553;66308
68;"09.03.2006";14;"94.9";2138;68084;65946
68;"09.03.2006";15;"86.9";2071;67280;65209
68;"09.03.2006";16;"85.2";2171;66684;64513
68;"09.03.2006";17;84;2112;65211;63099
68;"09.03.2006";18;"81.8";1898;65822;63924
68;"09.03.2006";19;"95.6";1734;68881;67147
68;"09.03.2006";20;"87.1";1701;69357;67656
68;"09.03.2006";21;80;1581;65456;63875
68;"09.03.2006";22;"63.3";1520;62786;61266
68;"09.03.2006";23;"63.4";1510;61671;60161
68;"09.03.2006";24;54;1891;57411;55520
69;"10.03.2006";1;"52.2";2408;54091;51683
69;"10.03.2006";2;"50.2";2557;51737;49180
69;"10.03.2006";3;"46.5";2646;50424;47778
69;"10.03.2006";4;"38.4";3159;50820;47661
69;"10.03.2006";5;"36.7";3312;52056;48744
69;"10.03.2006";6;"43.4";3634;54047;50413
69;"10.03.2006";7;"53.8";3942;59401;55459
69;"10.03.2006";8;"69.9";4496;63799;59303
69;"10.03.2006";9;"76.2";4750;66245;61495
69;"10.03.2006";10;"82.4";4975;66472;61497
69;"10.03.2006";11;"76.1";5297;67669;62372
69;"10.03.2006";12;80;5593;68476;62883
69;"10.03.2006";13;82;5507;67949;62442
69;"10.03.2006";14;83;5117;66434;61317
69;"10.03.2006";15;"80.1";4556;65022;60466
69;"10.03.2006";16;"75.5";3699;64167;60468
69;"10.03.2006";17;"69.4";3292;63039;59747
69;"10.03.2006";18;"68.9";3250;63965;60715
69;"10.03.2006";19;84;3343;67638;64295
69;"10.03.2006";20;"85.1";3573;67742;64169
69;"10.03.2006";21;"81.9";3662;63640;59978
69;"10.03.2006";22;"61.6";3752;61518;57766
69;"10.03.2006";23;68;3814;61105;57291
69;"10.03.2006";24;"51.5";3755;57436;53681
70;"11.03.2006";1;42;4026;54526;50500
70;"11.03.2006";2;"38.3";4086;52392;48306
70;"11.03.2006";3;"39.1";4071;50778;46707
70;"11.03.2006";4;"36.8";4331;50193;45862
70;"11.03.2006";5;"35.8";4457;49857;45400
70;"11.03.2006";6;"32.5";4368;48795;44427
70;"11.03.2006";7;"31.5";4501;47037;42536
70;"11.03.2006";8;"32.6";4929;49377;44448
70;"11.03.2006";9;"42.2";4961;53959;48998
70;"11.03.2006";10;"49.9";5254;57377;52123
70;"11.03.2006";11;"48.4";5555;59445;53890
70;"11.03.2006";12;"50.1";5693;60470;54777
70;"11.03.2006";13;51;5806;59373;53567
70;"11.03.2006";14;"50.5";5927;57738;51811
70;"11.03.2006";15;"44.6";6681;56461;49780
70;"11.03.2006";16;"42.3";6595;55780;49185
70;"11.03.2006";17;40;6521;55104;48583
70;"11.03.2006";18;"40.8";6482;56589;50107
70;"11.03.2006";19;"48.9";5826;60129;54303
70;"11.03.2006";20;"57.9";5481;60734;55253
70;"11.03.2006";21;"50.5";5413;57284;51871
70;"11.03.2006";22;"44.7";5782;56057;50275
70;"11.03.2006";23;"46.5";5829;57366;51537
70;"11.03.2006";24;"45.2";5564;55187;49623
71;"12.03.2006";1;"48.1";5332;52886;47554
71;"12.03.2006";2;"43.2";4922;50718;45796
71;"12.03.2006";3;"39.8";4671;49118;44447
71;"12.03.2006";4;"39.2";4636;48065;43429
71;"12.03.2006";5;"39.9";4422;47471;43049
71;"12.03.2006";6;"36.7";4112;45700;41588
71;"12.03.2006";7;"24.7";3793;41857;38064
71;"12.03.2006";8;"22.5";3775;42612;38837
71;"12.03.2006";9;"31.6";3371;46062;42691
71;"12.03.2006";10;"34.8";3095;49260;46165
71;"12.03.2006";11;"46.1";2889;51823;48934
71;"12.03.2006";12;"48.1";2722;54604;51882
71;"12.03.2006";13;48;2411;53330;50919
71;"12.03.2006";14;"44.9";2105;50921;48816
71;"12.03.2006";15;"40.8";1928;49168;47240
71;"12.03.2006";16;"38.2";1764;48273;46509
71;"12.03.2006";17;"36.3";1637;47806;46169
71;"12.03.2006";18;"41.4";1433;49270;47837
71;"12.03.2006";19;"50.6";1439;55094;53655
71;"12.03.2006";20;"54.7";1369;58255;56886
71;"12.03.2006";21;"49.9";1351;56340;54989
71;"12.03.2006";22;"49.2";1351;55851;54500
71;"12.03.2006";23;55;1339;57929;56590
71;"12.03.2006";24;49;1290;55418;54128
72;"13.03.2006";1;"47.4";1262;53462;52200
72;"13.03.2006";2;"46.1";1218;51666;50448
72;"13.03.2006";3;44;1123;50782;49659
72;"13.03.2006";4;"42.4";983;50262;49279
72;"13.03.2006";5;"44.1";1022;50955;49933
72;"13.03.2006";6;"47.6";1061;53736;52675
72;"13.03.2006";7;"57.6";1135;59112;57977
72;"13.03.2006";8;"83.2";1186;63715;62529
72;"13.03.2006";9;"85.1";821;66296;65475
72;"13.03.2006";10;"85.8";452;66798;66346
72;"13.03.2006";11;"85.1";410;67557;67147
72;"13.03.2006";12;"90.1";559;68707;68148
72;"13.03.2006";13;88;696;68105;67409
72;"13.03.2006";14;"88.1";758;67689;66931
72;"13.03.2006";15;84;828;66819;65991
72;"13.03.2006";16;"78.9";927;65668;64741
72;"13.03.2006";17;65;1064;64097;63033
72;"13.03.2006";18;"57.5";1201;64032;62831
72;"13.03.2006";19;85;1325;67815;66490
72;"13.03.2006";20;90;1637;70265;68628
72;"13.03.2006";21;"76.2";1865;66512;64647
72;"13.03.2006";22;"59.1";2003;64035;62032
72;"13.03.2006";23;"58.6";2078;63299;61221
72;"13.03.2006";24;49;2110;59556;57446
73;"14.03.2006";1;"58.8";2074;57354;55280
73;"14.03.2006";2;"50.6";1910;55510;53600
73;"14.03.2006";3;"46.6";1855;54297;52442
73;"14.03.2006";4;"54.1";1761;54025;52264
73;"14.03.2006";5;"54.8";1878;54454;52576
73;"14.03.2006";6;"49.9";1867;56531;54664
73;"14.03.2006";7;"74.9";1877;60941;59064
73;"14.03.2006";8;"94.5";1739;64967;63228
73;"14.03.2006";9;105;1332;66900;65568
73;"14.03.2006";10;"106.9";1024;67125;66101
73;"14.03.2006";11;101;1119;67985;66866
73;"14.03.2006";12;"121.3";1147;68676;67529
73;"14.03.2006";13;"100.8";1198;67751;66553
73;"14.03.2006";14;"117.7";1191;67500;66309
73;"14.03.2006";15;"97.3";1183;66471;65288
73;"14.03.2006";16;"86.9";1180;65208;64028
73;"14.03.2006";17;"80.1";1310;63738;62428
73;"14.03.2006";18;"76.2";1500;63989;62489
73;"14.03.2006";19;95;1756;67417;65661
73;"14.03.2006";20;"100.2";2040;70098;68058
73;"14.03.2006";21;"84.3";2354;66863;64509
73;"14.03.2006";22;75;2262;64355;62093
73;"14.03.2006";23;"76.2";2153;63217;61064
73;"14.03.2006";24;"57.5";2101;59409;57308
74;"15.03.2006";1;"51.5";2004;56639;54635
74;"15.03.2006";2;"54.9";2065;54576;52511
74;"15.03.2006";3;"47.9";2033;53282;51249
74;"15.03.2006";4;"45.5";1890;53119;51229
74;"15.03.2006";5;"45.3";1946;53776;51830
74;"15.03.2006";6;"46.6";2049;56003;53954
74;"15.03.2006";7;"59.3";1989;60807;58818
74;"15.03.2006";8;90;1867;65000;63133
74;"15.03.2006";9;"90.2";1608;67255;65647
74;"15.03.2006";10;"100.2";1485;67311;65826
74;"15.03.2006";11;"101.8";1965;68094;66129
74;"15.03.2006";12;130;2293;69339;67046
74;"15.03.2006";13;84;2094;68756;66662
74;"15.03.2006";14;"90.3";2054;68301;66247
74;"15.03.2006";15;86;2179;67309;65130
74;"15.03.2006";16;"82.9";2414;66581;64167
74;"15.03.2006";17;"62.7";2762;65206;62444
74;"15.03.2006";18;"65.3";2819;65623;62804
74;"15.03.2006";19;"79.9";2830;68898;66068
74;"15.03.2006";20;"90.1";2911;70570;67659
74;"15.03.2006";21;"84.1";2976;66642;63666
74;"15.03.2006";22;"74.1";2755;64318;61563
74;"15.03.2006";23;"72.2";2725;62892;60167
74;"15.03.2006";24;"50.1";2596;58679;56083
75;"16.03.2006";1;55;2479;55703;53224
75;"16.03.2006";2;"51.7";2427;53496;51069
75;"16.03.2006";3;"48.6";2504;52297;49793
75;"16.03.2006";4;"48.5";2528;52295;49767
75;"16.03.2006";5;"46.4";2769;53053;50284
75;"16.03.2006";6;"53.1";2826;54991;52165
75;"16.03.2006";7;"63.4";2737;60236;57499
75;"16.03.2006";8;85;2573;64829;62256
75;"16.03.2006";9;"89.9";2366;67443;65077
75;"16.03.2006";10;"89.7";2395;67766;65371
75;"16.03.2006";11;"89.6";2625;68658;66033
75;"16.03.2006";12;"89.9";2851;69769;66918
75;"16.03.2006";13;78;2963;69350;66387
75;"16.03.2006";14;"85.1";2831;68885;66054
75;"16.03.2006";15;82;2960;68054;65094
75;"16.03.2006";16;"76.2";3062;67087;64025
75;"16.03.2006";17;"77.9";3125;65642;62517
75;"16.03.2006";18;"72.2";3153;65855;62702
75;"16.03.2006";19;"89.1";3099;68590;65491
75;"16.03.2006";20;"109.3";3056;69983;66927
75;"16.03.2006";21;"86.9";3052;66444;63392
75;"16.03.2006";22;"76.7";3073;64066;60993
75;"16.03.2006";23;"72.1";2996;63132;60136
75;"16.03.2006";24;"54.1";2761;58797;56036
76;"17.03.2006";1;"52.9";2657;56180;53523
76;"17.03.2006";2;"50.6";2485;53979;51494
76;"17.03.2006";3;49;2513;52985;50472
76;"17.03.2006";4;"47.5";2208;52950;50742
76;"17.03.2006";5;"48.2";2103;53434;51331
76;"17.03.2006";6;"52.9";2085;55188;53103
76;"17.03.2006";7;"63.4";2061;59936;57875
76;"17.03.2006";8;"84.4";1934;64457;62523
76;"17.03.2006";9;"96.6";1878;67088;65210
76;"17.03.2006";10;"96.2";1902;67529;65627
76;"17.03.2006";11;"101.4";1940;68222;66282
76;"17.03.2006";12;"96.8";1863;69233;67370
76;"17.03.2006";13;"91.9";1932;68788;66856
76;"17.03.2006";14;"85.9";1966;67186;65220
76;"17.03.2006";15;"80.1";2112;66033;63921
76;"17.03.2006";16;"73.2";2043;65061;63018
76;"17.03.2006";17;"73.1";2017;64060;62043
76;"17.03.2006";18;"73.1";1962;64413;62451
76;"17.03.2006";19;"81.7";1945;67260;65315
76;"17.03.2006";20;"91.2";1983;68144;66161
76;"17.03.2006";21;"84.1";2151;63836;61685
76;"17.03.2006";22;"64.4";2113;61608;59495
76;"17.03.2006";23;69;1960;61238;59278
76;"17.03.2006";24;"63.9";1859;57897;56038
77;"18.03.2006";1;49;1703;54799;53096
77;"18.03.2006";2;47;1620;52775;51155
77;"18.03.2006";3;"46.4";1500;51365;49865
77;"18.03.2006";4;"44.9";1269;50750;49481
77;"18.03.2006";5;"43.5";1194;50445;49251
77;"18.03.2006";6;47;1142;49139;47997
77;"18.03.2006";7;45;1026;47102;46076
77;"18.03.2006";8;"50.5";980;49551;48571
77;"18.03.2006";9;51;984;53516;52532
77;"18.03.2006";10;"74.5";922;56614;55692
77;"18.03.2006";11;"80.2";842;57782;56940
77;"18.03.2006";12;"80.1";759;58403;57644
77;"18.03.2006";13;75;680;57005;56325
77;"18.03.2006";14;"58.2";676;54927;54251
77;"18.03.2006";15;54;646;53316;52670
77;"18.03.2006";16;"52.2";683;52596;51913
77;"18.03.2006";17;"49.3";721;51889;51168
77;"18.03.2006";18;"49.6";703;53221;52518
77;"18.03.2006";19;"73.3";672;56498;55826
77;"18.03.2006";20;"83.9";742;58931;58189
77;"18.03.2006";21;71;750;55332;54582
77;"18.03.2006";22;"49.9";799;53564;52765
77;"18.03.2006";23;"51.8";764;54475;53711
77;"18.03.2006";24;"48.1";736;51978;51242
78;"19.03.2006";1;"51.1";763;49543;48780
78;"19.03.2006";2;"46.7";844;47276;46432
78;"19.03.2006";3;"42.4";935;46199;45264
78;"19.03.2006";4;42;961;45554;44593
78;"19.03.2006";5;41;1044;45215;44171
78;"19.03.2006";6;40;1148;43613;42465
78;"19.03.2006";7;"32.1";1216;39856;38640
78;"19.03.2006";8;22;1222;41335;40113
78;"19.03.2006";9;"39.9";1304;44937;43633
78;"19.03.2006";10;"45.6";1328;48038;46710
78;"19.03.2006";11;"49.5";1487;50370;48883
78;"19.03.2006";12;"53.5";1653;52609;50956
78;"19.03.2006";13;"51.9";1825;50945;49120
78;"19.03.2006";14;"46.7";2016;48327;46311
78;"19.03.2006";15;"42.6";2224;46434;44210
78;"19.03.2006";16;"39.9";2295;45341;43046
78;"19.03.2006";17;"37.7";2258;45196;42938
78;"19.03.2006";18;"38.3";2261;47453;45192
78;"19.03.2006";19;"53.5";2122;52242;50120
78;"19.03.2006";20;"71.7";2097;56353;54256
78;"19.03.2006";21;"57.4";1965;54280;52315
78;"19.03.2006";22;52;1700;53646;51946
78;"19.03.2006";23;"55.1";1458;54899;53441
78;"19.03.2006";24;"48.9";1185;51371;50186
79;"20.03.2006";1;"48.2";1081;48589;47508
79;"20.03.2006";2;"45.8";849;46618;45769
79;"20.03.2006";3;"43.9";735;46055;45320
79;"20.03.2006";4;"36.8";800;46781;45981
79;"20.03.2006";5;"43.7";757;48392;47635
79;"20.03.2006";6;"49.5";711;51721;51010
79;"20.03.2006";7;"60.8";795;57194;56399
79;"20.03.2006";8;"85.6";760;62462;61702
79;"20.03.2006";9;"104.4";900;65319;64419
79;"20.03.2006";10;115;1039;65946;64907
79;"20.03.2006";11;"103.8";1409;66936;65527
79;"20.03.2006";12;110;1930;68262;66332
79;"20.03.2006";13;"103.9";2270;67774;65504
79;"20.03.2006";14;"100.4";2611;67009;64398
79;"20.03.2006";15;"90.1";3038;65818;62780
79;"20.03.2006";16;86;3431;64492;61061
79;"20.03.2006";17;"81.1";3739;62914;59175
79;"20.03.2006";18;80;3342;62676;59334
79;"20.03.2006";19;"100.1";2960;65492;62532
79;"20.03.2006";20;"116.6";2873;68947;66074
79;"20.03.2006";21;"91.6";2542;64808;62266
79;"20.03.2006";22;"76.7";2524;62205;59681
79;"20.03.2006";23;"72.2";2093;60431;58338
79;"20.03.2006";24;"52.8";1734;55624;53890
80;"21.03.2006";1;"43.7";1649;52362;50713
80;"21.03.2006";2;"41.9";1431;50315;48884
80;"21.03.2006";3;"42.1";1108;49099;47991
80;"21.03.2006";4;"42.1";851;49496;48645
80;"21.03.2006";5;"38.7";686;50769;50083
80;"21.03.2006";6;"48.5";522;53328;52806
80;"21.03.2006";7;"49.7";479;58192;57713
80;"21.03.2006";8;"84.9";467;63569;63102
80;"21.03.2006";9;"100.1";360;66326;65966
80;"21.03.2006";10;"157.3";410;66871;66461
80;"21.03.2006";11;"169.1";546;67775;67229
80;"21.03.2006";12;"169.4";569;68855;68286
80;"21.03.2006";13;"100.1";578;68024;67446
80;"21.03.2006";14;"100.1";613;67355;66742
80;"21.03.2006";15;"91.5";719;66360;65641
80;"21.03.2006";16;"86.4";841;65296;64455
80;"21.03.2006";17;80;974;63747;62773
80;"21.03.2006";18;"76.2";901;64033;63132
80;"21.03.2006";19;"88.1";762;66391;65629
80;"21.03.2006";20;"109.7";729;68684;67955
80;"21.03.2006";21;"90.2";746;64905;64159
80;"21.03.2006";22;"81.4";725;62175;61450
80;"21.03.2006";23;"72.1";665;60544;59879
80;"21.03.2006";24;"50.5";616;55847;55231
81;"22.03.2006";1;"48.1";586;52384;51798
81;"22.03.2006";2;"45.1";584;50328;49744
81;"22.03.2006";3;"40.7";592;49571;48979
81;"22.03.2006";4;"36.7";592;49577;48985
81;"22.03.2006";5;39;607;50847;50240
81;"22.03.2006";6;50;575;53450;52875
81;"22.03.2006";7;"62.3";596;58469;57873
81;"22.03.2006";8;"84.1";594;64008;63414
81;"22.03.2006";9;96;386;65991;65605
81;"22.03.2006";10;111;353;66332;65979
81;"22.03.2006";11;"106.9";619;67236;66617
81;"22.03.2006";12;"109.8";782;68271;67489
81;"22.03.2006";13;"90.1";814;68007;67193
81;"22.03.2006";14;89;1119;67192;66073
81;"22.03.2006";15;"83.8";1206;66272;65066
81;"22.03.2006";16;"78.6";1393;65133;63740
81;"22.03.2006";17;"76.2";1317;63410;62093
81;"22.03.2006";18;76;1200;63360;62160
81;"22.03.2006";19;82;932;65659;64727
81;"22.03.2006";20;"121.9";955;68701;67746
81;"22.03.2006";21;"88.9";968;65458;64490
81;"22.03.2006";22;"78.7";1038;63077;62039
81;"22.03.2006";23;"61.3";931;61450;60519
81;"22.03.2006";24;"44.6";789;56581;55792
82;"23.03.2006";1;"45.1";756;53287;52531
82;"23.03.2006";2;"43.4";826;51338;50512
82;"23.03.2006";3;"41.6";845;50787;49942
82;"23.03.2006";4;"40.4";796;50765;49969
82;"23.03.2006";5;"40.2";737;51879;51142
82;"23.03.2006";6;"45.1";663;54080;53417
82;"23.03.2006";7;"45.1";647;58187;57540
82;"23.03.2006";8;"79.8";548;62959;62411
82;"23.03.2006";9;90;370;64972;64602
82;"23.03.2006";10;90;347;65176;64829
82;"23.03.2006";11;"89.1";419;66025;65606
82;"23.03.2006";12;"89.1";448;67187;66739
82;"23.03.2006";13;"83.5";456;66325;65869
82;"23.03.2006";14;"64.9";528;65625;65097
82;"23.03.2006";15;76;675;64693;64018
82;"23.03.2006";16;59;790;63411;62621
82;"23.03.2006";17;"48.7";906;61703;60797
82;"23.03.2006";18;"48.9";1057;61914;60857
82;"23.03.2006";19;"68.1";1309;64130;62821
82;"23.03.2006";20;"90.2";2016;68065;66049
82;"23.03.2006";21;78;3030;64803;61773
82;"23.03.2006";22;"52.5";3657;62127;58470
82;"23.03.2006";23;"48.3";4151;60477;56326
82;"23.03.2006";24;"42.2";4667;56097;51430
83;"24.03.2006";1;"57.6";5061;53291;48230
83;"24.03.2006";2;"47.3";4848;51483;46635
83;"24.03.2006";3;"44.1";4682;50333;45651
83;"24.03.2006";4;"38.4";4849;50682;45833
83;"24.03.2006";5;"41.7";4808;51643;46835
83;"24.03.2006";6;"46.6";4899;53673;48774
83;"24.03.2006";7;"60.9";5164;57749;52585
83;"24.03.2006";8;74;4999;62611;57612
83;"24.03.2006";9;"75.9";4444;65135;60691
83;"24.03.2006";10;"77.1";4479;65737;61258
83;"24.03.2006";11;"76.2";4896;66687;61791
83;"24.03.2006";12;"76.3";5824;67818;61994
83;"24.03.2006";13;74;6186;67011;60825
83;"24.03.2006";14;65;6394;65638;59244
83;"24.03.2006";15;"57.5";6305;64355;58050
83;"24.03.2006";16;"55.2";6278;63228;56950
83;"24.03.2006";17;"52.7";6015;62194;56179
83;"24.03.2006";18;"52.9";5468;62505;57037
83;"24.03.2006";19;56;5139;64801;59662
83;"24.03.2006";20;"65.1";5053;66653;61600
83;"24.03.2006";21;"51.5";4748;62406;57658
83;"24.03.2006";22;"51.5";4379;59387;55008
83;"24.03.2006";23;"56.2";3991;58419;54428
83;"24.03.2006";24;"49.1";3630;54409;50779
84;"25.03.2006";1;50;3059;50193;47134
84;"25.03.2006";2;"44.5";2915;47642;44727
84;"25.03.2006";3;"33.3";2658;46228;43570
84;"25.03.2006";4;"24.9";2600;45920;43320
84;"25.03.2006";5;"29.1";2912;46429;43517
84;"25.03.2006";6;"35.2";3063;45983;42920
84;"25.03.2006";7;"28.1";2950;44581;41631
84;"25.03.2006";8;45;3014;47991;44977
84;"25.03.2006";9;"49.1";3219;52433;49214
84;"25.03.2006";10;"50.5";3335;55492;52157
84;"25.03.2006";11;"56.7";3545;57123;53578
84;"25.03.2006";12;"63.1";3937;58351;54414
84;"25.03.2006";13;55;3845;56806;52961
84;"25.03.2006";14;"51.1";3881;54740;50859
84;"25.03.2006";15;"46.4";3641;52818;49177
84;"25.03.2006";16;47;3339;52051;48712
84;"25.03.2006";17;45;2882;51115;48233
84;"25.03.2006";18;"42.3";2590;52486;49896
84;"25.03.2006";19;"50.5";2395;55591;53196
84;"25.03.2006";20;"69.9";2279;57685;55406
84;"25.03.2006";21;"52.1";2127;54034;51907
84;"25.03.2006";22;"42.3";2485;51770;49285
84;"25.03.2006";23;"48.7";2471;51808;49337
84;"25.03.2006";24;"36.8";2420;47976;45556
85;"26.03.2006";1;"40.4";2689;44014;41325
85;"26.03.2006";2;"29.1";3170;41445;38275
85;"26.03.2006";3;"29.1";3170;41445;38275
85;"26.03.2006";4;"19.3";3693;40535;36842
85;"26.03.2006";5;"19.5";4166;40714;36548
85;"26.03.2006";6;"25.1";4501;40985;36484
85;"26.03.2006";7;"6.5";5148;39301;34153
85;"26.03.2006";8;"2.3";6141;39120;32979
85;"26.03.2006";9;"20.6";6705;42213;35508
85;"26.03.2006";10;"31.7";7335;46554;39219
85;"26.03.2006";11;37;7783;50059;42276
85;"26.03.2006";12;"45.6";8170;52906;44736
85;"26.03.2006";13;"45.6";8046;52347;44301
85;"26.03.2006";14;"37.4";7945;50033;42088
85;"26.03.2006";15;"32.1";7687;48104;40417
85;"26.03.2006";16;"28.5";7131;46659;39528
85;"26.03.2006";17;"27.5";6230;45487;39257
85;"26.03.2006";18;"31.5";5004;45662;40658
85;"26.03.2006";19;"36.6";4030;48220;44190
85;"26.03.2006";20;"44.2";3374;50847;47473
85;"26.03.2006";21;"52.6";2843;53822;50979
85;"26.03.2006";22;"50.1";3110;52618;49508
85;"26.03.2006";23;"51.8";3362;53050;49688
85;"26.03.2006";24;"38.3";3656;49117;45461
86;"27.03.2006";1;"27.9";3387;44819;41432
86;"27.03.2006";2;"19.2";3532;42126;38594
86;"27.03.2006";3;"15.1";3465;40870;37405
86;"27.03.2006";4;13;3252;41370;38118
86;"27.03.2006";5;"24.4";3569;43797;40228
86;"27.03.2006";6;"32.2";3941;47913;43972
86;"27.03.2006";7;"42.2";4521;56375;51854
86;"27.03.2006";8;63;4320;61656;57336
86;"27.03.2006";9;"64.4";4842;64578;59736
86;"27.03.2006";10;"69.1";4779;65297;60518
86;"27.03.2006";11;"66.8";5490;66757;61267
86;"27.03.2006";12;68;6184;68157;61973
86;"27.03.2006";13;"63.7";6388;67056;60668
86;"27.03.2006";14;"67.4";6528;66452;59924
86;"27.03.2006";15;"60.3";6674;65174;58500
86;"27.03.2006";16;56;6765;63947;57182
86;"27.03.2006";17;48;7347;61625;54278
86;"27.03.2006";18;"45.6";7541;61342;53801
86;"27.03.2006";19;48;7453;62240;54787
86;"27.03.2006";20;"50.1";7054;62875;55821
86;"27.03.2006";21;"60.6";6995;63412;56417
86;"27.03.2006";22;"53.5";7530;61177;53647
86;"27.03.2006";23;48;8418;58317;49899
86;"27.03.2006";24;"39.5";9126;53651;44525
87;"28.03.2006";1;"5.3";8912;49708;40796
87;"28.03.2006";2;"0.6";8992;47236;38244
87;"28.03.2006";3;"0.2";8857;46459;37602
87;"28.03.2006";4;"0.4";8445;46872;38427
87;"28.03.2006";5;"0.6";7879;48365;40486
87;"28.03.2006";6;"8.6";7648;51684;44036
87;"28.03.2006";7;"47.3";7658;58591;50933
87;"28.03.2006";8;"52.9";7635;63900;56265
87;"28.03.2006";9;51;7482;66474;58992
87;"28.03.2006";10;"49.7";7471;66779;59308
87;"28.03.2006";11;51;8425;68011;59586
87;"28.03.2006";12;58;9392;69359;59967
87;"28.03.2006";13;51;9903;68407;58504
87;"28.03.2006";14;"57.8";9716;67409;57693
87;"28.03.2006";15;"49.8";9604;66336;56732
87;"28.03.2006";16;50;8606;64684;56078
87;"28.03.2006";17;"48.7";7687;62806;55119
87;"28.03.2006";18;"48.2";6392;62090;55698
87;"28.03.2006";19;"46.2";5076;61963;56887
87;"28.03.2006";20;"49.1";3883;62794;58911
87;"28.03.2006";21;"68.1";3642;63862;60220
87;"28.03.2006";22;"55.8";3905;61028;57123
87;"28.03.2006";23;"49.7";4614;58013;53399
87;"28.03.2006";24;"40.6";5426;53380;47954
88;"29.03.2006";1;"38.7";5974;49107;43133
88;"29.03.2006";2;"30.9";6287;46779;40492
88;"29.03.2006";3;20;6500;46181;39681
88;"29.03.2006";4;"13.9";6569;46792;40223
88;"29.03.2006";5;"14.9";6337;48393;42056
88;"29.03.2006";6;"32.5";6635;51480;44845
88;"29.03.2006";7;36;6616;58614;51998
88;"29.03.2006";8;"49.1";6771;63493;56722
88;"29.03.2006";9;"51.4";6721;66102;59381
88;"29.03.2006";10;55;7249;66676;59427
88;"29.03.2006";11;"57.3";7817;67526;59709
88;"29.03.2006";12;"55.9";8615;69381;60766
88;"29.03.2006";13;55;8793;68638;59845
88;"29.03.2006";14;"51.1";8807;67871;59064
88;"29.03.2006";15;"55.9";9032;66592;57560
88;"29.03.2006";16;"49.4";9069;65469;56400
88;"29.03.2006";17;"42.2";8331;63595;55264
88;"29.03.2006";18;43;7177;62559;55382
88;"29.03.2006";19;45;5971;62170;56199
88;"29.03.2006";20;"47.1";4632;62678;58046
88;"29.03.2006";21;55;3543;63676;60133
88;"29.03.2006";22;"48.8";2715;61113;58398
88;"29.03.2006";23;"49.7";2592;58394;55802
88;"29.03.2006";24;"47.3";2569;53580;51011
89;"30.03.2006";1;43;2870;49868;46998
89;"30.03.2006";2;"34.1";3182;47564;44382
89;"30.03.2006";3;"32.5";3206;46492;43286
89;"30.03.2006";4;"19.2";3672;47159;43487
89;"30.03.2006";5;"29.2";4066;48754;44688
89;"30.03.2006";6;"42.4";4654;51605;46951
89;"30.03.2006";7;"51.5";5494;58633;53139
89;"30.03.2006";8;"64.4";6602;63805;57203
89;"30.03.2006";9;"68.9";7445;66569;59124
89;"30.03.2006";10;"60.9";8199;67303;59104
89;"30.03.2006";11;64;8745;68918;60173
89;"30.03.2006";12;"64.9";9620;70270;60650
89;"30.03.2006";13;"57.7";10483;69606;59123
89;"30.03.2006";14;"55.1";11120;69181;58061
89;"30.03.2006";15;"49.1";10964;67770;56806
89;"30.03.2006";16;"47.2";10566;66579;56013
89;"30.03.2006";17;46;10316;64967;54651
89;"30.03.2006";18;"44.9";9851;64097;54246
89;"30.03.2006";19;"43.9";8419;63670;55251
89;"30.03.2006";20;"44.6";7562;64440;56878
89;"30.03.2006";21;"58.1";7423;64795;57372
89;"30.03.2006";22;"49.9";7710;62091;54381
89;"30.03.2006";23;46;7527;59633;52106
89;"30.03.2006";24;"35.1";7279;54144;46865
90;"31.03.2006";1;"38.6";7662;49822;42160
90;"31.03.2006";2;"32.4";7862;47151;39289
90;"31.03.2006";3;"18.2";7821;45802;37981
90;"31.03.2006";4;10;8203;46582;38379
90;"31.03.2006";5;"3.9";8577;48094;39517
90;"31.03.2006";6;"31.6";9017;51576;42559
90;"31.03.2006";7;"44.6";9422;58261;48839
90;"31.03.2006";8;"51.9";10422;63838;53416
90;"31.03.2006";9;"49.7";10755;66755;56000
90;"31.03.2006";10;"52.5";11478;67212;55734
90;"31.03.2006";11;"53.7";12393;68153;55760
90;"31.03.2006";12;"52.6";13295;69322;56027
90;"31.03.2006";13;"54.1";13706;68420;54714
90;"31.03.2006";14;50;13745;66973;53228
90;"31.03.2006";15;"45.1";13865;65124;51259
90;"31.03.2006";16;"37.4";13618;63818;50200
90;"31.03.2006";17;"37.9";12806;62300;49494
90;"31.03.2006";18;37;12240;61848;49608
90;"31.03.2006";19;"38.9";10589;61708;51119
90;"31.03.2006";20;"43.5";8577;61753;53176
90;"31.03.2006";21;"49.9";7387;62562;55175
90;"31.03.2006";22;"49.6";6666;60353;53687
90;"31.03.2006";23;"47.9";5655;58253;52598
90;"31.03.2006";24;"43.9";5352;53988;48636
91;"01.04.2006";1;37;4869;49582;44713
91;"01.04.2006";2;"31.8";4802;46789;41987
91;"01.04.2006";3;"40.1";4561;45099;40538
91;"01.04.2006";4;"34.9";4595;45110;40515
91;"01.04.2006";5;"33.9";4595;45928;41333
91;"01.04.2006";6;"43.4";4317;45948;41631
91;"01.04.2006";7;"38.2";4298;45907;41609
91;"01.04.2006";8;"43.5";4142;47786;43644
91;"01.04.2006";9;"50.4";4108;51969;47861
91;"01.04.2006";10;"58.2";4123;55194;51071
91;"01.04.2006";11;"57.4";4370;56538;52168
91;"01.04.2006";12;"52.4";4895;57230;52335
91;"01.04.2006";13;"52.8";5414;55844;50430
91;"01.04.2006";14;"49.2";6527;54201;47674
91;"01.04.2006";15;"44.9";6421;52443;46022
91;"01.04.2006";16;"41.7";6373;51494;45121
91;"01.04.2006";17;"39.3";6606;51029;44423
91;"01.04.2006";18;"40.1";6076;51637;45561
91;"01.04.2006";19;"39.4";5100;52194;47094
91;"01.04.2006";20;"37.1";4585;52704;48119
91;"01.04.2006";21;"46.5";4427;53599;49172
91;"01.04.2006";22;"43.7";4012;51920;47908
91;"01.04.2006";23;"45.7";4170;51261;47091
91;"01.04.2006";24;"37.9";4270;47854;43584
92;"02.04.2006";1;"32.7";4578;43854;39276
92;"02.04.2006";2;24;4670;41026;36356
92;"02.04.2006";3;"21.3";4602;39824;35222
92;"02.04.2006";4;"18.1";4451;39564;35113
92;"02.04.2006";5;"17.6";4606;40390;35784
92;"02.04.2006";6;20;4550;40245;35695
92;"02.04.2006";7;"6.9";4433;38707;34274
92;"02.04.2006";8;"2.4";4430;39552;35122
92;"02.04.2006";9;"10.6";4025;42963;38938
92;"02.04.2006";10;"28.5";3681;46011;42330
92;"02.04.2006";11;"35.5";4098;48807;44709
92;"02.04.2006";12;45;4831;51906;47075
92;"02.04.2006";13;"44.1";6173;51407;45234
92;"02.04.2006";14;"33.1";6797;49555;42758
92;"02.04.2006";15;"30.1";7013;47452;40439
92;"02.04.2006";16;23;7165;46518;39353
92;"02.04.2006";17;"19.2";7239;46045;38806
92;"02.04.2006";18;"24.9";7418;47295;39877
92;"02.04.2006";19;"32.3";6402;48952;42550
92;"02.04.2006";20;"38.4";6082;50706;44624
92;"02.04.2006";21;50;5409;53320;47911
92;"02.04.2006";22;"45.1";4647;52772;48125
92;"02.04.2006";23;"46.7";4996;52385;47389
92;"02.04.2006";24;"34.8";5186;48421;43235
93;"03.04.2006";1;"28.9";5406;44722;39316
93;"03.04.2006";2;"19.9";5693;42507;36814
93;"03.04.2006";3;"4.2";5631;41919;36288
93;"03.04.2006";4;"3.1";5763;42639;36876
93;"03.04.2006";5;"12.8";5568;44271;38703
93;"03.04.2006";6;"31.2";5788;48567;42779
93;"03.04.2006";7;"46.9";5972;56745;50773
93;"03.04.2006";8;"56.6";6024;62150;56126
93;"03.04.2006";9;"53.6";5735;64879;59144
93;"03.04.2006";10;"59.1";6727;65817;59090
93;"03.04.2006";11;"63.4";7849;67331;59482
93;"03.04.2006";12;67;8421;68886;60465
93;"03.04.2006";13;"61.1";8844;68519;59675
93;"03.04.2006";14;59;9185;67898;58713
93;"03.04.2006";15;"56.4";9183;66847;57664
93;"03.04.2006";16;"51.4";9070;65891;56821
93;"03.04.2006";17;"49.7";8657;64094;55437
93;"03.04.2006";18;"49.7";7843;63566;55723
93;"03.04.2006";19;"49.9";6897;63412;56515
93;"03.04.2006";20;"48.3";5677;63391;57714
93;"03.04.2006";21;"57.3";4344;64272;59928
93;"03.04.2006";22;"49.1";3197;61860;58663
93;"03.04.2006";23;"47.9";2497;58766;56269
93;"03.04.2006";24;"41.6";2216;53851;51635
94;"04.04.2006";1;"44.4";2241;49724;47483
94;"04.04.2006";2;"36.7";2244;47494;45250
94;"04.04.2006";3;"40.7";2265;46710;44445
94;"04.04.2006";4;"37.8";2568;47504;44936
94;"04.04.2006";5;"37.9";2483;48888;46405
94;"04.04.2006";6;"41.7";2534;52140;49606
94;"04.04.2006";7;"44.2";2798;58530;55732
94;"04.04.2006";8;"67.9";2582;63394;60812
94;"04.04.2006";9;"69.9";2528;65991;63463
94;"04.04.2006";10;78;2979;66224;63245
94;"04.04.2006";11;"77.7";3512;67317;63805
94;"04.04.2006";12;"78.7";4281;68523;64242
94;"04.04.2006";13;70;4594;67580;62986
94;"04.04.2006";14;"69.9";5644;67035;61391
94;"04.04.2006";15;"68.8";6502;66030;59528
94;"04.04.2006";16;"47.1";6506;64663;58157
94;"04.04.2006";17;"44.2";6901;62726;55825
94;"04.04.2006";18;"42.2";6873;62305;55432
94;"04.04.2006";19;"42.8";5900;61902;56002
94;"04.04.2006";20;"44.2";5058;62419;57361
94;"04.04.2006";21;64;4345;63832;59487
94;"04.04.2006";22;"49.1";4015;61776;57761
94;"04.04.2006";23;"44.8";3626;59236;55610
94;"04.04.2006";24;"47.1";3640;54133;50493
95;"05.04.2006";1;"39.4";3784;49943;46159
95;"05.04.2006";2;"34.1";3878;47898;44020
95;"05.04.2006";3;"30.3";3862;46797;42935
95;"05.04.2006";4;"24.8";3800;47411;43611
95;"05.04.2006";5;"26.8";3884;48980;45096
95;"05.04.2006";6;"36.9";3895;52225;48330
95;"05.04.2006";7;50;3822;58546;54724
95;"05.04.2006";8;"57.6";3422;63643;60221
95;"05.04.2006";9;"66.3";2976;66050;63074
95;"05.04.2006";10;70;2984;66641;63657
95;"05.04.2006";11;"74.6";3543;67957;64414
95;"05.04.2006";12;"82.9";3946;69266;65320
95;"05.04.2006";13;"78.1";4128;68309;64181
95;"05.04.2006";14;"75.4";4507;67741;63234
95;"05.04.2006";15;"70.1";4571;66475;61904
95;"05.04.2006";16;"70.1";4734;65116;60382
95;"05.04.2006";17;"59.9";4811;63332;58521
95;"05.04.2006";18;"59.3";4936;62816;57880
95;"05.04.2006";19;53;4178;62476;58298
95;"05.04.2006";20;"59.7";3341;62657;59316
95;"05.04.2006";21;"63.8";2222;63751;61529
95;"05.04.2006";22;63;2039;61742;59703
95;"05.04.2006";23;"61.9";2194;59700;57506
95;"05.04.2006";24;"45.1";2310;54943;52633
96;"06.04.2006";1;47;2455;51640;49185
96;"06.04.2006";2;"42.2";2478;49584;47106
96;"06.04.2006";3;"40.7";2149;48657;46508
96;"06.04.2006";4;"37.3";1906;49126;47220
96;"06.04.2006";5;"37.9";1888;50503;48615
96;"06.04.2006";6;"45.9";1843;53041;51198
96;"06.04.2006";7;52;1959;58992;57033
96;"06.04.2006";8;"69.2";2139;63321;61182
96;"06.04.2006";9;62;1967;65264;63297
96;"06.04.2006";10;"65.1";2134;65549;63415
96;"06.04.2006";11;66;2907;66095;63188
96;"06.04.2006";12;66;3536;67199;63663
96;"06.04.2006";13;55;4244;66690;62446
96;"06.04.2006";14;"50.6";4648;65728;61080
96;"06.04.2006";15;"46.7";4755;64346;59591
96;"06.04.2006";16;"44.6";4847;63201;58354
96;"06.04.2006";17;"44.1";5022;61950;56928
96;"06.04.2006";18;44;4796;61727;56931
96;"06.04.2006";19;44;4366;61733;57367
96;"06.04.2006";20;"44.4";4088;61615;57527
96;"06.04.2006";21;58;3821;63375;59554
96;"06.04.2006";22;"50.9";3960;61716;57756
96;"06.04.2006";23;"46.8";4287;59312;55025
96;"06.04.2006";24;"44.3";4828;54570;49742
97;"07.04.2006";1;"44.1";5208;50753;45545
97;"07.04.2006";2;42;5351;48390;43039
97;"07.04.2006";3;"39.9";5084;47428;42344
97;"07.04.2006";4;"37.9";4826;47814;42988
97;"07.04.2006";5;"39.3";4552;49322;44770
97;"07.04.2006";6;44;4452;52419;47967
97;"07.04.2006";7;"50.9";4579;58580;54001
97;"07.04.2006";8;"61.3";4016;63108;59092
97;"07.04.2006";9;"67.1";3386;65451;62065
97;"07.04.2006";10;"65.6";2822;65606;62784
97;"07.04.2006";11;68;3052;66094;63042
97;"07.04.2006";12;"69.8";3504;66648;63144
97;"07.04.2006";13;"56.1";3949;65290;61341
97;"07.04.2006";14;"52.1";3753;63761;60008
97;"07.04.2006";15;"51.9";3218;61866;58648
97;"07.04.2006";16;50;2982;60250;57268
97;"07.04.2006";17;"48.4";2606;59247;56641
97;"07.04.2006";18;"47.9";2218;59293;57075
97;"07.04.2006";19;"49.9";1731;59138;57407
97;"07.04.2006";20;"48.9";1161;59242;58081
97;"07.04.2006";21;"54.8";1045;60233;59188
97;"07.04.2006";22;"51.9";1228;58625;57397
97;"07.04.2006";23;54;1642;56730;55088
97;"07.04.2006";24;"48.8";2234;52938;50704
98;"08.04.2006";1;"43.7";2848;49070;46222
98;"08.04.2006";2;"38.3";3512;46827;43315
98;"08.04.2006";3;36;4150;45238;41088
98;"08.04.2006";4;36;4302;45214;40912
98;"08.04.2006";5;31;4911;46259;41348
98;"08.04.2006";6;"33.9";5256;46380;41124
98;"08.04.2006";7;33;5670;46008;40338
98;"08.04.2006";8;38;5944;48129;42185
98;"08.04.2006";9;"43.1";6060;51609;45549
98;"08.04.2006";10;47;6407;54303;47896
98;"08.04.2006";11;"47.9";7842;55643;47801
98;"08.04.2006";12;45;9667;56404;46737
98;"08.04.2006";13;47;11252;55394;44142
98;"08.04.2006";14;"43.9";11562;53660;42098
98;"08.04.2006";15;"38.8";11114;51990;40876
98;"08.04.2006";16;"37.4";10501;51145;40644
98;"08.04.2006";17;"35.9";9741;50577;40836
98;"08.04.2006";18;37;8221;50977;42756
98;"08.04.2006";19;39;6573;51460;44887
98;"08.04.2006";20;"42.3";4751;51450;46699
98;"08.04.2006";21;"53.3";3451;52124;48673
98;"08.04.2006";22;"44.7";3008;51076;48068
98;"08.04.2006";23;"47.8";3336;50125;46789
98;"08.04.2006";24;"38.3";3708;46965;43257
99;"09.04.2006";1;34;3874;43315;39441
99;"09.04.2006";2;"26.1";3917;40514;36597
99;"09.04.2006";3;21;4001;39124;35123
99;"09.04.2006";4;"17.1";4348;39159;34811
99;"09.04.2006";5;"16.3";4694;39700;35006
99;"09.04.2006";6;"16.1";5074;39761;34687
99;"09.04.2006";7;"3.1";5239;38158;32919
99;"09.04.2006";8;"3.4";5180;39138;33958
99;"09.04.2006";9;"19.1";5375;42748;37373
99;"09.04.2006";10;"34.9";7028;46664;39636
99;"09.04.2006";11;"36.9";8467;49724;41257
99;"09.04.2006";12;"43.3";9516;52790;43274
99;"09.04.2006";13;"42.1";9985;52057;42072
99;"09.04.2006";14;"34.9";10495;49929;39434
99;"09.04.2006";15;28;9725;47931;38206
99;"09.04.2006";16;"28.1";9692;46852;37160
99;"09.04.2006";17;"18.2";8747;46290;37543
99;"09.04.2006";18;"23.3";7769;47018;39249
99;"09.04.2006";19;"34.9";6401;48494;42093
99;"09.04.2006";20;41;4791;49042;44251
99;"09.04.2006";21;47;3668;51020;47352
99;"09.04.2006";22;44;3181;51183;48002
99;"09.04.2006";23;"46.9";2957;51634;48677
99;"09.04.2006";24;"40.5";2759;48271;45512
100;"10.04.2006";1;"25.9";2433;44830;42397
100;"10.04.2006";2;"23.3";2393;42589;40196
100;"10.04.2006";3;"20.1";2163;42016;39853
100;"10.04.2006";4;"17.7";1900;42770;40870
100;"10.04.2006";5;"19.9";1554;44651;43097
100;"10.04.2006";6;"32.7";1383;48306;46923
100;"10.04.2006";7;"50.1";1365;54839;53474
100;"10.04.2006";8;"58.4";1181;60605;59424
100;"10.04.2006";9;"55.9";1179;64440;63261
100;"10.04.2006";10;"58.9";1240;65576;64336
100;"10.04.2006";11;"59.9";1351;67104;65753
100;"10.04.2006";12;"64.6";1411;68513;67102
100;"10.04.2006";13;61;1498;67915;66417
100;"10.04.2006";14;59;1820;66947;65127
100;"10.04.2006";15;"56.7";2134;65685;63551
100;"10.04.2006";16;"53.1";2474;64223;61749
100;"10.04.2006";17;"51.6";3097;62632;59535
100;"10.04.2006";18;"50.2";3484;61966;58482
100;"10.04.2006";19;"49.1";3557;61982;58425
100;"10.04.2006";20;"50.1";3509;61875;58366
100;"10.04.2006";21;"57.5";3117;62594;59477
100;"10.04.2006";22;"54.1";2836;61220;58384
100;"10.04.2006";23;51;2434;58801;56367
100;"10.04.2006";24;"46.5";2295;54274;51979
101;"11.04.2006";1;"48.2";2402;50648;48246
101;"11.04.2006";2;"40.9";2097;48587;46490
101;"11.04.2006";3;37;2065;48053;45988
101;"11.04.2006";4;"37.3";1879;48459;46580
101;"11.04.2006";5;"39.7";1805;49931;48126
101;"11.04.2006";6;"46.5";1753;52371;50618
101;"11.04.2006";7;"53.1";1847;57227;55380
101;"11.04.2006";8;"69.7";1442;62043;60601
101;"11.04.2006";9;73;1062;65113;64051
101;"11.04.2006";10;"68.8";947;65791;64844
101;"11.04.2006";11;"75.6";1195;66965;65770
101;"11.04.2006";12;"91.6";1317;67957;66640
101;"11.04.2006";13;"82.6";1374;66790;65416
101;"11.04.2006";14;"82.5";1442;65804;64362
101;"11.04.2006";15;"69.7";1504;64575;63071
101;"11.04.2006";16;"61.3";1638;63170;61532
101;"11.04.2006";17;53;1869;61448;59579
101;"11.04.2006";18;"53.1";1959;60906;58947
101;"11.04.2006";19;"54.1";1951;60962;59011
101;"11.04.2006";20;"52.4";1979;61232;59253
101;"11.04.2006";21;"62.9";2124;62085;59961
101;"11.04.2006";22;"51.7";2479;60377;57898
101;"11.04.2006";23;"53.1";2861;58254;55393
101;"11.04.2006";24;"47.5";3358;53176;49818
102;"12.04.2006";1;42;3788;49375;45587
102;"12.04.2006";2;40;4096;47237;43141
102;"12.04.2006";3;"37.4";4117;46473;42356
102;"12.04.2006";4;"31.8";3934;46734;42800
102;"12.04.2006";5;"34.1";3671;48135;44464
102;"12.04.2006";6;"40.8";3483;50751;47268
102;"12.04.2006";7;"44.1";3314;56285;52971
102;"12.04.2006";8;"57.9";3136;61588;58452
102;"12.04.2006";9;68;2672;65239;62567
102;"12.04.2006";10;"73.6";2407;66469;64062
102;"12.04.2006";11;68;2490;67998;65508
102;"12.04.2006";12;"74.1";2402;68990;66588
102;"12.04.2006";13;"66.9";2508;67848;65340
102;"12.04.2006";14;"60.1";2388;66804;64416
102;"12.04.2006";15;54;2368;65629;63261
102;"12.04.2006";16;"51.3";2045;64054;62009
102;"12.04.2006";17;51;2233;62499;60266
102;"12.04.2006";18;"47.5";2098;62062;59964
102;"12.04.2006";19;49;1834;61696;59862
102;"12.04.2006";20;"49.9";1454;61514;60060
102;"12.04.2006";21;"55.4";1177;62105;60928
102;"12.04.2006";22;"52.3";1298;61002;59704
102;"12.04.2006";23;"51.9";1586;58875;57289
102;"12.04.2006";24;"47.9";1967;54225;52258
103;"13.04.2006";1;42;2514;50645;48131
103;"13.04.2006";2;"37.5";2790;48092;45302
103;"13.04.2006";3;"32.2";3106;47280;44174
103;"13.04.2006";4;"26.7";3616;47768;44152
103;"13.04.2006";5;"28.5";3986;49225;45239
103;"13.04.2006";6;"37.5";4425;51536;47111
103;"13.04.2006";7;"41.9";5201;56300;51099
103;"13.04.2006";8;"50.5";5676;61036;55360
103;"13.04.2006";9;"51.9";6221;64396;58175
103;"13.04.2006";10;55;6850;65710;58860
103;"13.04.2006";11;55;7468;67153;59685
103;"13.04.2006";12;"58.9";8100;68674;60574
103;"13.04.2006";13;"57.9";8008;67961;59953
103;"13.04.2006";14;"55.4";8216;66888;58672
103;"13.04.2006";15;"50.6";8455;65855;57400
103;"13.04.2006";16;48;8629;64992;56363
103;"13.04.2006";17;"44.3";8147;63318;55171
103;"13.04.2006";18;"49.4";7960;62452;54492
103;"13.04.2006";19;"49.4";7426;62296;54870
103;"13.04.2006";20;"46.7";7185;61648;54463
103;"13.04.2006";21;54;7086;60853;53767
103;"13.04.2006";22;"49.9";7610;58439;50829
103;"13.04.2006";23;"45.5";8109;55987;47878
103;"13.04.2006";24;"38.1";8598;51715;43117
104;"14.04.2006";1;"39.8";8385;48337;39952
104;"14.04.2006";2;"28.8";8163;45723;37560
104;"14.04.2006";3;"31.1";8223;44498;36275
104;"14.04.2006";4;17;7665;43893;36228
104;"14.04.2006";5;"19.8";7633;44107;36474
104;"14.04.2006";6;"27.4";7155;42927;35772
104;"14.04.2006";7;"23.1";6886;40400;33514
104;"14.04.2006";8;"34.4";6317;41305;34988
104;"14.04.2006";9;34;6452;44311;37859
104;"14.04.2006";10;"39.1";7268;47863;40595
104;"14.04.2006";11;"46.8";8382;50624;42242
104;"14.04.2006";12;"49.2";9272;53539;44267
104;"14.04.2006";13;"48.6";9563;53208;43645
104;"14.04.2006";14;"45.3";9385;50758;41373
104;"14.04.2006";15;"30.5";9474;48758;39284
104;"14.04.2006";16;"26.9";9116;47072;37956
104;"14.04.2006";17;"27.3";9091;46065;36974
104;"14.04.2006";18;"34.5";8704;46681;37977
104;"14.04.2006";19;"36.2";7587;47523;39936
104;"14.04.2006";20;"45.2";6322;47777;41455
104;"14.04.2006";21;51;4813;48803;43990
104;"14.04.2006";22;"47.8";3866;49474;45608
104;"14.04.2006";23;"49.1";3480;49559;46079
104;"14.04.2006";24;"36.2";3542;46208;42666
105;"15.04.2006";1;"23.9";3335;42352;39017
105;"15.04.2006";2;"20.6";3319;40691;37372
105;"15.04.2006";3;"16.3";2921;39965;37044
105;"15.04.2006";4;"16.6";2248;40126;37878
105;"15.04.2006";5;"19.2";1794;40863;39069
105;"15.04.2006";6;"19.7";1273;40830;39557
105;"15.04.2006";7;"21.1";854;39520;38666
105;"15.04.2006";8;"32.6";801;41659;40858
105;"15.04.2006";9;"38.7";725;45566;44841
105;"15.04.2006";10;"48.4";718;48517;47799
105;"15.04.2006";11;50;538;49585;49047
105;"15.04.2006";12;50;602;50432;49830
105;"15.04.2006";13;"49.5";701;49772;49071
105;"15.04.2006";14;"47.8";840;48254;47414
105;"15.04.2006";15;"43.8";1013;47176;46163
105;"15.04.2006";16;"42.5";1234;46797;45563
105;"15.04.2006";17;"37.9";1692;46518;44826
105;"15.04.2006";18;"40.1";1926;47605;45679
105;"15.04.2006";19;"41.1";1784;48315;46531
105;"15.04.2006";20;41;1896;48590;46694
105;"15.04.2006";21;"48.5";2351;48809;46458
105;"15.04.2006";22;48;3078;48138;45060
105;"15.04.2006";23;"47.1";3334;47394;44060
105;"15.04.2006";24;33;3545;44006;40461
106;"16.04.2006";1;"24.3";3480;40198;36718
106;"16.04.2006";2;"21.3";3519;37383;33864
106;"16.04.2006";3;"16.1";3605;35816;32211
106;"16.04.2006";4;15;3828;35118;31290
106;"16.04.2006";5;"14.1";3533;35675;32142
106;"16.04.2006";6;"14.1";3542;35969;32427
106;"16.04.2006";7;"3.9";3482;34345;30863
106;"16.04.2006";8;"4.4";3440;35614;32174
106;"16.04.2006";9;"15.5";3469;39587;36118
106;"16.04.2006";10;"24.3";3589;43009;39420
106;"16.04.2006";11;"37.4";4009;45519;41510
106;"16.04.2006";12;"42.7";3894;48183;44289
106;"16.04.2006";13;"39.2";4167;46634;42467
106;"16.04.2006";14;"25.6";4474;43640;39166
106;"16.04.2006";15;"17.3";4772;42102;37330
106;"16.04.2006";16;"10.9";5108;40940;35832
106;"16.04.2006";17;"7.9";5166;39965;34799
106;"16.04.2006";18;"6.9";4817;40523;35706
106;"16.04.2006";19;"18.2";4950;42780;37830
106;"16.04.2006";20;"30.6";5104;43704;38600
106;"16.04.2006";21;41;4682;45490;40808
106;"16.04.2006";22;"42.1";4347;46479;42132
106;"16.04.2006";23;"44.2";4227;46326;42099
106;"16.04.2006";24;"27.1";3858;43254;39396
107;"17.04.2006";1;"22.9";3370;39439;36069
107;"17.04.2006";2;"17.8";3204;36764;33560
107;"17.04.2006";3;13;3119;35392;32273
107;"17.04.2006";4;"12.9";2543;35331;32788
107;"17.04.2006";5;"14.5";2295;36267;33972
107;"17.04.2006";6;"18.8";2206;36697;34491
107;"17.04.2006";7;"5.2";2073;35202;33129
107;"17.04.2006";8;"5.4";2001;35936;33935
107;"17.04.2006";9;"12.3";1984;39110;37126
107;"17.04.2006";10;"26.8";2145;42344;40199
107;"17.04.2006";11;"28.6";2544;44754;42210
107;"17.04.2006";12;"41.1";3277;47371;44094
107;"17.04.2006";13;"37.7";3980;46592;42612
107;"17.04.2006";14;"27.3";4761;44535;39774
107;"17.04.2006";15;"20.7";5411;42581;37170
107;"17.04.2006";16;"20.7";5991;42199;36208
107;"17.04.2006";17;"16.7";6119;42075;35956
107;"17.04.2006";18;"16.4";5608;43123;37515
107;"17.04.2006";19;26;4559;44651;40092
107;"17.04.2006";20;"36.7";3848;45216;41368
107;"17.04.2006";21;"47.7";2884;46713;43829
107;"17.04.2006";22;"46.4";2548;47927;45379
107;"17.04.2006";23;"48.1";2360;48360;46000
107;"17.04.2006";24;"36.9";2551;45232;42681
108;"18.04.2006";1;"25.7";2676;41757;39081
108;"18.04.2006";2;"19.1";3018;39729;36711
108;"18.04.2006";3;"14.3";3578;39649;36071
108;"18.04.2006";4;"11.6";3689;40223;36534
108;"18.04.2006";5;"18.1";3919;42284;38365
108;"18.04.2006";6;"26.9";3794;45983;42189
108;"18.04.2006";7;"41.9";3741;52165;48424
108;"18.04.2006";8;"56.6";3271;57800;54529
108;"18.04.2006";9;"58.9";2877;61444;58567
108;"18.04.2006";10;"61.1";3236;63216;59980
108;"18.04.2006";11;"60.8";3640;64667;61027
108;"18.04.2006";12;"64.6";4409;66151;61742
108;"18.04.2006";13;61;4335;65172;60837
108;"18.04.2006";14;"59.8";4438;64509;60071
108;"18.04.2006";15;"56.3";4339;63366;59027
108;"18.04.2006";16;"54.9";4501;62495;57994
108;"18.04.2006";17;"51.4";4222;60849;56627
108;"18.04.2006";18;"49.3";3751;60334;56583
108;"18.04.2006";19;"50.3";3084;60325;57241
108;"18.04.2006";20;"50.5";2738;59834;57096
108;"18.04.2006";21;"51.9";1954;59655;57701
108;"18.04.2006";22;49;1496;59153;57657
108;"18.04.2006";23;"49.2";1479;56584;55105
108;"18.04.2006";24;"40.6";1023;51381;50358
109;"19.04.2006";1;42;992;47262;46270
109;"19.04.2006";2;"34.7";921;45062;44141
109;"19.04.2006";3;"29.2";865;44373;43508
109;"19.04.2006";4;"27.7";725;44947;44222
109;"19.04.2006";5;"33.2";671;46804;46133
109;"19.04.2006";6;39;745;49887;49142
109;"19.04.2006";7;"47.5";859;54586;53727
109;"19.04.2006";8;"61.3";927;59826;58899
109;"19.04.2006";9;"59.5";722;63022;62300
109;"19.04.2006";10;"61.4";600;63848;63248
109;"19.04.2006";11;"65.1";828;64591;63763
109;"19.04.2006";12;"69.7";1239;65691;64452
109;"19.04.2006";13;65;1562;64757;63195
109;"19.04.2006";14;65;1733;63747;62014
109;"19.04.2006";15;"59.8";1932;62502;60570
109;"19.04.2006";16;"55.1";2167;61323;59156
109;"19.04.2006";17;"50.4";2153;59801;57648
109;"19.04.2006";18;50;2058;59555;57497
109;"19.04.2006";19;"49.1";1899;59781;57882
109;"19.04.2006";20;"49.1";1774;59685;57911
109;"19.04.2006";21;"50.9";1925;59933;58008
109;"19.04.2006";22;46;2307;59375;57068
109;"19.04.2006";23;"43.6";2600;56609;54009
109;"19.04.2006";24;"41.8";2702;51192;48490
110;"20.04.2006";1;34;2713;47390;44677
110;"20.04.2006";2;"31.2";2457;45231;42774
110;"20.04.2006";3;"26.7";2487;44324;41837
110;"20.04.2006";4;"22.6";2122;44764;42642
110;"20.04.2006";5;"24.4";1844;46489;44645
110;"20.04.2006";6;"36.2";1685;50110;48425
110;"20.04.2006";7;42;1418;54698;53280
110;"20.04.2006";8;"49.9";1171;59635;58464
110;"20.04.2006";9;"52.6";765;62588;61823
110;"20.04.2006";10;"55.2";520;63229;62709
110;"20.04.2006";11;"57.2";610;64386;63776
110;"20.04.2006";12;"61.4";799;65651;64852
110;"20.04.2006";13;55;1091;64710;63619
110;"20.04.2006";14;"53.2";1052;63620;62568
110;"20.04.2006";15;"54.4";896;62428;61532
110;"20.04.2006";16;"52.1";658;60885;60227
110;"20.04.2006";17;"53.6";467;59450;58983
110;"20.04.2006";18;51;275;59228;58953
110;"20.04.2006";19;"50.1";168;59470;59302
110;"20.04.2006";20;"49.5";180;59267;59087
110;"20.04.2006";21;"57.4";272;60003;59731
110;"20.04.2006";22;"59.1";436;59371;58935
110;"20.04.2006";23;"53.1";637;56196;55559
110;"20.04.2006";24;"44.5";695;50692;49997
111;"21.04.2006";1;"40.6";817;46678;45861
111;"21.04.2006";2;"34.5";1017;44345;43328
111;"21.04.2006";3;"32.7";1081;43330;42249
111;"21.04.2006";4;"32.7";1008;43700;42692
111;"21.04.2006";5;"35.1";951;45362;44411
111;"21.04.2006";6;"42.3";908;48764;47856
111;"21.04.2006";7;68;903;54168;53265
111;"21.04.2006";8;"78.5";761;59617;58856
111;"21.04.2006";9;90;519;62719;62200
111;"21.04.2006";10;"91.5";295;63518;63223
111;"21.04.2006";11;"90.1";178;64376;64198
111;"21.04.2006";12;85;171;65347;65176
111;"21.04.2006";13;"80.1";167;64191;64024
111;"21.04.2006";14;"80.9";214;62232;62018
111;"21.04.2006";15;"69.9";279;60329;60050
111;"21.04.2006";16;62;374;58866;58492
111;"21.04.2006";17;"56.4";319;57624;57305
111;"21.04.2006";18;"56.6";388;57643;57255
111;"21.04.2006";19;"54.5";504;57762;57258
111;"21.04.2006";20;"50.9";661;57110;56449
111;"21.04.2006";21;"59.6";999;57404;56405
111;"21.04.2006";22;"56.5";1146;57072;55926
111;"21.04.2006";23;"53.1";1442;54133;52691
111;"21.04.2006";24;"45.9";1342;49344;48002
112;"22.04.2006";1;47;1601;45638;44037
112;"22.04.2006";2;"34.7";1606;43017;41411
112;"22.04.2006";3;"33.3";1524;41649;40125
112;"22.04.2006";4;"33.2";1386;41248;39862
112;"22.04.2006";5;"34.9";1435;41808;40373
112;"22.04.2006";6;"37.9";1746;42765;41019
112;"22.04.2006";7;"32.2";1616;43440;41824
112;"22.04.2006";8;"37.5";1330;46674;45344
112;"22.04.2006";9;50;908;50872;49964
112;"22.04.2006";10;"59.5";986;53839;52853
112;"22.04.2006";11;"61.3";1086;55262;54176
112;"22.04.2006";12;"62.3";1231;56444;55213
112;"22.04.2006";13;63;1487;54890;53403
112;"22.04.2006";14;"55.6";1743;52358;50615
112;"22.04.2006";15;"49.6";1756;50146;48390
112;"22.04.2006";16;"45.9";1778;49289;47511
112;"22.04.2006";17;"45.9";1701;48492;46791
112;"22.04.2006";18;"50.5";1412;49285;47873
112;"22.04.2006";19;"49.9";1517;49965;48448
112;"22.04.2006";20;"52.6";1106;50081;48975
112;"22.04.2006";21;"50.9";829;50196;49367
112;"22.04.2006";22;"48.5";853;50194;49341
112;"22.04.2006";23;"46.1";746;48851;48105
112;"22.04.2006";24;"36.4";564;45125;44561
113;"23.04.2006";1;"32.6";560;41461;40901
113;"23.04.2006";2;16;516;38609;38093
113;"23.04.2006";3;14;420;37379;36959
113;"23.04.2006";4;"11.7";302;37397;37095
113;"23.04.2006";5;12;246;38056;37810
113;"23.04.2006";6;"14.4";252;38145;37893
113;"23.04.2006";7;6;303;36416;36113
113;"23.04.2006";8;8;272;38018;37746
113;"23.04.2006";9;"25.1";221;41553;41332
113;"23.04.2006";10;"33.1";197;45027;44830
113;"23.04.2006";11;"40.7";202;47516;47314
113;"23.04.2006";12;"49.6";169;50061;49892
113;"23.04.2006";13;"43.3";178;48855;48677
113;"23.04.2006";14;"37.8";210;45755;45545
113;"23.04.2006";15;"32.6";263;43844;43581
113;"23.04.2006";16;"27.3";406;42553;42147
113;"23.04.2006";17;"26.8";453;42395;41942
113;"23.04.2006";18;"32.7";388;43553;43165
113;"23.04.2006";19;"36.5";422;45717;45295
113;"23.04.2006";20;"38.9";501;46522;46021
113;"23.04.2006";21;"43.2";425;48195;47770
113;"23.04.2006";22;"47.4";405;49706;49301
113;"23.04.2006";23;"46.5";414;49059;48645
113;"23.04.2006";24;"36.9";416;44882;44466
114;"24.04.2006";1;"32.7";346;41825;41479
114;"24.04.2006";2;20;272;39985;39713
114;"24.04.2006";3;"7.9";243;39693;39450
114;"24.04.2006";4;"10.6";267;40363;40096
114;"24.04.2006";5;"28.2";317;42457;42140
114;"24.04.2006";6;"37.9";215;46840;46625
114;"24.04.2006";7;"50.1";157;54122;53965
114;"24.04.2006";8;"59.1";123;59999;59876
114;"24.04.2006";9;61;94;63272;63178
114;"24.04.2006";10;62;73;63913;63840
114;"24.04.2006";11;66;81;64892;64811
114;"24.04.2006";12;"73.3";81;66215;66134
114;"24.04.2006";13;65;152;65197;65045
114;"24.04.2006";14;66;139;64517;64378
114;"24.04.2006";15;"61.8";187;63061;62874
114;"24.04.2006";16;"57.1";192;61683;61491
114;"24.04.2006";17;"55.1";182;59758;59576
114;"24.04.2006";18;55;229;59218;58989
114;"24.04.2006";19;"53.4";292;59317;59025
114;"24.04.2006";20;"52.2";376;58853;58477
114;"24.04.2006";21;"54.8";726;58962;58236
114;"24.04.2006";22;"53.1";1270;59347;58077
114;"24.04.2006";23;51;1657;55052;53395
114;"24.04.2006";24;"42.2";1734;49411;47677
115;"25.04.2006";1;"37.3";1720;45883;44163
115;"25.04.2006";2;"25.4";1962;43826;41864
115;"25.04.2006";3;"19.9";2094;42661;40567
115;"25.04.2006";4;"4.9";1969;43027;41058
115;"25.04.2006";5;"13.7";1724;44767;43043
115;"25.04.2006";6;"32.4";1557;48507;46950
115;"25.04.2006";7;"40.7";1415;55570;54155
115;"25.04.2006";8;49;1194;61177;59983
115;"25.04.2006";9;"53.1";669;63913;63244
115;"25.04.2006";10;"55.9";313;64125;63812
115;"25.04.2006";11;"60.3";241;64989;64748
115;"25.04.2006";12;67;311;65987;65676
115;"25.04.2006";13;"60.3";372;65211;64839
115;"25.04.2006";14;"58.6";387;64319;63932
115;"25.04.2006";15;52;419;63158;62739
115;"25.04.2006";16;"50.3";510;62013;61503
115;"25.04.2006";17;"47.6";571;60547;59976
115;"25.04.2006";18;"49.7";551;60203;59652
115;"25.04.2006";19;"47.6";635;59934;59299
115;"25.04.2006";20;"46.1";811;59795;58984
115;"25.04.2006";21;50;1207;59571;58364
115;"25.04.2006";22;"47.9";1220;58635;57415
115;"25.04.2006";23;"44.6";1284;54715;53431
115;"25.04.2006";24;"40.9";1208;49145;47937
116;"26.04.2006";1;38;1130;45067;43937
116;"26.04.2006";2;"26.8";1168;42770;41602
116;"26.04.2006";3;"21.4";1216;41725;40509
116;"26.04.2006";4;"9.9";1205;42131;40926
116;"26.04.2006";5;"21.3";1120;43651;42531
116;"26.04.2006";6;"37.9";1018;47914;46896
116;"26.04.2006";7;"52.5";829;55150;54321
116;"26.04.2006";8;"63.7";734;61300;60566
116;"26.04.2006";9;"63.8";531;64459;63928
116;"26.04.2006";10;"68.1";329;65153;64824
116;"26.04.2006";11;"68.1";200;66386;66186
116;"26.04.2006";12;"73.7";175;67790;67615
116;"26.04.2006";13;"66.1";243;66628;66385
116;"26.04.2006";14;"65.7";255;65702;65447
116;"26.04.2006";15;64;276;64369;64093
116;"26.04.2006";16;58;411;63083;62672
116;"26.04.2006";17;"53.3";511;61530;61019
116;"26.04.2006";18;"50.9";700;61507;60807
116;"26.04.2006";19;"50.9";798;61643;60845
116;"26.04.2006";20;"47.6";827;60848;60021
116;"26.04.2006";21;"56.5";981;60384;59403
116;"26.04.2006";22;"56.5";1049;59405;58356
116;"26.04.2006";23;"50.9";934;55400;54466
116;"26.04.2006";24;"40.1";766;49553;48787
117;"27.04.2006";1;"36.9";784;45396;44612
117;"27.04.2006";2;"29.6";745;43215;42470
117;"27.04.2006";3;"26.8";834;42352;41518
117;"27.04.2006";4;"8.2";762;42607;41845
117;"27.04.2006";5;"24.6";816;44345;43529
117;"27.04.2006";6;"34.8";838;48099;47261
117;"27.04.2006";7;"42.2";895;55326;54431
117;"27.04.2006";8;51;866;61797;60931
117;"27.04.2006";9;"55.9";728;64634;63906
117;"27.04.2006";10;"58.8";781;65390;64609
117;"27.04.2006";11;"62.9";865;66409;65544
117;"27.04.2006";12;"72.9";925;67706;66781
117;"27.04.2006";13;"61.5";1017;66259;65242
117;"27.04.2006";14;"58.8";1290;66109;64819
117;"27.04.2006";15;52;1554;64746;63192
117;"27.04.2006";16;"53.9";1887;63729;61842
117;"27.04.2006";17;"51.4";2210;62290;60080
117;"27.04.2006";18;"50.8";2239;62066;59827
117;"27.04.2006";19;"49.6";2207;61864;59657
117;"27.04.2006";20;48;2077;61386;59309
117;"27.04.2006";21;53;1938;60528;58590
117;"27.04.2006";22;"51.3";1938;59463;57525
117;"27.04.2006";23;"49.7";1984;55968;53984
117;"27.04.2006";24;40;1818;50997;49179
118;"28.04.2006";1;"37.2";1737;46485;44748
118;"28.04.2006";2;"31.1";1720;44126;42406
118;"28.04.2006";3;"21.4";1752;42964;41212
118;"28.04.2006";4;"16.6";1582;43516;41934
118;"28.04.2006";5;"26.8";1533;45395;43862
118;"28.04.2006";6;"37.8";1502;48980;47478
118;"28.04.2006";7;"48.4";1306;55731;54425
118;"28.04.2006";8;"62.2";1084;61608;60524
118;"28.04.2006";9;"66.5";753;64690;63937
118;"28.04.2006";10;"60.7";742;65029;64287
118;"28.04.2006";11;"63.5";1003;65770;64767
118;"28.04.2006";12;"69.8";1266;66749;65483
118;"28.04.2006";13;"63.2";1542;65370;63828
118;"28.04.2006";14;"61.4";1704;63589;61885
118;"28.04.2006";15;"60.1";1831;62162;60331
118;"28.04.2006";16;54;2062;60603;58541
118;"28.04.2006";17;48;2277;59509;57232
118;"28.04.2006";18;"47.2";2948;59714;56766
118;"28.04.2006";19;"43.6";2912;59595;56683
118;"28.04.2006";20;"41.8";2859;58977;56118
118;"28.04.2006";21;"45.4";3016;58182;55166
118;"28.04.2006";22;"47.1";2523;57732;55209
118;"28.04.2006";23;"38.9";2149;55050;52901
118;"28.04.2006";24;"33.1";2464;50659;48195
119;"29.04.2006";1;31;2763;46963;44200
119;"29.04.2006";2;"26.9";2513;44033;41520
119;"29.04.2006";3;"16.1";2157;42578;40421
119;"29.04.2006";4;14;2117;42886;40769
119;"29.04.2006";5;"8.9";2297;43696;41399
119;"29.04.2006";6;"14.1";1934;43792;41858
119;"29.04.2006";7;14;1550;43624;42074
119;"29.04.2006";8;"30.8";1250;46734;45484
119;"29.04.2006";9;35;1339;50896;49557
119;"29.04.2006";10;37;1344;53806;52462
119;"29.04.2006";11;"42.6";1420;55318;53898
119;"29.04.2006";12;"46.9";1560;56211;54651
119;"29.04.2006";13;"42.6";1749;54743;52994
119;"29.04.2006";14;"42.2";1837;52391;50554
119;"29.04.2006";15;"35.4";2046;50520;48474
119;"29.04.2006";16;"34.3";2348;49746;47398
119;"29.04.2006";17;"35.1";2488;49211;46723
119;"29.04.2006";18;"36.8";2211;50232;48021
119;"29.04.2006";19;"40.2";1765;50908;49143
119;"29.04.2006";20;"39.2";1714;50849;49135
119;"29.04.2006";21;"34.8";1377;50065;48688
119;"29.04.2006";22;"36.9";1184;50734;49550
119;"29.04.2006";23;"36.9";1164;49756;48592
119;"29.04.2006";24;"28.4";1207;46507;45300
120;"30.04.2006";1;"27.2";1268;42284;41016
120;"30.04.2006";2;"18.1";1262;39753;38491
120;"30.04.2006";3;"14.1";1211;38677;37466
120;"30.04.2006";4;"12.1";1236;38645;37409
120;"30.04.2006";5;"12.6";1142;39056;37914
120;"30.04.2006";6;"12.1";1023;38580;37557
120;"30.04.2006";7;"5.2";1147;36779;35632
120;"30.04.2006";8;"9.7";1021;38114;37093
120;"30.04.2006";9;"19.8";855;41490;40635
120;"30.04.2006";10;28;920;44671;43751
120;"30.04.2006";11;"34.9";1126;46906;45780
120;"30.04.2006";12;"39.8";1326;49787;48461
120;"30.04.2006";13;37;1406;48354;46948
120;"30.04.2006";14;"31.2";1334;45573;44239
120;"30.04.2006";15;"21.3";1510;43593;42083
120;"30.04.2006";16;"20.5";1439;42434;40995
120;"30.04.2006";17;"17.7";1602;41864;40262
120;"30.04.2006";18;"20.9";1663;43018;41355
120;"30.04.2006";19;29;1001;44738;43737
120;"30.04.2006";20;"33.7";1128;44991;43863
120;"30.04.2006";21;37;1071;45120;44049
120;"30.04.2006";22;38;1224;46782;45558
120;"30.04.2006";23;"41.4";1316;46461;45145
120;"30.04.2006";24;"29.9";1481;43263;41782
121;"01.05.2006";1;"22.2";1600;39798;38198
121;"01.05.2006";2;"16.5";1723;37658;35935
121;"01.05.2006";3;"12.6";1734;36418;34684
121;"01.05.2006";4;"12.1";1717;36284;34567
121;"01.05.2006";5;"11.8";1563;36721;35158
121;"01.05.2006";6;"11.6";1465;36475;35010
121;"01.05.2006";7;"2.2";1577;34653;33076
121;"01.05.2006";8;"3.2";1509;35725;34216
121;"01.05.2006";9;"15.9";1171;38921;37750
121;"01.05.2006";10;"26.9";1424;41835;40411
121;"01.05.2006";11;"33.9";2140;43721;41581
121;"01.05.2006";12;"41.8";2575;45339;42764
121;"01.05.2006";13;"36.4";3051;44449;41398
121;"01.05.2006";14;"26.7";3537;42652;39115
121;"01.05.2006";15;"17.5";3798;41080;37282
121;"01.05.2006";16;"16.6";3770;40479;36709
121;"01.05.2006";17;"7.7";3436;40252;36816
121;"01.05.2006";18;"17.1";3249;41932;38683
121;"01.05.2006";19;22;2980;44375;41395
121;"01.05.2006";20;"27.4";2569;45577;43008
121;"01.05.2006";21;"33.5";2568;46387;43819
121;"01.05.2006";22;"36.9";2926;47743;44817
121;"01.05.2006";23;"37.8";2880;46881;44001
121;"01.05.2006";24;"24.7";2908;42665;39757
122;"02.05.2006";1;"22.3";2740;39151;36411
122;"02.05.2006";2;"18.1";2398;36983;34585
122;"02.05.2006";3;"16.3";2308;36352;34044
122;"02.05.2006";4;"1.4";1942;36809;34867
122;"02.05.2006";5;"13.6";1875;38922;37047
122;"02.05.2006";6;"26.5";1828;44014;42186
122;"02.05.2006";7;39;1646;53198;51552
122;"02.05.2006";8;"56.9";1366;59840;58474
122;"02.05.2006";9;"56.5";1113;62815;61702
122;"02.05.2006";10;62;1083;63330;62247
122;"02.05.2006";11;63;1081;64358;63277
122;"02.05.2006";12;72;981;65525;64544
122;"02.05.2006";13;65;988;65046;64058
122;"02.05.2006";14;61;921;64403;63482
122;"02.05.2006";15;60;782;63471;62689
122;"02.05.2006";16;"55.4";653;62107;61454
122;"02.05.2006";17;"45.1";513;60365;59852
122;"02.05.2006";18;"44.7";444;59475;59031
122;"02.05.2006";19;"44.1";420;59383;58963
122;"02.05.2006";20;"43.6";444;58886;58442
122;"02.05.2006";21;"48.1";758;58110;57352
122;"02.05.2006";22;"48.1";1677;58815;57138
122;"02.05.2006";23;"41.2";2945;55468;52523
122;"02.05.2006";24;"35.1";3840;50089;46249
123;"03.05.2006";1;"35.8";3991;45641;41650
123;"03.05.2006";2;"34.7";4163;43399;39236
123;"03.05.2006";3;"33.3";3950;42363;38413
123;"03.05.2006";4;"30.9";3648;42603;38955
123;"03.05.2006";5;"34.4";3305;44210;40905
123;"03.05.2006";6;"35.5";3100;47679;44579
123;"03.05.2006";7;"49.7";3026;54723;51697
123;"03.05.2006";8;"77.4";2411;60632;58221
123;"03.05.2006";9;"54.6";1455;63373;61918
123;"03.05.2006";10;"52.1";889;63541;62652
123;"03.05.2006";11;"52.1";834;64507;63673
123;"03.05.2006";12;"62.9";1310;65554;64244
123;"03.05.2006";13;54;1681;64639;62958
123;"03.05.2006";14;"56.3";1942;63839;61897
123;"03.05.2006";15;"55.1";1856;62551;60695
123;"03.05.2006";16;53;1474;61309;59835
123;"03.05.2006";17;"48.7";1301;59589;58288
123;"03.05.2006";18;"43.2";1435;59269;57834
123;"03.05.2006";19;"39.3";1628;59146;57518
123;"03.05.2006";20;36;1969;58754;56785
123;"03.05.2006";21;"51.2";2830;58539;55709
123;"03.05.2006";22;"52.5";3699;58420;54721
123;"03.05.2006";23;"42.2";4054;54756;50702
123;"03.05.2006";24;"34.7";4231;49416;45185
124;"04.05.2006";1;"21.8";3905;45512;41607
124;"04.05.2006";2;"19.5";3532;43264;39732
124;"04.05.2006";3;"18.5";3239;41881;38642
124;"04.05.2006";4;5;2831;41557;38726
124;"04.05.2006";5;"9.1";2807;43021;40214
124;"04.05.2006";6;22;2935;46608;43673
124;"04.05.2006";7;"32.8";2969;54397;51428
124;"04.05.2006";8;"51.5";2470;60581;58111
124;"04.05.2006";9;"49.7";1652;63234;61582
124;"04.05.2006";10;"48.8";1497;63168;61671
124;"04.05.2006";11;"50.3";2383;64061;61678
124;"04.05.2006";12;56;4084;65492;61408
124;"04.05.2006";13;"46.5";6034;64906;58872
124;"04.05.2006";14;"43.6";6864;64182;57318
124;"04.05.2006";15;"41.5";7216;63045;55829
124;"04.05.2006";16;"39.5";7390;61938;54548
124;"04.05.2006";17;"35.8";7602;60530;52928
124;"04.05.2006";18;34;7768;60348;52580
124;"04.05.2006";19;"32.9";7521;60025;52504
124;"04.05.2006";20;31;6535;59080;52545
124;"04.05.2006";21;36;6169;58069;51900
124;"04.05.2006";22;"37.4";6359;58585;52226
124;"04.05.2006";23;"36.8";6523;55050;48527
124;"04.05.2006";24;"21.8";6592;49380;42788
125;"05.05.2006";1;24;6422;45696;39274
125;"05.05.2006";2;"21.3";6016;43509;37493
125;"05.05.2006";3;"15.5";5791;42495;36704
125;"05.05.2006";4;"11.4";5357;42542;37185
125;"05.05.2006";5;"20.4";5182;43770;38588
125;"05.05.2006";6;"24.6";5061;46972;41911
125;"05.05.2006";7;"38.4";4735;54041;49306
125;"05.05.2006";8;"50.3";3905;60318;56413
125;"05.05.2006";9;45;2912;62863;59951
125;"05.05.2006";10;"47.5";2788;63217;60429
125;"05.05.2006";11;46;3562;64333;60771
125;"05.05.2006";12;49;4937;65525;60588
125;"05.05.2006";13;45;6310;64713;58403
125;"05.05.2006";14;"43.6";8144;63482;55338
125;"05.05.2006";15;"37.9";8497;61808;53311
125;"05.05.2006";16;35;8320;60630;52310
125;"05.05.2006";17;"35.1";8063;59444;51381
125;"05.05.2006";18;"33.3";7270;58637;51367
125;"05.05.2006";19;"34.9";6161;58179;52018
125;"05.05.2006";20;"32.9";4971;57050;52079
125;"05.05.2006";21;"36.9";4566;55384;50818
125;"05.05.2006";22;"37.7";4846;55715;50869
125;"05.05.2006";23;"38.5";5277;53047;47770
125;"05.05.2006";24;"24.4";5393;48648;43255
126;"06.05.2006";1;"24.1";5196;45156;39960
126;"06.05.2006";2;"19.3";4896;42551;37655
126;"06.05.2006";3;"15.1";4804;41035;36231
126;"06.05.2006";4;10;4431;40497;36066
126;"06.05.2006";5;"11.1";4296;40872;36576
126;"06.05.2006";6;"14.9";3929;41084;37155
126;"06.05.2006";7;"15.1";3729;42242;38513
126;"06.05.2006";8;"22.2";3212;46549;43337
126;"06.05.2006";9;"33.9";2166;50681;48515
126;"06.05.2006";10;"40.6";1316;53131;51815
126;"06.05.2006";11;"43.6";1332;53976;52644
126;"06.05.2006";12;47;1972;54520;52548
126;"06.05.2006";13;39;3379;52871;49492
126;"06.05.2006";14;"30.6";4648;50468;45820
126;"06.05.2006";15;"27.3";5510;48521;43011
126;"06.05.2006";16;"24.7";5864;47590;41726
126;"06.05.2006";17;"22.3";5496;46895;41399
126;"06.05.2006";18;"24.6";4850;47498;42648
126;"06.05.2006";19;"27.8";4241;48071;43830
126;"06.05.2006";20;"27.9";3998;47924;43926
126;"06.05.2006";21;"25.6";4363;46988;42625
126;"06.05.2006";22;"25.5";5198;48190;42992
126;"06.05.2006";23;"23.1";5610;46902;41292
126;"06.05.2006";24;18;5756;42704;36948
127;"07.05.2006";1;13;5423;39331;33908
127;"07.05.2006";2;7;5017;36902;31885
127;"07.05.2006";3;6;4661;35509;30848
127;"07.05.2006";4;"5.9";4419;34883;30464
127;"07.05.2006";5;7;4150;35066;30916
127;"07.05.2006";6;"6.1";4099;34941;30842
127;"07.05.2006";7;5;4195;34934;30739
127;"07.05.2006";8;"6.9";3538;37304;33766
127;"07.05.2006";9;"18.6";2538;40946;38408
127;"07.05.2006";10;"23.2";1967;43441;41474
127;"07.05.2006";11;"23.7";2178;45098;42920
127;"07.05.2006";12;"31.9";3448;47558;44110
127;"07.05.2006";13;"28.4";5215;46293;41078
127;"07.05.2006";14;"21.3";6525;43995;37470
127;"07.05.2006";15;"12.2";6667;41848;35181
127;"07.05.2006";16;"10.6";6840;41018;34178
127;"07.05.2006";17;10;6600;40913;34313
127;"07.05.2006";18;"15.8";6344;42675;36331
127;"07.05.2006";19;"19.4";5640;44821;39181
127;"07.05.2006";20;22;4696;45400;40704
127;"07.05.2006";21;"27.9";4425;45786;41361
127;"07.05.2006";22;"30.6";4942;47978;43036
127;"07.05.2006";23;"30.5";5113;47127;42014
127;"07.05.2006";24;20;5216;42967;37751
128;"08.05.2006";1;17;5005;39660;34655
128;"08.05.2006";2;"14.8";4822;38147;33325
128;"08.05.2006";3;"11.7";4542;37539;32997
128;"08.05.2006";4;"9.6";4165;37807;33642
128;"08.05.2006";5;"14.1";3976;39431;35455
128;"08.05.2006";6;"21.6";3850;42930;39080
128;"08.05.2006";7;"33.9";3586;51674;48088
128;"08.05.2006";8;"45.8";2928;58904;55976
128;"08.05.2006";9;"40.8";2043;62207;60164
128;"08.05.2006";10;"42.3";1729;62812;61083
128;"08.05.2006";11;"44.7";2046;63959;61913
128;"08.05.2006";12;"51.4";2899;65625;62726
128;"08.05.2006";13;"46.4";3973;64829;60856
128;"08.05.2006";14;"46.3";5143;64189;59046
128;"08.05.2006";15;"44.7";5904;63279;57375
128;"08.05.2006";16;"40.8";6006;62142;56136
128;"08.05.2006";17;"37.2";6043;60738;54695
128;"08.05.2006";18;"35.1";5557;60330;54773
128;"08.05.2006";19;"33.6";4956;60286;55330
128;"08.05.2006";20;"32.9";4167;59484;55317
128;"08.05.2006";21;39;4090;58209;54119
128;"08.05.2006";22;"39.1";4314;57804;53490
128;"08.05.2006";23;35;4664;53689;49025
128;"08.05.2006";24;"26.6";4619;47947;43328
129;"09.05.2006";1;"21.3";4328;43977;39649
129;"09.05.2006";2;"16.9";3914;41991;38077
129;"09.05.2006";3;"15.1";3554;40985;37431
129;"09.05.2006";4;"7.1";3440;41170;37730
129;"09.05.2006";5;"16.8";3310;42659;39349
129;"09.05.2006";6;"22.3";3079;46155;43076
129;"09.05.2006";7;"36.1";2823;53819;50996
129;"09.05.2006";8;"49.8";2080;60579;58499
129;"09.05.2006";9;"52.6";1362;63448;62086
129;"09.05.2006";10;62;1196;63946;62750
129;"09.05.2006";11;"64.9";1348;65032;63684
129;"09.05.2006";12;"70.7";2068;66550;64482
129;"09.05.2006";13;"64.4";3147;65679;62532
129;"09.05.2006";14;"57.1";3863;65081;61218
129;"09.05.2006";15;"49.4";4086;63975;59889
129;"09.05.2006";16;"47.9";4204;62655;58451
129;"09.05.2006";17;"42.9";4463;61483;57020
129;"09.05.2006";18;"39.9";4714;61118;56404
129;"09.05.2006";19;"41.8";4639;60954;56315
129;"09.05.2006";20;39;3873;60031;56158
129;"09.05.2006";21;"37.1";3676;58416;54740
129;"09.05.2006";22;"41.1";3825;57991;54166
129;"09.05.2006";23;"35.9";3902;54526;50624
129;"09.05.2006";24;"31.4";3467;48954;45487
130;"10.05.2006";1;"29.9";2986;45019;42033
130;"10.05.2006";2;"25.9";2814;43004;40190
130;"10.05.2006";3;"23.9";2624;41938;39314
130;"10.05.2006";4;"23.1";2403;42308;39905
130;"10.05.2006";5;"23.2";2261;43946;41685
130;"10.05.2006";6;30;2010;46766;44756
130;"10.05.2006";7;"39.6";1892;54349;52457
130;"10.05.2006";8;"52.6";1399;60996;59597
130;"10.05.2006";9;"62.9";731;64080;63349
130;"10.05.2006";10;"56.1";668;64226;63558
130;"10.05.2006";11;"59.1";1071;65404;64333
130;"10.05.2006";12;"64.5";1644;66885;65241
130;"10.05.2006";13;58;2005;65613;63608
130;"10.05.2006";14;"58.6";2284;64420;62136
130;"10.05.2006";15;63;2247;62988;60741
130;"10.05.2006";16;"49.9";2228;62022;59794
130;"10.05.2006";17;40;2149;60504;58355
130;"10.05.2006";18;"36.1";2066;60061;57995
130;"10.05.2006";19;36;1989;59799;57810
130;"10.05.2006";20;"33.1";1592;59114;57522
130;"10.05.2006";21;"42.9";1490;57342;55852
130;"10.05.2006";22;"38.1";1844;57886;56042
130;"10.05.2006";23;"35.5";2139;54646;52507
130;"10.05.2006";24;"30.1";1775;48464;46689
131;"11.05.2006";1;"28.6";1573;44886;43313
131;"11.05.2006";2;27;1250;42757;41507
131;"11.05.2006";3;"22.3";940;41654;40714
131;"11.05.2006";4;"19.3";662;41792;41130
131;"11.05.2006";5;"21.7";495;43166;42671
131;"11.05.2006";6;"29.6";313;46083;45770
131;"11.05.2006";7;"33.9";267;53608;53341
131;"11.05.2006";8;"51.4";230;59933;59703
131;"11.05.2006";9;"50.1";96;62506;62410
131;"11.05.2006";10;"54.8";79;63135;63056
131;"11.05.2006";11;"54.4";106;64263;64157
131;"11.05.2006";12;"68.1";170;65288;65118
131;"11.05.2006";13;"56.6";222;64545;64323
131;"11.05.2006";14;"69.5";262;63780;63518
131;"11.05.2006";15;"52.5";308;62552;62244
131;"11.05.2006";16;"49.9";364;61503;61139
131;"11.05.2006";17;"48.1";458;60104;59646
131;"11.05.2006";18;"50.1";478;59704;59226
131;"11.05.2006";19;"46.6";530;59601;59071
131;"11.05.2006";20;"41.1";610;59002;58392
131;"11.05.2006";21;39;569;57394;56825
131;"11.05.2006";22;"36.8";610;57463;56853
131;"11.05.2006";23;"37.1";798;53898;53100
131;"11.05.2006";24;32;906;48680;47774
132;"12.05.2006";1;"32.4";893;44931;44038
132;"12.05.2006";2;30;768;42917;42149
132;"12.05.2006";3;"29.5";684;41855;41171
132;"12.05.2006";4;"23.2";693;42059;41366
132;"12.05.2006";5;"28.3";642;43342;42700
132;"12.05.2006";6;32;687;45964;45277
132;"12.05.2006";7;"40.3";613;53621;53008
132;"12.05.2006";8;"57.2";486;60035;59549
132;"12.05.2006";9;"52.2";330;63089;62759
132;"12.05.2006";10;"56.6";162;63375;63213
132;"12.05.2006";11;"60.4";135;64280;64145
132;"12.05.2006";12;68;188;65306;65118
132;"12.05.2006";13;60;243;64301;64058
132;"12.05.2006";14;"50.2";390;62671;62281
132;"12.05.2006";15;48;624;61166;60542
132;"12.05.2006";16;"38.4";913;59739;58826
132;"12.05.2006";17;"34.9";1061;58713;57652
132;"12.05.2006";18;"34.9";1016;58688;57672
132;"12.05.2006";19;33;1177;58438;57261
132;"12.05.2006";20;32;1309;57222;55913
132;"12.05.2006";21;"39.4";1034;55111;54077
132;"12.05.2006";22;"39.9";1159;55214;54055
132;"12.05.2006";23;"36.1";1074;52566;51492
132;"12.05.2006";24;32;1111;47495;46384
133;"13.05.2006";1;"34.6";1140;44084;42944
133;"13.05.2006";2;"31.1";1002;41672;40670
133;"13.05.2006";3;"29.6";1076;40411;39335
133;"13.05.2006";4;"28.6";1219;40021;38802
133;"13.05.2006";5;"28.4";1275;40142;38867
133;"13.05.2006";6;"28.3";1329;40483;39154
133;"13.05.2006";7;"28.1";1369;42351;40982
133;"13.05.2006";8;"29.2";1496;46120;44624
133;"13.05.2006";9;33;1547;50443;48896
133;"13.05.2006";10;38;2033;53152;51119
133;"13.05.2006";11;"38.3";2223;54987;52764
133;"13.05.2006";12;"41.2";1872;55904;54032
133;"13.05.2006";13;"39.6";1513;54267;52754
133;"13.05.2006";14;"36.1";1253;51898;50645
133;"13.05.2006";15;"34.4";1671;49843;48172
133;"13.05.2006";16;33;1628;48374;46746
133;"13.05.2006";17;34;1730;47617;45887
133;"13.05.2006";18;"33.3";1677;48660;46983
133;"13.05.2006";19;"34.6";1404;49367;47963
133;"13.05.2006";20;"34.1";1331;49171;47840
133;"13.05.2006";21;"36.2";1496;47652;46156
133;"13.05.2006";22;36;1247;47778;46531
133;"13.05.2006";23;"35.1";1258;46348;45090
133;"13.05.2006";24;"31.3";1444;42606;41162
134;"14.05.2006";1;"24.8";1860;39314;37454
134;"14.05.2006";2;"15.7";1839;37017;35178
134;"14.05.2006";3;13;1911;35948;34037
134;"14.05.2006";4;"10.4";2077;35517;33440
134;"14.05.2006";5;"9.9";2136;35473;33337
134;"14.05.2006";6;"9.1";2224;35238;33014
134;"14.05.2006";7;9;1925;35197;33272
134;"14.05.2006";8;"9.1";1584;37613;36029
134;"14.05.2006";9;"18.7";1735;41430;39695
134;"14.05.2006";10;"25.7";1794;44284;42490
134;"14.05.2006";11;"30.5";1775;46611;44836
134;"14.05.2006";12;"35.8";1934;49327;47393
134;"14.05.2006";13;33;2260;48077;45817
134;"14.05.2006";14;"28.2";2313;45329;43016
134;"14.05.2006";15;"23.2";2241;43337;41096
134;"14.05.2006";16;23;2406;41812;39406
134;"14.05.2006";17;"22.3";2496;41481;38985
134;"14.05.2006";18;"24.4";2695;42883;40188
134;"14.05.2006";19;"27.8";2549;44712;42163
134;"14.05.2006";20;"30.7";2001;45286;43285
134;"14.05.2006";21;"30.1";1437;45160;43723
134;"14.05.2006";22;"35.1";1248;47244;45996
134;"14.05.2006";23;36;1064;47243;46179
134;"14.05.2006";24;"27.5";998;42981;41983
135;"15.05.2006";1;"21.6";870;39904;39034
135;"15.05.2006";2;"18.9";739;38197;37458
135;"15.05.2006";3;"17.3";677;37561;36884
135;"15.05.2006";4;"16.5";666;38182;37516
135;"15.05.2006";5;"17.6";673;39878;39205
135;"15.05.2006";6;"26.6";710;43656;42946
135;"15.05.2006";7;"35.5";723;51651;50928
135;"15.05.2006";8;"54.9";620;58742;58122
135;"15.05.2006";9;"65.2";459;61976;61517
135;"15.05.2006";10;"64.4";394;62611;62217
135;"15.05.2006";11;"69.4";393;63978;63585
135;"15.05.2006";12;"78.6";376;65240;64864
135;"15.05.2006";13;"74.8";414;64681;64267
135;"15.05.2006";14;"75.5";429;63965;63536
135;"15.05.2006";15;"75.1";491;62702;62211
135;"15.05.2006";16;"72.5";563;61820;61257
135;"15.05.2006";17;"52.6";662;60224;59562
135;"15.05.2006";18;"46.5";846;59913;59067
135;"15.05.2006";19;45;955;59929;58974
135;"15.05.2006";20;40;1110;59325;58215
135;"15.05.2006";21;"39.5";1312;57449;56137
135;"15.05.2006";22;"38.1";2010;57018;55008
135;"15.05.2006";23;"36.9";2598;53379;50781
135;"15.05.2006";24;32;3005;47905;44900
136;"16.05.2006";1;"24.1";2896;43991;41095
136;"16.05.2006";2;"21.4";2924;42073;39149
136;"16.05.2006";3;"18.7";3177;41059;37882
136;"16.05.2006";4;"6.1";3517;41366;37849
136;"16.05.2006";5;"17.1";3513;42725;39212
136;"16.05.2006";6;"21.4";3292;45762;42470
136;"16.05.2006";7;"32.7";3028;53943;50915
136;"16.05.2006";8;45;2872;60799;57927
136;"16.05.2006";9;"47.4";3078;64123;61045
136;"16.05.2006";10;48;3840;65029;61189
136;"16.05.2006";11;"48.5";4811;66242;61431
136;"16.05.2006";12;"52.2";5525;67717;62192
136;"16.05.2006";13;"51.2";5879;66421;60542
136;"16.05.2006";14;"47.3";6235;65581;59346
136;"16.05.2006";15;"42.1";6355;64633;58278
136;"16.05.2006";16;36;6383;63371;56988
136;"16.05.2006";17;"37.4";6911;62059;55148
136;"16.05.2006";18;36;6545;61754;55209
136;"16.05.2006";19;"37.8";4954;61131;56177
136;"16.05.2006";20;"37.2";3180;60076;56896
136;"16.05.2006";21;"43.5";2105;58431;56326
136;"16.05.2006";22;"37.7";1681;57718;56037
136;"16.05.2006";23;"35.5";1405;53984;52579
136;"16.05.2006";24;"29.4";1255;48464;47209
137;"17.05.2006";1;"31.1";1080;45101;44021
137;"17.05.2006";2;"27.9";982;43161;42179
137;"17.05.2006";3;22;907;42076;41169
137;"17.05.2006";4;"17.6";837;42408;41571
137;"17.05.2006";5;"20.2";1096;43573;42477
137;"17.05.2006";6;32;1072;46277;45205
137;"17.05.2006";7;39;992;53834;52842
137;"17.05.2006";8;"62.9";782;60688;59906
137;"17.05.2006";9;"60.1";690;63265;62575
137;"17.05.2006";10;68;597;63969;63372
137;"17.05.2006";11;"66.9";598;65192;64594
137;"17.05.2006";12;90;583;66620;66037
137;"17.05.2006";13;"75.2";615;65409;64794
137;"17.05.2006";14;"64.4";585;64609;64024
137;"17.05.2006";15;"62.9";553;63369;62816
137;"17.05.2006";16;63;460;62030;61570
137;"17.05.2006";17;"50.2";305;60493;60188
137;"17.05.2006";18;"50.1";246;60112;59866
137;"17.05.2006";19;"47.7";185;59685;59500
137;"17.05.2006";20;"43.6";179;58857;58678
137;"17.05.2006";21;"44.1";280;57160;56880
137;"17.05.2006";22;"46.7";616;56981;56365
137;"17.05.2006";23;"43.7";1212;53949;52737
137;"17.05.2006";24;"32.6";1849;48422;46573
138;"18.05.2006";1;"28.4";2421;44464;42043
138;"18.05.2006";2;"22.1";2877;42656;39779
138;"18.05.2006";3;18;3398;41728;38330
138;"18.05.2006";4;"10.7";3970;41651;37681
138;"18.05.2006";5;"8.1";4336;42746;38410
138;"18.05.2006";6;"16.6";4223;45728;41505
138;"18.05.2006";7;"28.6";4274;53526;49252
138;"18.05.2006";8;"36.3";4576;60857;56281
138;"18.05.2006";9;"44.9";4664;64319;59655
138;"18.05.2006";10;"46.1";4827;65341;60514
138;"18.05.2006";11;"49.1";5431;67425;61994
138;"18.05.2006";12;50;5750;68748;62998
138;"18.05.2006";13;50;6986;67760;60774
138;"18.05.2006";14;"46.1";7624;66641;59017
138;"18.05.2006";15;"44.1";7484;65387;57903
138;"18.05.2006";16;"44.9";6857;64153;57296
138;"18.05.2006";17;40;6692;62377;55685
138;"18.05.2006";18;44;6138;61548;55410
138;"18.05.2006";19;"42.2";5327;60987;55660
138;"18.05.2006";20;"40.1";4237;60033;55796
138;"18.05.2006";21;"37.9";3460;57587;54127
138;"18.05.2006";22;"43.3";2766;56815;54049
138;"18.05.2006";23;"38.1";2772;54041;51269
138;"18.05.2006";24;"33.9";2767;48458;45691
139;"19.05.2006";1;"29.4";2869;44761;41892
139;"19.05.2006";2;"25.1";3538;42789;39251
139;"19.05.2006";3;"20.4";3916;41284;37368
139;"19.05.2006";4;"17.7";3926;41672;37746
139;"19.05.2006";5;"17.5";4435;43088;38653
139;"19.05.2006";6;"23.1";5058;46348;41290
139;"19.05.2006";7;"41.3";5444;53671;48227
139;"19.05.2006";8;"52.6";6001;60049;54048
139;"19.05.2006";9;"47.6";7146;63265;56119
139;"19.05.2006";10;48;8641;64113;55472
139;"19.05.2006";11;"49.9";9572;65665;56093
139;"19.05.2006";12;"49.9";10953;66827;55874
139;"19.05.2006";13;"47.1";11654;66160;54506
139;"19.05.2006";14;"39.2";12407;64843;52436
139;"19.05.2006";15;"40.1";12679;63605;50926
139;"19.05.2006";16;"36.1";12697;61929;49232
139;"19.05.2006";17;"32.9";12782;60964;48182
139;"19.05.2006";18;"30.8";12529;60763;48234
139;"19.05.2006";19;"30.5";11845;60084;48239
139;"19.05.2006";20;"32.6";11190;59190;48000
139;"19.05.2006";21;35;10050;56693;46643
139;"19.05.2006";22;"36.8";8889;55849;46960
139;"19.05.2006";23;"36.9";8399;53692;45293
139;"19.05.2006";24;29;8062;49204;41142
140;"20.05.2006";1;"23.2";7921;45920;37999
140;"20.05.2006";2;"19.4";7590;43587;35997
140;"20.05.2006";3;18;7340;41979;34639
140;"20.05.2006";4;"17.6";6416;41522;35106
140;"20.05.2006";5;"16.7";5862;41631;35769
140;"20.05.2006";6;"15.9";5679;41400;35721
140;"20.05.2006";7;17;5767;43007;37240
140;"20.05.2006";8;"26.1";5752;46841;41089
140;"20.05.2006";9;"32.9";6988;51065;44077
140;"20.05.2006";10;36;8382;54417;46035
140;"20.05.2006";11;38;8790;56273;47483
140;"20.05.2006";12;"39.3";9388;57890;48502
140;"20.05.2006";13;"37.2";10299;56810;46511
140;"20.05.2006";14;"30.1";10559;54796;44237
140;"20.05.2006";15;"30.1";9807;52637;42830
140;"20.05.2006";16;"26.4";8728;51835;43107
140;"20.05.2006";17;"25.5";8195;51262;43067
140;"20.05.2006";18;"27.5";8458;52125;43667
140;"20.05.2006";19;"28.3";7875;52232;44357
140;"20.05.2006";20;"29.1";7656;51227;43571
140;"20.05.2006";21;"28.2";8969;49616;40647
140;"20.05.2006";22;"26.7";9416;49271;39855
140;"20.05.2006";23;"26.1";9736;49017;39281
140;"20.05.2006";24;"20.7";10040;46517;36477
141;"21.05.2006";1;"14.1";9530;42370;32840
141;"21.05.2006";2;5;9174;39533;30359
141;"21.05.2006";3;"1.6";9028;37759;28731
141;"21.05.2006";4;"0.6";8823;37335;28512
141;"21.05.2006";5;"1.4";9284;37751;28467
141;"21.05.2006";6;1;9212;37191;27979
141;"21.05.2006";7;"0.7";9274;37204;27930
141;"21.05.2006";8;"1.7";9229;39183;29954
141;"21.05.2006";9;"12.5";8986;42712;33726
141;"21.05.2006";10;18;9105;45730;36625
141;"21.05.2006";11;"21.4";9176;48525;39349
141;"21.05.2006";12;"29.2";8666;51252;42586
141;"21.05.2006";13;"27.6";8461;50447;41986
141;"21.05.2006";14;21;7411;48033;40622
141;"21.05.2006";15;"16.9";6331;45672;39341
141;"21.05.2006";16;"16.2";5369;43993;38624
141;"21.05.2006";17;15;4278;43400;39122
141;"21.05.2006";18;"19.4";3428;44557;41129
141;"21.05.2006";19;"25.8";2659;46115;43456
141;"21.05.2006";20;"28.4";1779;46349;44570
141;"21.05.2006";21;"30.1";1627;46036;44409
141;"21.05.2006";22;"29.4";2264;47375;45111
141;"21.05.2006";23;"33.8";3209;48470;45261
141;"21.05.2006";24;23;3984;44521;40537
142;"22.05.2006";1;"11.7";4490;41179;36689
142;"22.05.2006";2;"4.4";4966;39381;34415
142;"22.05.2006";3;7;4970;38718;33748
142;"22.05.2006";4;2;4790;38930;34140
142;"22.05.2006";5;"6.9";5039;40765;35726
142;"22.05.2006";6;18;5285;44095;38810
142;"22.05.2006";7;27;5588;52724;47136
142;"22.05.2006";8;"41.1";4992;59858;54866
142;"22.05.2006";9;"43.8";4741;63726;58985
142;"22.05.2006";10;"43.8";5270;64977;59707
142;"22.05.2006";11;"44.9";6366;66569;60203
142;"22.05.2006";12;48;7253;68172;60919
142;"22.05.2006";13;"42.8";7397;66946;59549
142;"22.05.2006";14;"41.9";7191;65990;58799
142;"22.05.2006";15;"40.5";7056;65089;58033
142;"22.05.2006";16;"38.4";7043;63718;56675
142;"22.05.2006";17;36;7668;62315;54647
142;"22.05.2006";18;"35.1";7991;62211;54220
142;"22.05.2006";19;"34.2";8542;61892;53350
142;"22.05.2006";20;32;8408;61281;52873
142;"22.05.2006";21;"36.8";7678;58776;51098
142;"22.05.2006";22;"35.9";7549;57677;50128
142;"22.05.2006";23;"32.7";7250;54713;47463
142;"22.05.2006";24;"22.3";7697;49346;41649
143;"23.05.2006";1;"21.6";8648;45807;37159
143;"23.05.2006";2;"18.2";9567;43787;34220
143;"23.05.2006";3;13;10357;42815;32458
143;"23.05.2006";4;0;10598;43091;32493
143;"23.05.2006";5;6;10576;44277;33701
143;"23.05.2006";6;"16.6";10960;47232;36272
143;"23.05.2006";7;"26.3";10836;54583;43747
143;"23.05.2006";8;"34.8";11221;61558;50337
143;"23.05.2006";9;"35.4";11974;65763;53789
143;"23.05.2006";10;"35.9";11786;66012;54226
143;"23.05.2006";11;"40.1";11523;67144;55621
143;"23.05.2006";12;"45.1";11098;68534;57436
143;"23.05.2006";13;"45.1";10313;67592;57279
143;"23.05.2006";14;"45.8";9598;66488;56890
143;"23.05.2006";15;"42.1";8917;64986;56069
143;"23.05.2006";16;42;8219;63966;55747
143;"23.05.2006";17;41;7555;62198;54643
143;"23.05.2006";18;"43.9";7156;61718;54562
143;"23.05.2006";19;45;6205;60920;54715
143;"23.05.2006";20;"42.9";4755;59313;54558
143;"23.05.2006";21;"40.6";3478;57181;53703
143;"23.05.2006";22;"38.9";3034;56482;53448
143;"23.05.2006";23;"40.1";2979;54644;51665
143;"23.05.2006";24;"32.6";3297;49322;46025
144;"24.05.2006";1;"29.7";3494;45322;41828
144;"24.05.2006";2;24;3785;43354;39569
144;"24.05.2006";3;"22.3";3956;42685;38729
144;"24.05.2006";4;"17.9";4103;43105;39002
144;"24.05.2006";5;"20.3";4277;44525;40248
144;"24.05.2006";6;28;4536;46664;42128
144;"24.05.2006";7;34;4506;53755;49249
144;"24.05.2006";8;"44.2";4289;60030;55741
144;"24.05.2006";9;"49.7";4541;62539;57998
144;"24.05.2006";10;"51.9";5457;62803;57346
144;"24.05.2006";11;"59.9";6906;64162;57256
144;"24.05.2006";12;"61.2";8017;65898;57881
144;"24.05.2006";13;"51.8";8790;65197;56407
144;"24.05.2006";14;45;8969;64365;55396
144;"24.05.2006";15;"42.8";9097;63201;54104
144;"24.05.2006";16;"38.6";8969;61761;52792
144;"24.05.2006";17;"35.1";9044;60424;51380
144;"24.05.2006";18;"33.3";8983;59864;50881
144;"24.05.2006";19;"33.1";8010;58835;50825
144;"24.05.2006";20;33;7470;58224;50754
144;"24.05.2006";21;"38.1";7040;56550;49510
144;"24.05.2006";22;"37.8";6622;55456;48834
144;"24.05.2006";23;"39.8";6808;53377;46569
144;"24.05.2006";24;"31.3";6206;48736;42530
145;"25.05.2006";1;"28.4";5936;44866;38930
145;"25.05.2006";2;"19.4";5655;42543;36888
145;"25.05.2006";3;"18.7";5265;41339;36074
145;"25.05.2006";4;"17.9";4957;40501;35544
145;"25.05.2006";5;"17.5";4255;39956;35701
145;"25.05.2006";6;11;4071;38285;34214
145;"25.05.2006";7;"4.4";3674;36853;33179
145;"25.05.2006";8;"12.9";3409;39109;35700
145;"25.05.2006";9;"19.1";3326;42520;39194
145;"25.05.2006";10;"26.8";3840;45102;41262
145;"25.05.2006";11;"28.7";4191;47738;43547
145;"25.05.2006";12;"32.9";4468;50399;45931
145;"25.05.2006";13;"32.5";4270;49746;45476
145;"25.05.2006";14;"25.8";4457;47702;43245
145;"25.05.2006";15;"21.4";4490;46206;41716
145;"25.05.2006";16;"20.6";4171;45192;41021
145;"25.05.2006";17;"20.2";3712;44734;41022
145;"25.05.2006";18;"23.2";3520;45512;41992
145;"25.05.2006";19;"23.2";3041;46505;43464
145;"25.05.2006";20;"28.5";2787;46360;43573
145;"25.05.2006";21;"28.5";2588;45763;43175
145;"25.05.2006";22;"32.3";2582;46369;43787
145;"25.05.2006";23;"39.4";2843;46564;43721
145;"25.05.2006";24;"25.9";3140;43056;39916
146;"26.05.2006";1;"20.4";3264;39938;36674
146;"26.05.2006";2;"16.6";3170;37902;34732
146;"26.05.2006";3;"12.9";3374;37148;33774
146;"26.05.2006";4;9;3381;37452;34071
146;"26.05.2006";5;14;3097;38656;35559
146;"26.05.2006";6;"18.8";2816;40523;37707
146;"26.05.2006";7;"26.8";2462;45528;43066
146;"26.05.2006";8;"35.2";2341;51109;48768
146;"26.05.2006";9;"34.1";2611;55027;52416
146;"26.05.2006";10;"39.7";2974;56945;53971
146;"26.05.2006";11;"41.3";3031;58396;55365
146;"26.05.2006";12;44;3032;60046;57014
146;"26.05.2006";13;"42.1";3182;59724;56542
146;"26.05.2006";14;"41.4";2950;57990;55040
146;"26.05.2006";15;39;3103;56679;53576
146;"26.05.2006";16;"36.5";3202;55640;52438
146;"26.05.2006";17;"35.1";2785;54997;52212
146;"26.05.2006";18;"36.1";2535;55341;52806
146;"26.05.2006";19;"36.5";2452;55528;53076
146;"26.05.2006";20;34;2512;54616;52104
146;"26.05.2006";21;"35.6";2372;52350;49978
146;"26.05.2006";22;"34.9";2457;51788;49331
146;"26.05.2006";23;34;2475;50055;47580
146;"26.05.2006";24;"30.1";2362;45931;43569
147;"27.05.2006";1;"35.5";2527;42216;39689
147;"27.05.2006";2;31;2605;39780;37175
147;"27.05.2006";3;"28.4";2422;38569;36147
147;"27.05.2006";4;"25.7";2141;38203;36062
147;"27.05.2006";5;"28.4";2341;38608;36267
147;"27.05.2006";6;30;2650;38904;36254
147;"27.05.2006";7;30;2893;40579;37686
147;"27.05.2006";8;"36.5";2881;44288;41407
147;"27.05.2006";9;"36.3";3018;48300;45282
147;"27.05.2006";10;"43.8";3108;51522;48414
147;"27.05.2006";11;"46.3";3223;53412;50189
147;"27.05.2006";12;"47.9";3514;54699;51185
147;"27.05.2006";13;49;3578;53582;50004
147;"27.05.2006";14;"45.9";3778;51591;47813
147;"27.05.2006";15;38;3551;49565;46014
147;"27.05.2006";16;"38.3";3569;48768;45199
147;"27.05.2006";17;37;3894;48346;44452
147;"27.05.2006";18;37;3870;49533;45663
147;"27.05.2006";19;"37.2";3282;50127;46845
147;"27.05.2006";20;"37.1";3139;49656;46517
147;"27.05.2006";21;"34.6";2922;47586;44664
147;"27.05.2006";22;"35.6";2605;47225;44620
147;"27.05.2006";23;"38.4";2604;46269;43665
147;"27.05.2006";24;"30.3";2612;42517;39905
148;"28.05.2006";1;"22.5";3423;39402;35979
148;"28.05.2006";2;"18.3";3720;37015;33295
148;"28.05.2006";3;"14.1";4239;35761;31522
148;"28.05.2006";4;"10.1";5030;35478;30448
148;"28.05.2006";5;7;5751;35771;30020
148;"28.05.2006";6;"5.3";6792;35815;29023
148;"28.05.2006";7;"1.8";8075;36350;28275
148;"28.05.2006";8;"5.3";9498;39119;29621
148;"28.05.2006";9;"13.1";11130;43358;32228
148;"28.05.2006";10;"19.3";12174;46659;34485
148;"28.05.2006";11;"25.5";13222;49668;36446
148;"28.05.2006";12;"29.5";13774;52446;38672
148;"28.05.2006";13;"31.9";13679;51555;37876
148;"28.05.2006";14;"23.7";13916;49353;35437
148;"28.05.2006";15;"20.2";14382;47428;33046
148;"28.05.2006";16;"18.7";13905;46170;32265
148;"28.05.2006";17;"17.2";13276;45769;32493
148;"28.05.2006";18;"19.1";12544;46894;34350
148;"28.05.2006";19;"19.9";11682;48439;36757
148;"28.05.2006";20;"22.3";10242;48471;38229
148;"28.05.2006";21;27;7930;47543;39613
148;"28.05.2006";22;30;7069;48028;40959
148;"28.05.2006";23;33;5769;49107;43338
148;"28.05.2006";24;"22.8";5058;45142;40084
149;"29.05.2006";1;"17.4";4713;41337;36624
149;"29.05.2006";2;"15.1";4445;39682;35237
149;"29.05.2006";3;"12.5";4054;38985;34931
149;"29.05.2006";4;"10.7";3912;39290;35378
149;"29.05.2006";5;"17.5";3614;40950;37336
149;"29.05.2006";6;"22.1";3179;44197;41018
149;"29.05.2006";7;"29.1";2883;52188;49305
149;"29.05.2006";8;"41.9";2621;59058;56437
149;"29.05.2006";9;"42.9";2652;62833;60181
149;"29.05.2006";10;"44.6";2677;64268;61591
149;"29.05.2006";11;"48.1";2898;65999;63101
149;"29.05.2006";12;"50.9";2921;67667;64746
149;"29.05.2006";13;"51.1";2967;67148;64181
149;"29.05.2006";14;"47.3";3229;66464;63235
149;"29.05.2006";15;"45.1";2786;65104;62318
149;"29.05.2006";16;43;3001;64105;61104
149;"29.05.2006";17;"40.1";2742;62057;59315
149;"29.05.2006";18;"38.9";2984;61222;58238
149;"29.05.2006";19;"39.1";2478;60829;58351
149;"29.05.2006";20;"38.1";2030;59891;57861
149;"29.05.2006";21;"43.6";2104;57724;55620
149;"29.05.2006";22;"42.2";1933;56479;54546
149;"29.05.2006";23;"42.2";2231;54548;52317
149;"29.05.2006";24;"36.5";2511;49207;46696
150;"30.05.2006";1;"28.2";2820;45593;42773
150;"30.05.2006";2;"27.8";2656;43441;40785
150;"30.05.2006";3;"22.3";2995;42673;39678
150;"30.05.2006";4;"18.7";3215;43376;40161
150;"30.05.2006";5;"22.3";3177;44760;41583
150;"30.05.2006";6;"28.1";3066;46994;43928
150;"30.05.2006";7;35;2924;53826;50902
150;"30.05.2006";8;"47.6";2992;60326;57334
150;"30.05.2006";9;"46.2";3209;64139;60930
150;"30.05.2006";10;"48.3";3461;65038;61577
150;"30.05.2006";11;"53.1";4260;66836;62576
150;"30.05.2006";12;"55.8";4612;68490;63878
150;"30.05.2006";13;56;4634;67324;62690
150;"30.05.2006";14;"55.1";5033;66561;61528
150;"30.05.2006";15;"48.3";5645;65354;59709
150;"30.05.2006";16;"45.4";6101;64175;58074
150;"30.05.2006";17;"42.7";5994;62105;56111
150;"30.05.2006";18;"42.2";5717;61689;55972
150;"30.05.2006";19;"41.4";5821;61624;55803
150;"30.05.2006";20;"39.7";4734;60246;55512
150;"30.05.2006";21;"44.1";3926;57805;53879
150;"30.05.2006";22;40;3373;57310;53937
150;"30.05.2006";23;"37.3";3020;55644;52624
150;"30.05.2006";24;"32.5";3172;50275;47103
151;"31.05.2006";1;"35.8";3291;46115;42824
151;"31.05.2006";2;32;3233;44109;40876
151;"31.05.2006";3;"28.3";3460;43483;40023
151;"31.05.2006";4;"25.6";3526;44081;40555
151;"31.05.2006";5;"25.3";3431;45444;42013
151;"31.05.2006";6;"31.6";3390;47782;44392
151;"31.05.2006";7;43;3076;54537;51461
151;"31.05.2006";8;52;2860;60893;58033
151;"31.05.2006";9;"53.9";2873;64452;61579
151;"31.05.2006";10;58;3012;65199;62187
151;"31.05.2006";11;"64.4";3442;66576;63134
151;"31.05.2006";12;71;3547;67776;64229
151;"31.05.2006";13;68;3633;66719;63086
151;"31.05.2006";14;60;3947;65971;62024
151;"31.05.2006";15;"53.5";4644;65249;60605
151;"31.05.2006";16;"52.3";5194;63911;58717
151;"31.05.2006";17;50;5345;61941;56596
151;"31.05.2006";18;48;5711;61893;56182
151;"31.05.2006";19;"45.8";5703;61594;55891
151;"31.05.2006";20;"41.8";5257;60499;55242
151;"31.05.2006";21;42;4846;58129;53283
151;"31.05.2006";22;42;5009;57413;52404
151;"31.05.2006";23;46;5180;55495;50315
151;"31.05.2006";24;"35.1";5450;50397;44947
152;"01.06.2006";1;"33.6";5534;46411;40877
152;"01.06.2006";2;"32.9";5506;44330;38824
152;"01.06.2006";3;"31.2";5789;43571;37782
152;"01.06.2006";4;"25.2";6280;44013;37733
152;"01.06.2006";5;30;6149;45093;38944
152;"01.06.2006";6;"33.2";5936;47195;41259
152;"01.06.2006";7;"36.5";5648;53765;48117
152;"01.06.2006";8;"56.5";5794;60660;54866
152;"01.06.2006";9;"60.7";5930;63982;58052
152;"01.06.2006";10;"60.9";6340;64768;58428
152;"01.06.2006";11;"61.3";6091;65932;59841
152;"01.06.2006";12;"71.9";5634;67015;61381
152;"01.06.2006";13;"64.4";5506;66148;60642
152;"01.06.2006";14;"61.3";5167;65425;60258
152;"01.06.2006";15;"61.3";4939;64193;59254
152;"01.06.2006";16;"54.3";4622;63142;58520
152;"01.06.2006";17;"47.1";4228;61363;57135
152;"01.06.2006";18;"46.3";3703;61102;57399
152;"01.06.2006";19;"47.2";3063;60804;57741
152;"01.06.2006";20;"43.5";2668;59747;57079
152;"01.06.2006";21;"49.7";2116;57150;55034
152;"01.06.2006";22;"49.1";1717;56647;54930
152;"01.06.2006";23;"49.7";1528;55515;53987
152;"01.06.2006";24;"42.3";1278;50430;49152
153;"02.06.2006";1;"37.1";1194;46157;44963
153;"02.06.2006";2;"32.9";1116;43934;42818
153;"02.06.2006";3;"30.9";916;42929;42013
153;"02.06.2006";4;"23.3";782;43522;42740
153;"02.06.2006";5;"30.4";644;44739;44095
153;"02.06.2006";6;"36.3";530;46690;46160
153;"02.06.2006";7;"47.6";492;53549;53057
153;"02.06.2006";8;"60.3";332;59933;59601
153;"02.06.2006";9;"58.4";264;62976;62712
153;"02.06.2006";10;"62.1";261;63367;63106
153;"02.06.2006";11;"60.2";232;64214;63982
153;"02.06.2006";12;"65.1";240;65423;65183
153;"02.06.2006";13;"49.9";312;64384;64072
153;"02.06.2006";14;"47.5";415;62678;62263
153;"02.06.2006";15;"45.3";541;61078;60537
153;"02.06.2006";16;"41.6";646;59547;58901
153;"02.06.2006";17;"40.9";896;58303;57407
153;"02.06.2006";18;"35.9";1066;58081;57015
153;"02.06.2006";19;"35.6";1123;57611;56488
153;"02.06.2006";20;33;1031;56469;55438
153;"02.06.2006";21;"34.8";968;54011;53043
153;"02.06.2006";22;"33.8";1048;53529;52481
153;"02.06.2006";23;"36.5";1187;53372;52185
153;"02.06.2006";24;"32.5";1245;49019;47774
154;"03.06.2006";1;38;1130;45237;44107
154;"03.06.2006";2;32;1158;42570;41412
154;"03.06.2006";3;"30.8";1156;40877;39721
154;"03.06.2006";4;"30.1";1044;40612;39568
154;"03.06.2006";5;"30.1";1026;40795;39769
154;"03.06.2006";6;"30.2";981;40411;39430
154;"03.06.2006";7;"20.5";904;41065;40161
154;"03.06.2006";8;"24.3";718;44437;43719
154;"03.06.2006";9;"37.1";700;48727;48027
154;"03.06.2006";10;"40.7";938;51390;50452
154;"03.06.2006";11;40;1248;52970;51722
154;"03.06.2006";12;"42.2";1557;54110;52553
154;"03.06.2006";13;"39.8";1749;52635;50886
154;"03.06.2006";14;"34.6";1933;50460;48527
154;"03.06.2006";15;32;2004;48464;46460
154;"03.06.2006";16;"32.8";1999;47573;45574
154;"03.06.2006";17;"35.9";2190;46701;44511
154;"03.06.2006";18;"34.2";2411;47687;45276
154;"03.06.2006";19;"34.6";2395;48356;45961
154;"03.06.2006";20;"34.1";2437;48025;45588
154;"03.06.2006";21;"34.5";2834;46388;43554
154;"03.06.2006";22;"33.8";2983;45924;42941
154;"03.06.2006";23;"34.5";3212;45891;42679
154;"03.06.2006";24;"21.3";3318;42330;39012
155;"04.06.2006";1;21;3420;38870;35450
155;"04.06.2006";2;"12.4";3392;36191;32799
155;"04.06.2006";3;"6.5";3444;34937;31493
155;"04.06.2006";4;"6.9";3776;34556;30780
155;"04.06.2006";5;"6.9";4101;34621;30520
155;"04.06.2006";6;"5.3";3978;33738;29760
155;"04.06.2006";7;"1.6";3961;33392;29431
155;"04.06.2006";8;5;4483;35418;30935
155;"04.06.2006";9;"10.9";5298;38922;33624
155;"04.06.2006";10;15;5815;41885;36070
155;"04.06.2006";11;"22.1";6182;44561;38379
155;"04.06.2006";12;"30.8";6529;47228;40699
155;"04.06.2006";13;"24.9";6856;46100;39244
155;"04.06.2006";14;"17.9";7188;43328;36140
155;"04.06.2006";15;"14.2";7249;41310;34061
155;"04.06.2006";16;"12.3";7019;40348;33329
155;"04.06.2006";17;10;6690;40030;33340
155;"04.06.2006";18;12;6435;40709;34274
155;"04.06.2006";19;"17.9";5915;41831;35916
155;"04.06.2006";20;"21.2";5224;42096;36872
155;"04.06.2006";21;"21.9";4436;41626;37190
155;"04.06.2006";22;23;3849;42175;38326
155;"04.06.2006";23;33;3578;43928;40350
155;"04.06.2006";24;21;3263;40639;37376
156;"05.06.2006";1;"21.4";2886;37184;34298
156;"05.06.2006";2;"9.1";2485;34811;32326
156;"05.06.2006";3;7;2404;33730;31326
156;"05.06.2006";4;"2.3";2206;33887;31681
156;"05.06.2006";5;"2.1";1962;34145;32183
156;"05.06.2006";6;"6.1";1811;33619;31808
156;"05.06.2006";7;"6.1";1685;33553;31868
156;"05.06.2006";8;"8.7";1443;35074;33631
156;"05.06.2006";9;"16.4";1520;38456;36936
156;"05.06.2006";10;"22.4";1600;41823;40223
156;"05.06.2006";11;30;1752;44332;42580
156;"05.06.2006";12;"36.2";1646;47184;45538
156;"05.06.2006";13;"33.1";1626;46542;44916
156;"05.06.2006";14;"25.6";1700;44225;42525
156;"05.06.2006";15;"18.7";1599;42408;40809
156;"05.06.2006";16;15;1637;41377;39740
156;"05.06.2006";17;"14.7";1783;41057;39274
156;"05.06.2006";18;"22.1";1683;42181;40498
156;"05.06.2006";19;"24.1";1643;43829;42186
156;"05.06.2006";20;"24.6";1362;44360;42998
156;"05.06.2006";21;"31.1";1119;44016;42897
156;"05.06.2006";22;"36.2";1016;44322;43306
156;"05.06.2006";23;"36.9";1090;46138;45048
156;"05.06.2006";24;"25.3";1127;42784;41657
157;"06.06.2006";1;"22.1";1139;39283;38144
157;"06.06.2006";2;"21.1";1120;37307;36187
157;"06.06.2006";3;"12.3";1181;36651;35470
157;"06.06.2006";4;"5.1";1115;37251;36136
157;"06.06.2006";5;"12.2";964;38945;37981
157;"06.06.2006";6;22;917;42199;41282
157;"06.06.2006";7;31;810;49936;49126
157;"06.06.2006";8;"44.2";640;57271;56631
157;"06.06.2006";9;"46.1";562;61142;60580
157;"06.06.2006";10;"47.1";567;62457;61890
157;"06.06.2006";11;"48.7";637;64109;63472
157;"06.06.2006";12;57;686;65877;65191
157;"06.06.2006";13;"50.1";832;64837;64005
157;"06.06.2006";14;"50.9";1113;63827;62714
157;"06.06.2006";15;"48.8";1480;62651;61171
157;"06.06.2006";16;"46.6";1327;61425;60098
157;"06.06.2006";17;"42.1";1547;59717;58170
157;"06.06.2006";18;"40.1";1561;59561;58000
157;"06.06.2006";19;40;1456;59143;57687
157;"06.06.2006";20;"36.9";1189;58472;57283
157;"06.06.2006";21;"38.8";1243;56009;54766
157;"06.06.2006";22;"38.1";817;54824;54007
157;"06.06.2006";23;"36.3";869;54045;53176
157;"06.06.2006";24;"31.7";864;48699;47835
158;"07.06.2006";1;"35.9";720;44673;43953
158;"07.06.2006";2;"32.8";614;42641;42027
158;"07.06.2006";3;"23.1";446;41600;41154
158;"07.06.2006";4;"25.2";317;42203;41886
158;"07.06.2006";5;"26.8";247;43421;43174
158;"07.06.2006";6;"32.9";225;45800;45575
158;"07.06.2006";7;"38.5";197;52508;52311
158;"07.06.2006";8;"49.8";116;59161;59045
158;"07.06.2006";9;"48.7";80;62112;62032
158;"07.06.2006";10;53;82;62402;62320
158;"07.06.2006";11;"52.9";92;63743;63651
158;"07.06.2006";12;58;116;65053;64937
158;"07.06.2006";13;"53.8";135;63941;63806
158;"07.06.2006";14;53;227;63487;63260
158;"07.06.2006";15;53;269;62292;62023
158;"07.06.2006";16;"49.9";331;61255;60924
158;"07.06.2006";17;44;415;59656;59241
158;"07.06.2006";18;43;335;59397;59062
158;"07.06.2006";19;"40.1";370;58965;58595
158;"07.06.2006";20;"39.1";360;58120;57760
158;"07.06.2006";21;"44.9";288;55801;55513
158;"07.06.2006";22;"43.1";294;54840;54546
158;"07.06.2006";23;43;344;54141;53797
158;"07.06.2006";24;38;307;48738;48431
159;"08.06.2006";1;"31.4";314;44607;44293
159;"08.06.2006";2;"26.7";310;42575;42265
159;"08.06.2006";3;"25.2";249;41437;41188
159;"08.06.2006";4;"25.2";208;41615;41407
159;"08.06.2006";5;"27.1";190;42959;42769
159;"08.06.2006";6;35;207;45480;45273
159;"08.06.2006";7;"36.5";300;52855;52555
159;"08.06.2006";8;"45.7";264;59450;59186
159;"08.06.2006";9;"50.8";160;62173;62013
159;"08.06.2006";10;51;153;62865;62712
159;"08.06.2006";11;"52.3";194;63753;63559
159;"08.06.2006";12;"53.5";273;65207;64934
159;"08.06.2006";13;"54.1";248;64178;63930
159;"08.06.2006";14;"50.9";267;63288;63021
159;"08.06.2006";15;50;328;62316;61988
159;"08.06.2006";16;"45.3";349;61224;60875
159;"08.06.2006";17;"44.1";350;59713;59363
159;"08.06.2006";18;"43.5";362;59287;58925
159;"08.06.2006";19;"41.3";372;58955;58583
159;"08.06.2006";20;"38.1";313;58327;58014
159;"08.06.2006";21;"38.4";248;56236;55988
159;"08.06.2006";22;"39.9";357;55175;54818
159;"08.06.2006";23;"39.1";488;54409;53921
159;"08.06.2006";24;"33.6";594;49194;48600
160;"09.06.2006";1;"34.3";555;45049;44494
160;"09.06.2006";2;"30.5";455;43401;42946
160;"09.06.2006";3;"24.3";390;42650;42260
160;"09.06.2006";4;22;364;42898;42534
160;"09.06.2006";5;"24.3";323;43811;43488
160;"09.06.2006";6;"33.1";217;46119;45902
160;"09.06.2006";7;40;162;53302;53140
160;"09.06.2006";8;"54.2";120;59598;59478
160;"09.06.2006";9;"50.2";75;63033;62958
160;"09.06.2006";10;58;77;63337;63260
160;"09.06.2006";11;"53.1";96;64262;64166
160;"09.06.2006";12;60;137;65199;65062
160;"09.06.2006";13;53;164;64335;64171
160;"09.06.2006";14;"50.9";183;62660;62477
160;"09.06.2006";15;"48.6";195;61029;60834
160;"09.06.2006";16;48;262;59624;59362
160;"09.06.2006";17;41;342;58711;58369
160;"09.06.2006";18;41;372;58130;57758
160;"09.06.2006";19;39;441;56554;56113
160;"09.06.2006";20;38;455;54689;54234
160;"09.06.2006";21;"41.3";539;53045;52506
160;"09.06.2006";22;"39.9";672;52050;51378
160;"09.06.2006";23;"41.9";802;51861;51059
160;"09.06.2006";24;"35.9";940;48310;47370
161;"10.06.2006";1;36;964;44417;43453
161;"10.06.2006";2;26;915;42160;41245
161;"10.06.2006";3;"24.4";828;40728;39900
161;"10.06.2006";4;"25.2";699;40483;39784
161;"10.06.2006";5;"24.3";538;40218;39680
161;"10.06.2006";6;"21.2";415;39979;39564
161;"10.06.2006";7;"21.2";454;42333;41879
161;"10.06.2006";8;"32.2";210;46347;46137
161;"10.06.2006";9;32;114;50506;50392
161;"10.06.2006";10;"37.9";106;53200;53094
161;"10.06.2006";11;"40.9";124;54521;54397
161;"10.06.2006";12;"43.3";189;55356;55167
161;"10.06.2006";13;"42.3";362;53628;53266
161;"10.06.2006";14;"39.3";455;51152;50697
161;"10.06.2006";15;"34.9";575;49101;48526
161;"10.06.2006";16;35;748;48313;47565
161;"10.06.2006";17;"33.6";757;47586;46829
161;"10.06.2006";18;"33.8";874;48246;47372
161;"10.06.2006";19;"34.4";948;48331;47383
161;"10.06.2006";20;"33.1";1060;47800;46740
161;"10.06.2006";21;"33.6";1164;46256;45092
161;"10.06.2006";22;"31.6";1548;45456;43908
161;"10.06.2006";23;"34.8";2019;45887;43868
161;"10.06.2006";24;"28.3";2533;42909;40376
162;"11.06.2006";1;29;2634;39356;36722
162;"11.06.2006";2;20;2885;36835;33950
162;"11.06.2006";3;15;2967;35857;32890
162;"11.06.2006";4;"11.1";2871;35128;32257
162;"11.06.2006";5;"9.1";2684;34663;31979
162;"11.06.2006";6;"8.1";2464;34012;31548
162;"11.06.2006";7;"5.5";2093;34866;32773
162;"11.06.2006";8;"8.3";1254;37489;36235
162;"11.06.2006";9;"19.6";726;40933;40207
162;"11.06.2006";10;"25.3";791;43622;42831
162;"11.06.2006";11;"31.5";1139;45579;44440
162;"11.06.2006";12;38;1328;47599;46271
162;"11.06.2006";13;"35.1";1312;46363;45051
162;"11.06.2006";14;"28.9";1345;44271;42926
162;"11.06.2006";15;"22.6";1292;42874;41582
162;"11.06.2006";16;"24.5";1259;42154;40895
162;"11.06.2006";17;"22.2";1267;41774;40507
162;"11.06.2006";18;"27.9";1195;43503;42308
162;"11.06.2006";19;"28.5";1203;45357;44154
162;"11.06.2006";20;"28.4";1204;45846;44642
162;"11.06.2006";21;"28.7";1315;45752;44437
162;"11.06.2006";22;"28.9";1831;45890;44059
162;"11.06.2006";23;38;2413;47763;45350
162;"11.06.2006";24;"27.6";2761;44207;41446
163;"12.06.2006";1;"26.6";2715;40567;37852
163;"12.06.2006";2;24;2590;38784;36194
163;"12.06.2006";3;"18.1";2448;37972;35524
163;"12.06.2006";4;12;2170;38014;35844
163;"12.06.2006";5;"17.4";1936;39154;37218
163;"12.06.2006";6;"25.3";1718;42258;40540
163;"12.06.2006";7;"37.9";1500;51562;50062
163;"12.06.2006";8;"46.5";1118;58925;57807
163;"12.06.2006";9;"51.4";630;62644;62014
163;"12.06.2006";10;"56.6";477;63304;62827
163;"12.06.2006";11;"59.2";772;64651;63879
163;"12.06.2006";12;"65.5";1066;66245;65179
163;"12.06.2006";13;"60.1";1414;65457;64043
163;"12.06.2006";14;"58.1";1652;64848;63196
163;"12.06.2006";15;60;1673;63833;62160
163;"12.06.2006";16;"54.3";1775;63047;61272
163;"12.06.2006";17;"47.6";1872;61512;59640
163;"12.06.2006";18;"45.9";1825;61011;59186
163;"12.06.2006";19;"45.6";1715;60560;58845
163;"12.06.2006";20;"44.1";1453;59575;58122
163;"12.06.2006";21;42;1284;57146;55862
163;"12.06.2006";22;"40.1";1569;55388;53819
163;"12.06.2006";23;"42.4";2051;54478;52427
163;"12.06.2006";24;"38.4";2441;49636;47195
164;"13.06.2006";1;33;2591;45193;42602
164;"13.06.2006";2;"30.2";2622;43178;40556
164;"13.06.2006";3;"25.6";2426;42023;39597
164;"13.06.2006";4;"24.4";2334;42039;39705
164;"13.06.2006";5;"27.5";2191;42665;40474
164;"13.06.2006";6;33;2167;45151;42984
164;"13.06.2006";7;36;1960;53231;51271
164;"13.06.2006";8;55;1266;60170;58904
164;"13.06.2006";9;"65.1";508;63322;62814
164;"13.06.2006";10;"72.1";209;63957;63748
164;"13.06.2006";11;"78.1";216;65344;65128
164;"13.06.2006";12;"91.9";318;66727;66409
164;"13.06.2006";13;84;471;65651;65180
164;"13.06.2006";14;"79.1";451;64882;64431
164;"13.06.2006";15;"79.1";373;64064;63691
164;"13.06.2006";16;70;266;63003;62737
164;"13.06.2006";17;"63.4";186;61568;61382
164;"13.06.2006";18;54;200;61299;61099
164;"13.06.2006";19;"54.1";252;60969;60717
164;"13.06.2006";20;48;293;59744;59451
164;"13.06.2006";21;"41.1";378;57719;57341
164;"13.06.2006";22;"40.1";615;56095;55480
164;"13.06.2006";23;"43.1";983;55224;54241
164;"13.06.2006";24;"36.3";1336;50506;49170
165;"14.06.2006";1;"35.6";1404;46520;45116
165;"14.06.2006";2;"33.2";1412;44328;42916
165;"14.06.2006";3;"30.6";1197;43179;41982
165;"14.06.2006";4;"25.1";1193;43027;41834
165;"14.06.2006";5;"26.4";1206;43568;42362
165;"14.06.2006";6;"31.1";1500;45770;44270
165;"14.06.2006";7;"37.2";1468;53478;52010
165;"14.06.2006";8;"52.1";1282;60187;58905
165;"14.06.2006";9;"55.1";1308;63626;62318
165;"14.06.2006";10;62;1626;64325;62699
165;"14.06.2006";11;73;1737;65591;63854
165;"14.06.2006";12;"80.1";1264;66934;65670
165;"14.06.2006";13;"69.5";1087;65889;64802
165;"14.06.2006";14;"67.8";1142;65414;64272
165;"14.06.2006";15;64;1427;64226;62799
165;"14.06.2006";16;"58.3";1959;63120;61161
165;"14.06.2006";17;52;2121;61870;59749
165;"14.06.2006";18;"46.4";1936;61336;59400
165;"14.06.2006";19;"46.7";1872;60678;58806
165;"14.06.2006";20;44;1892;59190;57298
165;"14.06.2006";21;45;1754;55871;54117
165;"14.06.2006";22;40;1798;53326;51528
165;"14.06.2006";23;44;1808;52363;50555
165;"14.06.2006";24;"37.1";1620;49643;48023
166;"15.06.2006";1;35;1374;45874;44500
166;"15.06.2006";2;32;1331;43527;42196
166;"15.06.2006";3;"30.4";1161;42110;40949
166;"15.06.2006";4;"25.3";1068;41607;40539
166;"15.06.2006";5;"22.3";1025;41140;40115
166;"15.06.2006";6;26;819;40349;39530
166;"15.06.2006";7;"22.2";823;42501;41678
166;"15.06.2006";8;"31.1";778;45982;45204
166;"15.06.2006";9;"33.3";549;48432;47883
166;"15.06.2006";10;34;441;50281;49840
166;"15.06.2006";11;"36.3";432;52100;51668
166;"15.06.2006";12;45;485;53912;53427
166;"15.06.2006";13;"44.9";425;53382;52957
166;"15.06.2006";14;"41.8";466;51878;51412
166;"15.06.2006";15;"38.4";652;50816;50164
166;"15.06.2006";16;"33.4";625;49954;49329
166;"15.06.2006";17;"34.7";833;49631;48798
166;"15.06.2006";18;"40.6";900;50561;49661
166;"15.06.2006";19;"42.1";828;51245;50417
166;"15.06.2006";20;"42.5";748;50692;49944
166;"15.06.2006";21;40;794;49595;48801
166;"15.06.2006";22;"37.1";849;48922;48073
166;"15.06.2006";23;"43.1";871;48833;47962
166;"15.06.2006";24;"35.2";846;44981;44135
167;"16.06.2006";1;"35.1";832;41802;40970
167;"16.06.2006";2;"33.3";872;39623;38751
167;"16.06.2006";3;"32.9";828;38791;37963
167;"16.06.2006";4;"24.3";748;38615;37867
167;"16.06.2006";5;"23.8";909;39400;38491
167;"16.06.2006";6;"32.8";806;41819;41013
167;"16.06.2006";7;"37.4";846;48847;48001
167;"16.06.2006";8;"59.9";631;55097;54466
167;"16.06.2006";9;52;472;58725;58253
167;"16.06.2006";10;"61.4";468;60160;59692
167;"16.06.2006";11;"68.7";403;61077;60674
167;"16.06.2006";12;"70.6";354;62215;61861
167;"16.06.2006";13;"68.3";304;61441;61137
167;"16.06.2006";14;63;368;60026;59658
167;"16.06.2006";15;"52.6";389;58549;58160
167;"16.06.2006";16;"53.5";475;57609;57134
167;"16.06.2006";17;54;775;56950;56175
167;"16.06.2006";18;51;923;56861;55938
167;"16.06.2006";19;50;1019;56525;55506
167;"16.06.2006";20;48;1032;55293;54261
167;"16.06.2006";21;"50.9";1081;53132;52051
167;"16.06.2006";22;"47.3";1109;51568;50459
167;"16.06.2006";23;"49.7";956;50689;49733
167;"16.06.2006";24;"45.1";956;46900;45944
168;"17.06.2006";1;"35.6";776;43417;42641
168;"17.06.2006";2;32;751;41248;40497
168;"17.06.2006";3;28;618;39963;39345
168;"17.06.2006";4;22;695;39524;38829
168;"17.06.2006";5;"21.2";878;39467;38589
168;"17.06.2006";6;"21.1";882;39368;38486
168;"17.06.2006";7;18;840;41511;40671
168;"17.06.2006";8;"22.2";921;45274;44353
168;"17.06.2006";9;34;864;49229;48365
168;"17.06.2006";10;"41.9";823;51842;51019
168;"17.06.2006";11;"43.6";794;53615;52821
168;"17.06.2006";12;"48.8";931;54705;53774
168;"17.06.2006";13;"45.1";1057;53255;52198
168;"17.06.2006";14;"39.1";1165;50697;49532
168;"17.06.2006";15;"36.1";1072;49021;47949
168;"17.06.2006";16;"34.9";1081;48371;47290
168;"17.06.2006";17;33;1182;47679;46497
168;"17.06.2006";18;"31.1";1199;48175;46976
168;"17.06.2006";19;33;972;48388;47416
168;"17.06.2006";20;32;770;47848;47078
168;"17.06.2006";21;"31.9";437;46111;45674
168;"17.06.2006";22;"31.5";275;44972;44697
168;"17.06.2006";23;35;301;45560;45259
168;"17.06.2006";24;33;366;42620;42254
169;"18.06.2006";1;"32.7";543;39301;38758
169;"18.06.2006";2;"21.4";668;37124;36456
169;"18.06.2006";3;"15.9";564;35682;35118
169;"18.06.2006";4;"11.1";530;34961;34431
169;"18.06.2006";5;"8.1";481;34528;34047
169;"18.06.2006";6;"8.5";577;33574;32997
169;"18.06.2006";7;5;507;34418;33911
169;"18.06.2006";8;11;336;36910;36574
169;"18.06.2006";9;"21.2";212;40320;40108
169;"18.06.2006";10;"34.6";155;43281;43126
169;"18.06.2006";11;35;161;45274;45113
169;"18.06.2006";12;"37.4";238;47483;47245
169;"18.06.2006";13;"37.5";332;46506;46174
169;"18.06.2006";14;"35.9";356;44515;44159
169;"18.06.2006";15;"33.8";336;42959;42623
169;"18.06.2006";16;"30.9";301;42316;42015
169;"18.06.2006";17;28;251;42473;42222
169;"18.06.2006";18;"33.4";219;44101;43882
169;"18.06.2006";19;"34.5";193;45887;45694
169;"18.06.2006";20;"35.1";198;46385;46187
169;"18.06.2006";21;35;272;46191;45919
169;"18.06.2006";22;"34.5";756;46337;45581
169;"18.06.2006";23;"36.6";1509;47780;46271
169;"18.06.2006";24;"34.9";2381;44491;42110
170;"19.06.2006";1;"30.7";2805;41251;38446
170;"19.06.2006";2;23;2685;39444;36759
170;"19.06.2006";3;22;2572;38735;36163
170;"19.06.2006";4;21;2457;39016;36559
170;"19.06.2006";5;"22.1";2279;39934;37655
170;"19.06.2006";6;"31.1";2279;42721;40442
170;"19.06.2006";7;"35.8";2036;51753;49717
170;"19.06.2006";8;49;1545;59510;57965
170;"19.06.2006";9;"49.6";991;63305;62314
170;"19.06.2006";10;54;893;64245;63352
170;"19.06.2006";11;"63.6";1240;66137;64897
170;"19.06.2006";12;84;1681;67743;66062
170;"19.06.2006";13;75;1780;66278;64498
170;"19.06.2006";14;"68.1";2197;66413;64216
170;"19.06.2006";15;"64.4";2046;65394;63348
170;"19.06.2006";16;"51.5";1955;64725;62770
170;"19.06.2006";17;"51.6";2257;63368;61111
170;"19.06.2006";18;"49.9";2337;62694;60357
170;"19.06.2006";19;"48.2";2169;61804;59635
170;"19.06.2006";20;"44.9";2016;60408;58392
170;"19.06.2006";21;"43.2";1281;57998;56717
170;"19.06.2006";22;"41.3";952;56015;55063
170;"19.06.2006";23;"41.1";842;54612;53770
170;"19.06.2006";24;"33.7";943;49379;48436
171;"20.06.2006";1;36;898;45920;45022
171;"20.06.2006";2;"32.7";874;43882;43008
171;"20.06.2006";3;30;806;43064;42258
171;"20.06.2006";4;"26.1";828;43149;42321
171;"20.06.2006";5;"24.3";993;43963;42970
171;"20.06.2006";6;"29.9";1087;46502;45415
171;"20.06.2006";7;40;928;54280;53352
171;"20.06.2006";8;"51.3";698;60795;60097
171;"20.06.2006";9;"53.1";675;63813;63138
171;"20.06.2006";10;"58.2";825;64463;63638
171;"20.06.2006";11;"62.9";1090;65701;64611
171;"20.06.2006";12;"70.1";1423;67392;65969
171;"20.06.2006";13;"63.3";1732;66847;65115
171;"20.06.2006";14;"59.9";1745;66279;64534
171;"20.06.2006";15;"52.2";1761;65450;63689
171;"20.06.2006";16;"51.5";1571;63948;62377
171;"20.06.2006";17;"52.2";1338;61746;60408
171;"20.06.2006";18;"51.1";1119;61043;59924
171;"20.06.2006";19;"49.3";893;61145;60252
171;"20.06.2006";20;"41.3";626;60400;59774
171;"20.06.2006";21;"44.2";472;58157;57685
171;"20.06.2006";22;40;513;56224;55711
171;"20.06.2006";23;"42.1";743;54810;54067
171;"20.06.2006";24;"35.1";733;49856;49123
172;"21.06.2006";1;"35.4";842;46384;45542
172;"21.06.2006";2;"30.9";1090;44444;43354
172;"21.06.2006";3;"27.5";1608;43299;41691
172;"21.06.2006";4;"21.4";1638;43527;41889
172;"21.06.2006";5;"20.8";1929;44283;42354
172;"21.06.2006";6;25;2336;46792;44456
172;"21.06.2006";7;34;2402;54576;52174
172;"21.06.2006";8;"49.9";2280;61126;58846
172;"21.06.2006";9;"52.9";2789;64200;61411
172;"21.06.2006";10;"57.5";3643;65002;61359
172;"21.06.2006";11;62;4420;66380;61960
172;"21.06.2006";12;"68.3";4545;67503;62958
172;"21.06.2006";13;"63.8";4237;66406;62169
172;"21.06.2006";14;64;3942;65566;61624
172;"21.06.2006";15;64;4032;64564;60532
172;"21.06.2006";16;"57.9";3939;63634;59695
172;"21.06.2006";17;"57.9";4268;62404;58136
172;"21.06.2006";18;52;4020;61726;57706
172;"21.06.2006";19;52;3593;61293;57700
172;"21.06.2006";20;48;3155;60569;57414
172;"21.06.2006";21;"41.2";2641;58199;55558
172;"21.06.2006";22;"41.2";2553;56068;53515
172;"21.06.2006";23;"41.2";2441;54775;52334
172;"21.06.2006";24;34;2775;50363;47588
173;"22.06.2006";1;31;2915;46237;43322
173;"22.06.2006";2;"30.1";3007;43997;40990
173;"22.06.2006";3;"22.1";2916;42815;39899
173;"22.06.2006";4;"21.3";2820;42754;39934
173;"22.06.2006";5;"11.8";2983;43399;40416
173;"22.06.2006";6;"24.1";3337;45892;42555
173;"22.06.2006";7;"33.4";3387;53857;50470
173;"22.06.2006";8;"45.4";3545;60555;57010
173;"22.06.2006";9;"51.5";4016;63794;59778
173;"22.06.2006";10;"52.6";4592;64348;59756
173;"22.06.2006";11;"57.1";5266;65745;60479
173;"22.06.2006";12;"66.1";5874;67060;61186
173;"22.06.2006";13;"58.1";6008;66608;60600
173;"22.06.2006";14;"59.1";6379;65660;59281
173;"22.06.2006";15;"56.1";6786;64830;58044
173;"22.06.2006";16;"52.1";7149;64127;56978
173;"22.06.2006";17;"49.1";7338;62449;55111
173;"22.06.2006";18;"47.9";6668;61697;55029
173;"22.06.2006";19;"47.1";5453;60862;55409
173;"22.06.2006";20;42;4212;59327;55115
173;"22.06.2006";21;"41.9";3169;56931;53762
173;"22.06.2006";22;40;2450;54999;52549
173;"22.06.2006";23;"40.5";2179;53943;51764
173;"22.06.2006";24;"36.1";2385;49153;46768
174;"23.06.2006";1;36;3005;45928;42923
174;"23.06.2006";2;"33.1";2987;43861;40874
174;"23.06.2006";3;"27.2";2876;42616;39740
174;"23.06.2006";4;"29.9";2736;42661;39925
174;"23.06.2006";5;"21.2";2767;43505;40738
174;"23.06.2006";6;"30.3";2503;45647;43144
174;"23.06.2006";7;40;2113;53011;50898
174;"23.06.2006";8;"52.1";1653;59553;57900
174;"23.06.2006";9;52;1618;62751;61133
174;"23.06.2006";10;"65.1";1788;63410;61622
174;"23.06.2006";11;"67.3";2095;64389;62294
174;"23.06.2006";12;"70.5";2015;65426;63411
174;"23.06.2006";13;"65.6";1881;64479;62598
174;"23.06.2006";14;62;1705;62675;60970
174;"23.06.2006";15;57;1727;61226;59499
174;"23.06.2006";16;52;1655;59953;58298
174;"23.06.2006";17;51;1381;59039;57658
174;"23.06.2006";18;"50.1";1335;58737;57402
174;"23.06.2006";19;"49.9";1094;58079;56985
174;"23.06.2006";20;"45.1";835;56714;55879
174;"23.06.2006";21;"48.3";577;54212;53635
174;"23.06.2006";22;"44.9";424;52582;52158
174;"23.06.2006";23;"49.6";396;52025;51629
174;"23.06.2006";24;"39.7";479;47899;47420
175;"24.06.2006";1;"50.3";563;44310;43747
175;"24.06.2006";2;"37.3";636;42065;41429
175;"24.06.2006";3;"34.8";720;40729;40009
175;"24.06.2006";4;"26.9";735;40118;39383
175;"24.06.2006";5;"21.6";670;39780;39110
175;"24.06.2006";6;"20.3";691;39332;38641
175;"24.06.2006";7;"30.8";676;42337;41661
175;"24.06.2006";8;"37.2";391;46409;46018
175;"24.06.2006";9;"43.9";174;50571;50397
175;"24.06.2006";10;"45.5";175;53258;53083
175;"24.06.2006";11;"49.6";242;54625;54383
175;"24.06.2006";12;"46.5";284;55445;55161
175;"24.06.2006";13;46;256;53657;53401
175;"24.06.2006";14;"43.1";226;51314;51088
175;"24.06.2006";15;"42.1";189;49526;49337
175;"24.06.2006";16;39;213;48821;48608
175;"24.06.2006";17;38;237;48261;48024
175;"24.06.2006";18;"39.3";289;47741;47452
175;"24.06.2006";19;"41.3";298;47286;46988
175;"24.06.2006";20;40;390;47704;47314
175;"24.06.2006";21;"36.4";482;45964;45482
175;"24.06.2006";22;"35.1";981;45050;44069
175;"24.06.2006";23;"35.9";1585;45690;44105
175;"24.06.2006";24;"34.1";1985;43296;41311
176;"25.06.2006";1;"29.8";2302;39960;37658
176;"25.06.2006";2;"22.9";2134;37512;35378
176;"25.06.2006";3;"16.3";1998;36338;34340
176;"25.06.2006";4;"13.6";1768;35604;33836
176;"25.06.2006";5;"9.9";1544;35200;33656
176;"25.06.2006";6;"5.1";1394;34310;32916
176;"25.06.2006";7;"5.1";1095;35424;34329
176;"25.06.2006";8;"21.4";499;38034;37535
176;"25.06.2006";9;"25.2";188;41001;40813
176;"25.06.2006";10;33;123;43921;43798
176;"25.06.2006";11;35;187;46170;45983
176;"25.06.2006";12;"39.7";411;48410;47999
176;"25.06.2006";13;"37.6";640;47490;46850
176;"25.06.2006";14;35;720;45289;44569
176;"25.06.2006";15;"32.5";648;43946;43298
176;"25.06.2006";16;"30.4";613;43412;42799
176;"25.06.2006";17;"29.8";677;43652;42975
176;"25.06.2006";18;"34.9";887;45448;44561
176;"25.06.2006";19;"35.7";1136;47214;46078
176;"25.06.2006";20;"36.1";1467;48082;46615
176;"25.06.2006";21;"36.2";1967;47883;45916
176;"25.06.2006";22;36;2343;47600;45257
176;"25.06.2006";23;"41.3";2511;48007;45496
176;"25.06.2006";24;35;2658;45024;42366
177;"26.06.2006";1;"25.1";2955;41487;38532
177;"26.06.2006";2;"19.5";3125;39923;36798
177;"26.06.2006";3;13;3071;38948;35877
177;"26.06.2006";4;"8.9";2137;38563;36426
177;"26.06.2006";5;"14.7";1630;39495;37865
177;"26.06.2006";6;24;1425;42876;41451
177;"26.06.2006";7;"35.3";1329;51964;50635
177;"26.06.2006";8;"52.4";1379;59550;58171
177;"26.06.2006";9;"53.9";1618;63649;62031
177;"26.06.2006";10;59;1674;64929;63255
177;"26.06.2006";11;66;1944;66290;64346
177;"26.06.2006";12;"70.3";2215;67830;65615
177;"26.06.2006";13;66;2705;66902;64197
177;"26.06.2006";14;"62.8";3310;66042;62732
177;"26.06.2006";15;"60.1";3757;64974;61217
177;"26.06.2006";16;"55.1";3999;63708;59709
177;"26.06.2006";17;"51.5";4386;62352;57966
177;"26.06.2006";18;"48.4";4212;61606;57394
177;"26.06.2006";19;"47.1";4244;60836;56592
177;"26.06.2006";20;"43.9";3488;59611;56123
177;"26.06.2006";21;"42.2";3181;57040;53859
177;"26.06.2006";22;"40.8";3171;55254;52083
177;"26.06.2006";23;"41.3";3400;54037;50637
177;"26.06.2006";24;"36.5";3707;49738;46031
178;"27.06.2006";1;34;3606;45622;42016
178;"27.06.2006";2;"30.1";3837;43563;39726
178;"27.06.2006";3;"27.9";3452;42428;38976
178;"27.06.2006";4;"19.5";3300;42396;39096
178;"27.06.2006";5;22;3132;43177;40045
178;"27.06.2006";6;31;2857;45616;42759
178;"27.06.2006";7;"34.9";2572;53358;50786
178;"27.06.2006";8;45;2324;60267;57943
178;"27.06.2006";9;"59.9";2180;63259;61079
178;"27.06.2006";10;"61.9";2073;63989;61916
178;"27.06.2006";11;66;1977;65128;63151
178;"27.06.2006";12;80;1758;66878;65120
178;"27.06.2006";13;"66.7";1483;65995;64512
178;"27.06.2006";14;67;1134;65128;63994
178;"27.06.2006";15;"75.1";1158;64187;63029
178;"27.06.2006";16;"67.9";1046;63361;62315
178;"27.06.2006";17;60;919;61973;61054
178;"27.06.2006";18;"54.5";1124;61531;60407
178;"27.06.2006";19;"51.1";1261;60659;59398
178;"27.06.2006";20;"47.9";1818;59700;57882
178;"27.06.2006";21;"47.9";1796;57146;55350
178;"27.06.2006";22;"44.9";1100;55229;54129
178;"27.06.2006";23;"50.2";964;53865;52901
178;"27.06.2006";24;38;1005;48990;47985
179;"28.06.2006";1;38;972;45241;44269
179;"28.06.2006";2;"34.9";894;43102;42208
179;"28.06.2006";3;"30.8";969;42112;41143
179;"28.06.2006";4;"30.1";1138;42037;40899
179;"28.06.2006";5;"25.4";1103;42903;41800
179;"28.06.2006";6;36;1225;45494;44269
179;"28.06.2006";7;"44.5";935;53219;52284
179;"28.06.2006";8;68;879;59701;58822
179;"28.06.2006";9;"65.9";1132;62994;61862
179;"28.06.2006";10;"68.1";1101;63672;62571
179;"28.06.2006";11;"75.2";1311;65184;63873
179;"28.06.2006";12;80;1349;66382;65033
179;"28.06.2006";13;"75.1";1483;65171;63688
179;"28.06.2006";14;"73.9";1634;64333;62699
179;"28.06.2006";15;"70.3";1882;63243;61361
179;"28.06.2006";16;"68.9";1832;62138;60306
179;"28.06.2006";17;"61.9";1770;60758;58988
179;"28.06.2006";18;"53.7";1704;60218;58514
179;"28.06.2006";19;51;1623;59900;58277
179;"28.06.2006";20;44;1548;58917;57369
179;"28.06.2006";21;"43.9";1440;56334;54894
179;"28.06.2006";22;41;1406;54672;53266
179;"28.06.2006";23;"39.9";1355;53445;52090
179;"28.06.2006";24;"36.6";1173;48849;47676
180;"29.06.2006";1;"30.9";1034;45254;44220
180;"29.06.2006";2;"29.2";922;43112;42190
180;"29.06.2006";3;"22.1";778;42219;41441
180;"29.06.2006";4;"20.1";765;42137;41372
180;"29.06.2006";5;"19.1";746;42931;42185
180;"29.06.2006";6;"29.3";796;45288;44492
180;"29.06.2006";7;"36.2";679;52849;52170
180;"29.06.2006";8;45;518;59428;58910
180;"29.06.2006";9;"60.7";357;62714;62357
180;"29.06.2006";10;68;311;63568;63257
180;"29.06.2006";11;74;365;64795;64430
180;"29.06.2006";12;"80.3";445;66141;65696
180;"29.06.2006";13;"75.1";443;65177;64734
180;"29.06.2006";14;"72.7";429;64423;63994
180;"29.06.2006";15;"75.1";467;63513;63046
180;"29.06.2006";16;67;751;62543;61792
180;"29.06.2006";17;67;912;61449;60537
180;"29.06.2006";18;"57.6";1014;61068;60054
180;"29.06.2006";19;"55.2";1262;60548;59286
180;"29.06.2006";20;"45.1";1413;59357;57944
180;"29.06.2006";21;"42.6";1462;56702;55240
180;"29.06.2006";22;"38.9";1642;54831;53189
180;"29.06.2006";23;40;1841;53784;51943
180;"29.06.2006";24;"35.3";1905;49390;47485
181;"30.06.2006";1;33;1801;45517;43716
181;"30.06.2006";2;"30.9";1591;43265;41674
181;"30.06.2006";3;"24.5";1285;41964;40679
181;"30.06.2006";4;"21.4";1297;42053;40756
181;"30.06.2006";5;"19.6";1248;42821;41573
181;"30.06.2006";6;"29.5";1086;45115;44029
181;"30.06.2006";7;"34.9";820;52627;51807
181;"30.06.2006";8;56;449;59543;59094
181;"30.06.2006";9;"56.5";222;62915;62693
181;"30.06.2006";10;60;224;63565;63341
181;"30.06.2006";11;62;294;64624;64330
181;"30.06.2006";12;"77.1";390;65478;65088
181;"30.06.2006";13;"62.7";365;64282;63917
181;"30.06.2006";14;"56.6";365;62211;61846
181;"30.06.2006";15;"53.7";488;60537;60049
181;"30.06.2006";16;"47.8";645;59342;58697
181;"30.06.2006";17;"46.1";663;57761;57098
181;"30.06.2006";18;"42.1";782;56087;55305
181;"30.06.2006";19;"39.4";794;54619;53825
181;"30.06.2006";20;"35.5";803;52967;52164
181;"30.06.2006";21;"37.2";953;52621;51668
181;"30.06.2006";22;"35.6";1095;51578;50483
181;"30.06.2006";23;38;1488;51451;49963
181;"30.06.2006";24;"34.5";1603;47865;46262
182;"01.07.2006";1;"31.1";1474;44217;42743
182;"01.07.2006";2;"28.4";1336;41860;40524
182;"01.07.2006";3;"24.3";1361;40678;39317
182;"01.07.2006";4;"22.2";1214;40113;38899
182;"01.07.2006";5;20;1073;39743;38670
182;"01.07.2006";6;15;984;39159;38175
182;"01.07.2006";7;19;869;41845;40976
182;"01.07.2006";8;"33.6";476;46218;45742
182;"01.07.2006";9;36;218;49867;49649
182;"01.07.2006";10;"46.2";182;52285;52103
182;"01.07.2006";11;52;261;53663;53402
182;"01.07.2006";12;"60.7";397;54397;54000
182;"01.07.2006";13;67;503;52850;52347
182;"01.07.2006";14;"51.1";608;50669;50061
182;"01.07.2006";15;"41.9";777;48910;48133
182;"01.07.2006";16;40;1027;48072;47045
182;"01.07.2006";17;"39.3";1166;47650;46484
182;"01.07.2006";18;36;1216;48311;47095
182;"01.07.2006";19;"34.6";1377;48227;46850
182;"01.07.2006";20;"33.4";1511;47337;45826
182;"01.07.2006";21;"35.4";1503;46441;44938
182;"01.07.2006";22;"33.8";1874;45281;43407
182;"01.07.2006";23;38;2396;45702;43306
182;"01.07.2006";24;"34.1";2772;42998;40226
183;"02.07.2006";1;"24.3";2883;39224;36341
183;"02.07.2006";2;"16.1";2871;36978;34107
183;"02.07.2006";3;"13.6";2735;35868;33133
183;"02.07.2006";4;"10.8";2582;35148;32566
183;"02.07.2006";5;"10.1";2457;34521;32064
183;"02.07.2006";6;"6.8";2427;33864;31437
183;"02.07.2006";7;"2.1";2154;35231;33077
183;"02.07.2006";8;"7.8";1352;37448;36096
183;"02.07.2006";9;"20.1";744;40566;39822
183;"02.07.2006";10;"28.1";824;42980;42156
183;"02.07.2006";11;"35.2";1956;44832;42876
183;"02.07.2006";12;"36.5";3283;46924;43641
183;"02.07.2006";13;"36.3";3595;45663;42068
183;"02.07.2006";14;"31.1";3577;43745;40168
183;"02.07.2006";15;"30.1";3418;42242;38824
183;"02.07.2006";16;"27.3";3572;41700;38128
183;"02.07.2006";17;"25.2";3750;41825;38075
183;"02.07.2006";18;"28.1";3713;43219;39506
183;"02.07.2006";19;"34.6";3421;44931;41510
183;"02.07.2006";20;"35.9";3294;45538;42244
183;"02.07.2006";21;"35.5";2811;45020;42209
183;"02.07.2006";22;"34.5";2881;45200;42319
183;"02.07.2006";23;42;3388;47268;43880
183;"02.07.2006";24;"35.1";3657;44262;40605
184;"03.07.2006";1;"25.5";3572;40879;37307
184;"03.07.2006";2;"21.3";3208;39022;35814
184;"03.07.2006";3;"14.7";2916;38088;35172
184;"03.07.2006";4;"8.6";3069;38292;35223
184;"03.07.2006";5;"9.9";3012;39329;36317
184;"03.07.2006";6;"21.2";2995;42325;39330
184;"03.07.2006";7;"34.7";2566;51262;48696
184;"03.07.2006";8;50;1497;58454;56957
184;"03.07.2006";9;"55.9";902;62213;61311
184;"03.07.2006";10;62;1410;63141;61731
184;"03.07.2006";11;"65.7";2630;64226;61596
184;"03.07.2006";12;"74.5";3829;65823;61994
184;"03.07.2006";13;"66.8";3856;65001;61145
184;"03.07.2006";14;"66.7";3787;64479;60692
184;"03.07.2006";15;"63.1";3587;63683;60096
184;"03.07.2006";16;"59.9";3387;62666;59279
184;"03.07.2006";17;"53.4";3415;61468;58053
184;"03.07.2006";18;"49.1";3277;60629;57352
184;"03.07.2006";19;46;3146;59985;56839
184;"03.07.2006";20;42;2812;59290;56478
184;"03.07.2006";21;"41.3";2417;56988;54571
184;"03.07.2006";22;"41.3";2845;55198;52353
184;"03.07.2006";23;"42.1";3506;54625;51119
184;"03.07.2006";24;"36.1";3800;49746;45946
185;"04.07.2006";1;"37.6";3590;46009;42419
185;"04.07.2006";2;"34.1";3282;44223;40941
185;"04.07.2006";3;"29.1";3131;42976;39845
185;"04.07.2006";4;"19.9";2828;43213;40385
185;"04.07.2006";5;"19.5";2504;43866;41362
185;"04.07.2006";6;"31.1";2461;45957;43496
185;"04.07.2006";7;"35.5";2184;53365;51181
185;"04.07.2006";8;"52.2";1341;59942;58601
185;"04.07.2006";9;75;608;63242;62634
185;"04.07.2006";10;"79.3";569;64203;63634
185;"04.07.2006";11;"83.2";1011;65404;64393
185;"04.07.2006";12;"114.8";1611;66881;65270
185;"04.07.2006";13;"81.1";1669;66166;64497
185;"04.07.2006";14;78;1483;65471;63988
185;"04.07.2006";15;"77.2";1267;64543;63276
185;"04.07.2006";16;"75.1";1062;63424;62362
185;"04.07.2006";17;68;1026;62205;61179
185;"04.07.2006";18;64;1101;61747;60646
185;"04.07.2006";19;"58.1";1171;61291;60120
185;"04.07.2006";20;"46.1";1306;59687;58381
185;"04.07.2006";21;"44.2";1446;55305;53859
185;"04.07.2006";22;"42.8";2013;52234;50221
185;"04.07.2006";23;"45.6";2793;52054;49261
185;"04.07.2006";24;39;3165;50361;47196
186;"05.07.2006";1;"38.9";3034;47756;44722
186;"05.07.2006";2;35;2829;45233;42404
186;"05.07.2006";3;"31.6";2548;43818;41270
186;"05.07.2006";4;"27.1";2338;43479;41141
186;"05.07.2006";5;"27.1";2435;44286;41851
186;"05.07.2006";6;"34.3";2488;46324;43836
186;"05.07.2006";7;"37.5";2174;53510;51336
186;"05.07.2006";8;50;1476;60310;58834
186;"05.07.2006";9;60;879;63897;63018
186;"05.07.2006";10;77;1174;64646;63472
186;"05.07.2006";11;"81.9";1344;66052;64708
186;"05.07.2006";12;"92.2";1560;67689;66129
186;"05.07.2006";13;"94.9";1487;66658;65171
186;"05.07.2006";14;79;1450;65883;64433
186;"05.07.2006";15;"80.1";1229;65043;63814
186;"05.07.2006";16;79;1085;63895;62810
186;"05.07.2006";17;"71.2";1021;62672;61651
186;"05.07.2006";18;"60.1";973;62382;61409
186;"05.07.2006";19;"57.3";886;62002;61116
186;"05.07.2006";20;"52.5";988;61018;60030
186;"05.07.2006";21;50;1398;58940;57542
186;"05.07.2006";22;"44.2";2001;56983;54982
186;"05.07.2006";23;45;2305;55325;53020
186;"05.07.2006";24;39;2105;50767;48662
187;"06.07.2006";1;"35.9";1835;47022;45187
187;"06.07.2006";2;"33.4";2007;45180;43173
187;"06.07.2006";3;"32.8";1651;44125;42474
187;"06.07.2006";4;"24.3";1376;44039;42663
187;"06.07.2006";5;"27.1";1289;44555;43266
187;"06.07.2006";6;31;1523;46880;45357
187;"06.07.2006";7;40;1338;54235;52897
187;"06.07.2006";8;68;731;60622;59891
187;"06.07.2006";9;"61.5";402;63769;63367
187;"06.07.2006";10;"68.9";355;64487;64132
187;"06.07.2006";11;"78.6";665;65566;64901
187;"06.07.2006";12;"100.6";550;66922;66372
187;"06.07.2006";13;"83.8";428;65970;65542
187;"06.07.2006";14;"97.4";432;65197;64765
187;"06.07.2006";15;"79.9";509;64481;63972
187;"06.07.2006";16;"76.4";560;64133;63573
187;"06.07.2006";17;74;478;63036;62558
187;"06.07.2006";18;"67.9";582;62899;62317
187;"06.07.2006";19;"60.8";592;62234;61642
187;"06.07.2006";20;"51.5";629;61041;60412
187;"06.07.2006";21;"47.7";560;58803;58243
187;"06.07.2006";22;44;668;56965;56297
187;"06.07.2006";23;"49.1";714;55252;54538
187;"06.07.2006";24;"39.9";476;50648;50172
188;"07.07.2006";1;"36.4";518;47142;46624
188;"07.07.2006";2;"34.7";628;44989;44361
188;"07.07.2006";3;"30.4";464;43666;43202
188;"07.07.2006";4;"27.7";447;43863;43416
188;"07.07.2006";5;30;351;44634;44283
188;"07.07.2006";6;"32.5";358;46760;46402
188;"07.07.2006";7;"39.8";498;54190;53692
188;"07.07.2006";8;66;375;60945;60570
188;"07.07.2006";9;"56.1";269;64366;64097
188;"07.07.2006";10;"63.5";259;65435;65176
188;"07.07.2006";11;"70.1";263;66920;66657
188;"07.07.2006";12;"76.2";336;68059;67723
188;"07.07.2006";13;"71.1";377;66630;66253
188;"07.07.2006";14;"67.5";468;64977;64509
188;"07.07.2006";15;58;666;63582;62916
188;"07.07.2006";16;"52.4";869;62503;61634
188;"07.07.2006";17;"45.1";1146;61341;60195
188;"07.07.2006";18;42;1547;61143;59596
188;"07.07.2006";19;"50.9";1759;60367;58608
188;"07.07.2006";20;"44.3";1485;58959;57474
188;"07.07.2006";21;"45.2";1119;55800;54681
188;"07.07.2006";22;"39.4";978;54067;53089
188;"07.07.2006";23;"44.3";733;53087;52354
188;"07.07.2006";24;"36.1";605;49229;48624
189;"08.07.2006";1;"34.7";613;45936;45323
189;"08.07.2006";2;"26.4";644;43602;42958
189;"08.07.2006";3;"24.1";567;42120;41553
189;"08.07.2006";4;21;585;41518;40933
189;"08.07.2006";5;"16.2";523;41290;40767
189;"08.07.2006";6;"11.1";468;41031;40563
189;"08.07.2006";7;21;499;43567;43068
189;"08.07.2006";8;"30.8";481;47634;47153
189;"08.07.2006";9;"35.6";432;51449;51017
189;"08.07.2006";10;"40.6";482;54372;53890
189;"08.07.2006";11;"39.5";534;55780;55246
189;"08.07.2006";12;"42.1";597;56685;56088
189;"08.07.2006";13;41;644;54919;54275
189;"08.07.2006";14;40;644;52523;51879
189;"08.07.2006";15;39;781;50698;49917
189;"08.07.2006";16;"34.6";732;49493;48761
189;"08.07.2006";17;"36.2";712;48838;48126
189;"08.07.2006";18;"37.6";644;49137;48493
189;"08.07.2006";19;"37.1";501;49383;48882
189;"08.07.2006";20;"35.2";326;48675;48349
189;"08.07.2006";21;"33.8";215;46689;46474
189;"08.07.2006";22;"32.9";136;45381;45245
189;"08.07.2006";23;"36.2";164;45567;45403
189;"08.07.2006";24;32;248;43740;43492
190;"09.07.2006";1;30;457;40355;39898
190;"09.07.2006";2;"22.8";746;37806;37060
190;"09.07.2006";3;"16.1";1046;36572;35526
190;"09.07.2006";4;"9.8";1258;36005;34747
190;"09.07.2006";5;8;1358;35581;34223
190;"09.07.2006";6;"3.9";1368;34566;33198
190;"09.07.2006";7;"3.9";1312;35414;34102
190;"09.07.2006";8;"7.3";1005;37835;36830
190;"09.07.2006";9;"16.5";769;40803;40034
190;"09.07.2006";10;"27.5";793;43506;42713
190;"09.07.2006";11;"30.8";1139;45844;44705
190;"09.07.2006";12;"35.7";1588;48443;46855
190;"09.07.2006";13;"36.1";1980;46963;44983
190;"09.07.2006";14;32;2658;45252;42594
190;"09.07.2006";15;28;3185;43876;40691
190;"09.07.2006";16;"24.2";3799;43313;39514
190;"09.07.2006";17;"24.3";3224;43154;39930
190;"09.07.2006";18;"30.2";2919;44475;41556
190;"09.07.2006";19;"32.9";2665;46307;43642
190;"09.07.2006";20;34;2182;46879;44697
190;"09.07.2006";21;33;1667;45801;44134
190;"09.07.2006";22;"35.5";1432;45394;43962
190;"09.07.2006";23;"40.4";1725;46586;44861
190;"09.07.2006";24;"35.3";2174;44618;42444
191;"10.07.2006";1;"27.6";2183;41395;39212
191;"10.07.2006";2;"22.5";2583;39841;37258
191;"10.07.2006";3;"20.2";2498;39014;36516
191;"10.07.2006";4;"16.3";2560;39020;36460
191;"10.07.2006";5;"16.5";2547;40033;37486
191;"10.07.2006";6;"24.8";2338;42852;40514
191;"10.07.2006";7;"37.3";1908;51467;49559
191;"10.07.2006";8;54;1381;58808;57427
191;"10.07.2006";9;"62.3";1261;62432;61171
191;"10.07.2006";10;67;1353;63278;61925
191;"10.07.2006";11;"71.4";1614;64774;63160
191;"10.07.2006";12;"83.3";1708;66424;64716
191;"10.07.2006";13;"76.1";1682;65519;63837
191;"10.07.2006";14;76;1683;64889;63206
191;"10.07.2006";15;73;1443;63990;62547
191;"10.07.2006";16;"68.1";1148;62764;61616
191;"10.07.2006";17;"61.9";874;61323;60449
191;"10.07.2006";18;"53.9";633;61057;60424
191;"10.07.2006";19;"53.4";436;60485;60049
191;"10.07.2006";20;"49.2";302;59599;59297
191;"10.07.2006";21;"45.6";230;57131;56901
191;"10.07.2006";22;"44.2";246;55539;55293
191;"10.07.2006";23;45;261;54779;54518
191;"10.07.2006";24;"38.5";308;49955;49647
192;"11.07.2006";1;36;501;45995;45494
192;"11.07.2006";2;"33.6";793;44114;43321
192;"11.07.2006";3;"28.4";1005;42540;41535
192;"11.07.2006";4;"29.9";1182;42566;41384
192;"11.07.2006";5;"32.2";1230;43430;42200
192;"11.07.2006";6;"30.1";1219;45760;44541
192;"11.07.2006";7;"39.4";1109;53246;52137
192;"11.07.2006";8;"67.9";762;60174;59412
192;"11.07.2006";9;65;457;63416;62959
192;"11.07.2006";10;76;380;64382;64002
192;"11.07.2006";11;79;437;65769;65332
192;"11.07.2006";12;"84.9";666;67183;66517
192;"11.07.2006";13;"75.2";743;66232;65489
192;"11.07.2006";14;"75.1";851;65298;64447
192;"11.07.2006";15;"75.1";924;64445;63521
192;"11.07.2006";16;74;1141;63631;62490
192;"11.07.2006";17;"69.9";1344;61990;60646
192;"11.07.2006";18;"62.1";1810;61563;59753
192;"11.07.2006";19;"59.1";2068;61057;58989
192;"11.07.2006";20;51;1943;59954;58011
192;"11.07.2006";21;"60.4";1828;57416;55588
192;"11.07.2006";22;"47.7";1844;55915;54071
192;"11.07.2006";23;"47.6";1861;54629;52768
192;"11.07.2006";24;"36.3";1720;49662;47942
193;"12.07.2006";1;"38.8";1739;46119;44380
193;"12.07.2006";2;"37.3";1614;43831;42217
193;"12.07.2006";3;"33.7";1384;42832;41448
193;"12.07.2006";4;"24.2";1080;42838;41758
193;"12.07.2006";5;"28.5";908;43755;42847
193;"12.07.2006";6;"35.3";797;46059;45262
193;"12.07.2006";7;"41.3";655;53504;52849
193;"12.07.2006";8;"64.7";492;59895;59403
193;"12.07.2006";9;65;331;63063;62732
193;"12.07.2006";10;"79.7";174;63834;63660
193;"12.07.2006";11;"81.9";123;64783;64660
193;"12.07.2006";12;"100.1";149;66300;66151
193;"12.07.2006";13;"92.4";179;65422;65243
193;"12.07.2006";14;100;191;65022;64831
193;"12.07.2006";15;86;216;64247;64031
193;"12.07.2006";16;110;244;63402;63158
193;"12.07.2006";17;"82.5";280;62223;61943
193;"12.07.2006";18;"77.9";313;61667;61354
193;"12.07.2006";19;70;389;60804;60415
193;"12.07.2006";20;"58.2";488;59719;59231
193;"12.07.2006";21;"52.1";554;57233;56679
193;"12.07.2006";22;53;773;55415;54642
193;"12.07.2006";23;"53.7";1139;54590;53451
193;"12.07.2006";24;44;1262;50260;48998
194;"13.07.2006";1;"40.2";1189;46717;45528
194;"13.07.2006";2;"35.2";973;44642;43669
194;"13.07.2006";3;33;811;43285;42474
194;"13.07.2006";4;27;570;43249;42679
194;"13.07.2006";5;"31.2";506;44341;43835
194;"13.07.2006";6;36;425;46528;46103
194;"13.07.2006";7;46;343;53832;53489
194;"13.07.2006";8;"76.3";144;59823;59679
194;"13.07.2006";9;77;74;62883;62809
194;"13.07.2006";10;"80.9";68;63609;63541
194;"13.07.2006";11;"91.3";108;64916;64808
194;"13.07.2006";12;"106.2";107;66229;66122
194;"13.07.2006";13;"89.8";113;65510;65397
194;"13.07.2006";14;"87.1";169;64678;64509
194;"13.07.2006";15;"81.1";265;64119;63854
194;"13.07.2006";16;"76.7";508;63292;62784
194;"13.07.2006";17;"77.2";1110;62294;61184
194;"13.07.2006";18;69;1746;61897;60151
194;"13.07.2006";19;65;2063;61509;59446
194;"13.07.2006";20;54;2510;60432;57922
194;"13.07.2006";21;"49.1";3223;57510;54287
194;"13.07.2006";22;"44.2";3278;55454;52176
194;"13.07.2006";23;"45.1";3357;54500;51143
194;"13.07.2006";24;"40.5";3314;50088;46774
195;"14.07.2006";1;"39.3";3339;46565;43226
195;"14.07.2006";2;"36.1";3528;44950;41422
195;"14.07.2006";3;30;3406;43744;40338
195;"14.07.2006";4;25;3268;43701;40433
195;"14.07.2006";5;"24.3";3291;44320;41029
195;"14.07.2006";6;"32.2";3452;46587;43135
195;"14.07.2006";7;"40.8";3352;53525;50173
195;"14.07.2006";8;66;3179;60036;56857
195;"14.07.2006";9;66;3373;63157;59784
195;"14.07.2006";10;66;3657;63733;60076
195;"14.07.2006";11;"69.9";3551;64836;61285
195;"14.07.2006";12;"91.3";3271;65883;62612
195;"14.07.2006";13;"69.9";3178;64745;61567
195;"14.07.2006";14;"56.9";3037;62910;59873
195;"14.07.2006";15;"52.9";3096;61484;58388
195;"14.07.2006";16;"49.7";3407;60444;57037
195;"14.07.2006";17;"41.9";3701;59483;55782
195;"14.07.2006";18;"49.7";3748;59196;55448
195;"14.07.2006";19;"46.4";3735;58554;54819
195;"14.07.2006";20;"42.3";3462;57008;53546
195;"14.07.2006";21;"48.9";2832;53849;51017
195;"14.07.2006";22;"45.1";2481;52088;49607
195;"14.07.2006";23;"57.9";2505;51533;49028
195;"14.07.2006";24;"45.1";2513;47671;45158
196;"15.07.2006";1;"40.3";2220;44169;41949
196;"15.07.2006";2;"33.1";1829;41803;39974
196;"15.07.2006";3;"31.3";1619;40401;38782
196;"15.07.2006";4;31;1427;40052;38625
196;"15.07.2006";5;"28.1";1202;39690;38488
196;"15.07.2006";6;"29.6";1243;39319;38076
196;"15.07.2006";7;"21.3";1137;41575;40438
196;"15.07.2006";8;"36.5";634;45420;44786
196;"15.07.2006";9;"46.9";392;49207;48815
196;"15.07.2006";10;"54.2";602;51568;50966
196;"15.07.2006";11;"62.5";860;52943;52083
196;"15.07.2006";12;"62.5";1053;53751;52698
196;"15.07.2006";13;"53.1";1372;52103;50731
196;"15.07.2006";14;"50.8";1518;49804;48286
196;"15.07.2006";15;50;1615;47953;46338
196;"15.07.2006";16;"47.7";1860;47265;45405
196;"15.07.2006";17;"45.1";2044;46779;44735
196;"15.07.2006";18;"44.1";2198;47436;45238
196;"15.07.2006";19;43;2285;47729;45444
196;"15.07.2006";20;"40.4";2299;47031;44732
196;"15.07.2006";21;39;2304;45233;42929
196;"15.07.2006";22;"36.5";2469;44290;41821
196;"15.07.2006";23;"40.4";3113;45298;42185
196;"15.07.2006";24;39;3243;42443;39200
197;"16.07.2006";1;"32.4";3159;39207;36048
197;"16.07.2006";2;"22.1";2781;37204;34423
197;"16.07.2006";3;"19.1";2466;35676;33210
197;"16.07.2006";4;"15.1";2229;35199;32970
197;"16.07.2006";5;"11.4";2088;34998;32910
197;"16.07.2006";6;"10.1";1957;34365;32408
197;"16.07.2006";7;"7.5";1749;35307;33558
197;"16.07.2006";8;"20.8";1077;37764;36687
197;"16.07.2006";9;"28.2";726;40531;39805
197;"16.07.2006";10;"38.1";955;42833;41878
197;"16.07.2006";11;40;1224;44555;43331
197;"16.07.2006";12;44;1549;46264;44715
197;"16.07.2006";13;"41.4";1615;45326;43711
197;"16.07.2006";14;"39.1";1654;43316;41662
197;"16.07.2006";15;"38.5";1651;42040;40389
197;"16.07.2006";16;38;1554;41379;39825
197;"16.07.2006";17;"37.3";1503;41378;39875
197;"16.07.2006";18;"36.5";1525;42673;41148
197;"16.07.2006";19;"37.9";1479;44451;42972
197;"16.07.2006";20;39;1384;45011;43627
197;"16.07.2006";21;"39.8";1226;44792;43566
197;"16.07.2006";22;39;1441;45360;43919
197;"16.07.2006";23;"43.3";1844;46826;44982
197;"16.07.2006";24;"34.6";1974;43595;41621
198;"17.07.2006";1;"38.5";1893;40693;38800
198;"17.07.2006";2;36;1944;38957;37013
198;"17.07.2006";3;"25.2";1739;37901;36162
198;"17.07.2006";4;"22.1";1582;38481;36899
198;"17.07.2006";5;"23.7";1265;39476;38211
198;"17.07.2006";6;"35.9";930;41998;41068
198;"17.07.2006";7;"41.1";667;49975;49308
198;"17.07.2006";8;"61.3";386;56997;56611
198;"17.07.2006";9;"77.5";159;60487;60328
198;"17.07.2006";10;89;118;61551;61433
198;"17.07.2006";11;100;139;63182;63043
198;"17.07.2006";12;"197.8";174;64520;64346
198;"17.07.2006";13;"119.2";197;63712;63515
198;"17.07.2006";14;"132.3";192;63012;62820
198;"17.07.2006";15;"105.1";183;62066;61883
198;"17.07.2006";16;100;178;61414;61236
198;"17.07.2006";17;"87.5";202;60121;59919
198;"17.07.2006";18;"77.6";207;60068;59861
198;"17.07.2006";19;75;265;59735;59470
198;"17.07.2006";20;"60.3";334;58638;58304
198;"17.07.2006";21;"56.1";320;56121;55801
198;"17.07.2006";22;"53.3";491;54871;54380
198;"17.07.2006";23;"57.3";633;53868;53235
198;"17.07.2006";24;46;651;49053;48402
199;"18.07.2006";1;"46.1";568;44830;44262
199;"18.07.2006";2;"38.4";512;43169;42657
199;"18.07.2006";3;"37.1";488;42148;41660
199;"18.07.2006";4;"32.6";487;42029;41542
199;"18.07.2006";5;"33.7";423;42749;42326
199;"18.07.2006";6;"37.4";357;44892;44535
199;"18.07.2006";7;47;273;52160;51887
199;"18.07.2006";8;70;298;58604;58306
199;"18.07.2006";9;75;132;61507;61375
199;"18.07.2006";10;"135.9";152;62461;62309
199;"18.07.2006";11;200;325;63893;63568
199;"18.07.2006";12;"205.2";487;65203;64716
199;"18.07.2006";13;120;549;64416;63867
199;"18.07.2006";14;"129.4";581;63577;62996
199;"18.07.2006";15;"205.1";700;62737;62037
199;"18.07.2006";16;"197.6";723;61743;61020
199;"18.07.2006";17;111;726;60902;60176
199;"18.07.2006";18;"85.4";719;60765;60046
199;"18.07.2006";19;75;735;60277;59542
199;"18.07.2006";20;72;782;59155;58373
199;"18.07.2006";21;68;801;56472;55671
199;"18.07.2006";22;"66.9";960;54982;54022
199;"18.07.2006";23;"67.1";1114;53975;52861
199;"18.07.2006";24;"41.9";1012;49247;48235
200;"19.07.2006";1;"41.3";824;45587;44763
200;"19.07.2006";2;"38.1";666;43548;42882
200;"19.07.2006";3;"35.1";580;42250;41670
200;"19.07.2006";4;"32.6";568;42148;41580
200;"19.07.2006";5;36;515;42978;42463
200;"19.07.2006";6;"38.1";493;45176;44683
200;"19.07.2006";7;50;550;52230;51680
200;"19.07.2006";8;67;480;58779;58299
200;"19.07.2006";9;"86.3";189;61933;61744
200;"19.07.2006";10;"135.9";109;63322;63213
200;"19.07.2006";11;"169.4";154;64589;64435
200;"19.07.2006";12;300;199;65977;65778
200;"19.07.2006";13;"200.1";176;64873;64697
200;"19.07.2006";14;"192.1";198;63958;63760
200;"19.07.2006";15;"107.1";217;62794;62577
200;"19.07.2006";16;101;238;61752;61514
200;"19.07.2006";17;"150.2";291;60767;60476
200;"19.07.2006";18;"90.1";341;60700;60359
200;"19.07.2006";19;"74.9";453;60343;59890
200;"19.07.2006";20;"72.9";515;59472;58957
200;"19.07.2006";21;"63.6";597;57160;56563
200;"19.07.2006";22;"64.9";978;56068;55090
200;"19.07.2006";23;"57.1";1522;54953;53431
200;"19.07.2006";24;50;1929;49824;47895
201;"20.07.2006";1;"48.5";2063;46271;44208
201;"20.07.2006";2;"43.1";1943;44391;42448
201;"20.07.2006";3;"37.8";1856;43297;41441
201;"20.07.2006";4;"34.4";1626;43118;41492
201;"20.07.2006";5;36;1532;43708;42176
201;"20.07.2006";6;"38.5";1393;45777;44384
201;"20.07.2006";7;"48.1";1306;52725;51419
201;"20.07.2006";8;"66.1";1127;58817;57690
201;"20.07.2006";9;"83.3";812;62189;61377
201;"20.07.2006";10;"85.5";449;63476;63027
201;"20.07.2006";11;"123.6";382;64909;64527
201;"20.07.2006";12;100;451;66405;65954
201;"20.07.2006";13;"83.2";544;65223;64679
201;"20.07.2006";14;95;691;64347;63656
201;"20.07.2006";15;118;802;63668;62866
201;"20.07.2006";16;89;881;62450;61569
201;"20.07.2006";17;"73.7";1094;61469;60375
201;"20.07.2006";18;"75.3";1546;61465;59919
201;"20.07.2006";19;"75.1";1563;60589;59026
201;"20.07.2006";20;"66.1";1784;59453;57669
201;"20.07.2006";21;"72.9";2299;57334;55035
201;"20.07.2006";22;"70.1";2187;56206;54019
201;"20.07.2006";23;"74.1";1972;54604;52632
201;"20.07.2006";24;"66.7";1524;49743;48219
202;"21.07.2006";1;"47.6";982;46321;45339
202;"21.07.2006";2;"41.3";1204;44530;43326
202;"21.07.2006";3;41;949;43340;42391
202;"21.07.2006";4;"39.1";1044;43262;42218
202;"21.07.2006";5;"39.7";1341;43993;42652
202;"21.07.2006";6;"45.1";1405;46317;44912
202;"21.07.2006";7;"62.9";1535;52610;51075
202;"21.07.2006";8;"73.3";1211;59163;57952
202;"21.07.2006";9;150;801;62172;61371
202;"21.07.2006";10;290;937;63146;62209
202;"21.07.2006";11;"250.1";1157;64747;63590
202;"21.07.2006";12;"300.1";1590;65920;64330
202;"21.07.2006";13;300;1779;64737;62958
202;"21.07.2006";14;"98.5";2119;63082;60963
202;"21.07.2006";15;80;2407;61941;59534
202;"21.07.2006";16;"83.3";2479;60821;58342
202;"21.07.2006";17;"82.4";2489;60038;57549
202;"21.07.2006";18;90;2588;59978;57390
202;"21.07.2006";19;"80.1";2691;59465;56774
202;"21.07.2006";20;"72.4";2306;58252;55946
202;"21.07.2006";21;"66.6";1622;55104;53482
202;"21.07.2006";22;"65.2";1365;53530;52165
202;"21.07.2006";23;"61.1";1381;52919;51538
202;"21.07.2006";24;56;1320;49124;47804
203;"22.07.2006";1;53;1254;45964;44710
203;"22.07.2006";2;"46.1";1094;43719;42625
203;"22.07.2006";3;"42.2";1054;42021;40967
203;"22.07.2006";4;"34.6";1063;41515;40452
203;"22.07.2006";5;36;979;41531;40552
203;"22.07.2006";6;"35.7";949;41103;40154
203;"22.07.2006";7;31;840;43454;42614
203;"22.07.2006";8;"35.1";554;47185;46631
203;"22.07.2006";9;"47.1";399;50772;50373
203;"22.07.2006";10;"63.1";286;53203;52917
203;"22.07.2006";11;70;396;54583;54187
203;"22.07.2006";12;72;458;55413;54955
203;"22.07.2006";13;"75.4";492;53699;53207
203;"22.07.2006";14;72;743;51687;50944
203;"22.07.2006";15;"68.1";716;50092;49376
203;"22.07.2006";16;65;739;49519;48780
203;"22.07.2006";17;"58.1";790;49279;48489
203;"22.07.2006";18;58;831;49947;49116
203;"22.07.2006";19;58;879;50013;49134
203;"22.07.2006";20;51;1256;49288;48032
203;"22.07.2006";21;"45.6";1155;46926;45771
203;"22.07.2006";22;"44.7";1416;46566;45150
203;"22.07.2006";23;"46.4";1375;46321;44946
203;"22.07.2006";24;38;1223;43394;42171
204;"23.07.2006";1;45;1248;40629;39381
204;"23.07.2006";2;"38.1";1263;38560;37297
204;"23.07.2006";3;38;1272;37285;36013
204;"23.07.2006";4;30;1395;36756;35361
204;"23.07.2006";5;26;1413;36626;35213
204;"23.07.2006";6;"25.2";1396;36171;34775
204;"23.07.2006";7;"17.2";1284;36876;35592
204;"23.07.2006";8;"20.7";850;38696;37846
204;"23.07.2006";9;"34.7";629;41643;41014
204;"23.07.2006";10;"42.9";416;44247;43831
204;"23.07.2006";11;"47.6";349;45523;45174
204;"23.07.2006";12;"51.1";428;47308;46880
204;"23.07.2006";13;"50.2";590;46556;45966
204;"23.07.2006";14;"45.4";838;44912;44074
204;"23.07.2006";15;"41.9";1184;43784;42600
204;"23.07.2006";16;"41.3";1258;43511;42253
204;"23.07.2006";17;"40.3";1220;43484;42264
204;"23.07.2006";18;43;1352;44355;43003
204;"23.07.2006";19;"44.1";1506;45597;44091
204;"23.07.2006";20;"46.1";1286;46091;44805
204;"23.07.2006";21;"50.1";908;45641;44733
204;"23.07.2006";22;"50.9";746;46541;45795
204;"23.07.2006";23;"53.4";911;47690;46779
204;"23.07.2006";24;"48.8";916;44378;43462
205;"24.07.2006";1;41;711;41733;41022
205;"24.07.2006";2;"31.4";723;40004;39281
205;"24.07.2006";3;"28.9";740;39291;38551
205;"24.07.2006";4;"31.1";675;39458;38783
205;"24.07.2006";5;"31.5";661;40658;39997
205;"24.07.2006";6;"37.5";564;43687;43123
205;"24.07.2006";7;"54.5";425;51007;50582
205;"24.07.2006";8;"83.8";284;57907;57623
205;"24.07.2006";9;"98.1";265;61490;61225
205;"24.07.2006";10;"140.1";372;62832;62460
205;"24.07.2006";11;"229.4";465;64357;63892
205;"24.07.2006";12;"399.9";430;66035;65605
205;"24.07.2006";13;"264.5";435;65110;64675
205;"24.07.2006";14;"202.1";549;64491;63942
205;"24.07.2006";15;"231.2";643;63418;62775
205;"24.07.2006";16;209;787;62360;61573
205;"24.07.2006";17;154;871;61071;60200
205;"24.07.2006";18;98;915;60727;59812
205;"24.07.2006";19;"78.7";902;60225;59323
205;"24.07.2006";20;"75.1";906;59218;58312
205;"24.07.2006";21;"77.5";817;56769;55952
205;"24.07.2006";22;"74.9";913;55689;54776
205;"24.07.2006";23;"76.3";1178;54316;53138
205;"24.07.2006";24;"56.3";1198;50014;48816
206;"25.07.2006";1;"42.5";1093;46283;45190
206;"25.07.2006";2;"40.2";977;44144;43167
206;"25.07.2006";3;"35.7";862;43214;42352
206;"25.07.2006";4;"35.9";787;43091;42304
206;"25.07.2006";5;"36.6";764;44033;43269
206;"25.07.2006";6;44;718;46476;45758
206;"25.07.2006";7;56;808;53043;52235
206;"25.07.2006";8;"76.1";668;59383;58715
206;"25.07.2006";9;"123.1";258;62458;62200
206;"25.07.2006";10;"290.6";156;63260;63104
206;"25.07.2006";11;"300.1";184;64304;64120
206;"25.07.2006";12;"2000.1";252;65126;64874
206;"25.07.2006";13;"499.9";251;64589;64338
206;"25.07.2006";14;450;272;63810;63538
206;"25.07.2006";15;"300.1";316;62981;62665
206;"25.07.2006";16;"292.2";375;62238;61863
206;"25.07.2006";17;"182.5";400;61200;60800
206;"25.07.2006";18;"80.4";504;61040;60536
206;"25.07.2006";19;"79.9";639;60453;59814
206;"25.07.2006";20;"74.4";868;59484;58616
206;"25.07.2006";21;"84.9";1131;57218;56087
206;"25.07.2006";22;"80.4";1631;56342;54711
206;"25.07.2006";23;"78.1";1866;54866;53000
206;"25.07.2006";24;62;1794;50074;48280
207;"26.07.2006";1;"52.8";1628;46634;45006
207;"26.07.2006";2;"44.3";1488;44508;43020
207;"26.07.2006";3;"40.8";1443;43485;42042
207;"26.07.2006";4;"36.4";1321;43358;42037
207;"26.07.2006";5;"35.9";1281;44342;43061
207;"26.07.2006";6;"47.6";1133;46527;45394
207;"26.07.2006";7;"51.1";1071;53250;52179
207;"26.07.2006";8;"78.4";733;59479;58746
207;"26.07.2006";9;"99.7";318;62317;61999
207;"26.07.2006";10;"129.9";166;63432;63266
207;"26.07.2006";11;"119.9";212;65119;64907
207;"26.07.2006";12;"144.6";320;66168;65848
207;"26.07.2006";13;220;307;65200;64893
207;"26.07.2006";14;"200.2";294;64405;64111
207;"26.07.2006";15;"139.7";330;63461;63131
207;"26.07.2006";16;"139.8";374;62474;62100
207;"26.07.2006";17;300;439;61181;60742
207;"26.07.2006";18;"94.9";556;60832;60276
207;"26.07.2006";19;76;656;60379;59723
207;"26.07.2006";20;"72.5";949;59443;58494
207;"26.07.2006";21;"78.3";1200;57445;56245
207;"26.07.2006";22;"80.1";1399;56709;55310
207;"26.07.2006";23;"78.3";1515;54863;53348
207;"26.07.2006";24;"56.6";1375;50592;49217
208;"27.07.2006";1;"54.7";1131;47211;46080
208;"27.07.2006";2;"47.4";1072;45017;43945
208;"27.07.2006";3;"39.4";984;43701;42717
208;"27.07.2006";4;"41.2";858;43476;42618
208;"27.07.2006";5;"41.3";1015;44120;43105
208;"27.07.2006";6;"49.8";1013;46595;45582
208;"27.07.2006";7;"51.8";817;53007;52190
208;"27.07.2006";8;"77.4";653;58940;58287
208;"27.07.2006";9;"120.6";270;61678;61408
208;"27.07.2006";10;"499.7";149;62754;62605
208;"27.07.2006";11;"998.2";133;63979;63846
208;"27.07.2006";12;1400;219;65312;65093
208;"27.07.2006";13;"699.8";352;64286;63934
208;"27.07.2006";14;"699.9";536;63631;63095
208;"27.07.2006";15;"800.1";929;62740;61811
208;"27.07.2006";16;"693.2";1487;62041;60554
208;"27.07.2006";17;"279.8";1384;61171;59787
208;"27.07.2006";18;106;1398;60811;59413
208;"27.07.2006";19;"139.7";1235;60131;58896
208;"27.07.2006";20;"87.5";1468;59143;57675
208;"27.07.2006";21;89;1382;57396;56014
208;"27.07.2006";22;"85.1";1556;56838;55282
208;"27.07.2006";23;"78.4";1316;54539;53223
208;"27.07.2006";24;57;1140;49959;48819
209;"28.07.2006";1;"69.9";893;47097;46204
209;"28.07.2006";2;"61.2";706;45304;44598
209;"28.07.2006";3;"47.9";645;44220;43575
209;"28.07.2006";4;"46.2";785;44051;43266
209;"28.07.2006";5;"49.1";821;44880;44059
209;"28.07.2006";6;55;782;47397;46615
209;"28.07.2006";7;"60.8";617;53532;52915
209;"28.07.2006";8;"91.8";645;59188;58543
209;"28.07.2006";9;"109.8";502;62144;61642
209;"28.07.2006";10;180;457;63059;62602
209;"28.07.2006";11;224;366;64438;64072
209;"28.07.2006";12;"384.9";242;65242;65000
209;"28.07.2006";13;"274.9";350;64257;63907
209;"28.07.2006";14;"169.9";359;62599;62240
209;"28.07.2006";15;150;379;61154;60775
209;"28.07.2006";16;"105.1";431;60016;59585
209;"28.07.2006";17;"95.9";403;59475;59072
209;"28.07.2006";18;"75.9";706;59394;58688
209;"28.07.2006";19;"72.6";1240;58640;57400
209;"28.07.2006";20;"66.8";896;57304;56408
209;"28.07.2006";21;"69.5";792;54735;53943
209;"28.07.2006";22;70;849;53688;52839
209;"28.07.2006";23;"66.7";900;51948;51048
209;"28.07.2006";24;50;767;47935;47168
210;"29.07.2006";1;"59.5";727;45129;44402
210;"29.07.2006";2;"52.8";507;43089;42582
210;"29.07.2006";3;51;460;41686;41226
210;"29.07.2006";4;"42.1";516;41268;40752
210;"29.07.2006";5;"39.5";693;41525;40832
210;"29.07.2006";6;"39.7";415;41698;41283
210;"29.07.2006";7;38;427;43238;42811
210;"29.07.2006";8;"55.8";320;46508;46188
210;"29.07.2006";9;"78.5";274;49845;49571
210;"29.07.2006";10;"82.5";260;52497;52237
210;"29.07.2006";11;"85.7";281;53916;53635
210;"29.07.2006";12;"87.1";325;54938;54613
210;"29.07.2006";13;"70.1";380;53489;53109
210;"29.07.2006";14;"59.9";671;51312;50641
210;"29.07.2006";15;"54.9";899;49464;48565
210;"29.07.2006";16;47;1106;48580;47474
210;"29.07.2006";17;47;1479;48088;46609
210;"29.07.2006";18;49;1510;48489;46979
210;"29.07.2006";19;"56.9";1166;48589;47423
210;"29.07.2006";20;"62.8";994;47861;46867
210;"29.07.2006";21;"54.9";560;46083;45523
210;"29.07.2006";22;"52.8";481;46284;45803
210;"29.07.2006";23;"57.4";436;45748;45312
210;"29.07.2006";24;"46.2";354;42584;42230
211;"30.07.2006";1;"43.6";420;40195;39775
211;"30.07.2006";2;"37.9";517;38255;37738
211;"30.07.2006";3;34;519;36977;36458
211;"30.07.2006";4;34;564;36414;35850
211;"30.07.2006";5;"28.8";569;36204;35635
211;"30.07.2006";6;25;524;35629;35105
211;"30.07.2006";7;"27.3";639;35596;34957
211;"30.07.2006";8;"37.7";564;37500;36936
211;"30.07.2006";9;"37.9";398;40368;39970
211;"30.07.2006";10;"40.8";241;42732;42491
211;"30.07.2006";11;46;353;44950;44597
211;"30.07.2006";12;51;527;47049;46522
211;"30.07.2006";13;52;743;46163;45420
211;"30.07.2006";14;"47.9";899;44488;43589
211;"30.07.2006";15;"43.6";882;43214;42332
211;"30.07.2006";16;40;792;42811;42019
211;"30.07.2006";17;"36.5";804;42784;41980
211;"30.07.2006";18;"37.9";772;43813;43041
211;"30.07.2006";19;46;1088;45200;44112
211;"30.07.2006";20;"51.4";1473;45938;44465
211;"30.07.2006";21;"50.1";1368;45678;44310
211;"30.07.2006";22;"49.3";1409;46705;45296
211;"30.07.2006";23;"52.9";1774;46798;45024
211;"30.07.2006";24;"40.3";2080;43771;41691
212;"31.07.2006";1;"43.5";2241;40969;38728
212;"31.07.2006";2;"35.4";2019;39171;37152
212;"31.07.2006";3;32;2052;38366;36314
212;"31.07.2006";4;"33.3";2197;38570;36373
212;"31.07.2006";5;"32.5";2054;39709;37655
212;"31.07.2006";6;"36.4";1674;42668;40994
212;"31.07.2006";7;52;1497;49625;48128
212;"31.07.2006";8;"71.5";1423;56383;54960
212;"31.07.2006";9;"79.9";1570;60105;58535
212;"31.07.2006";10;"85.3";1597;61293;59696
212;"31.07.2006";11;"85.4";1651;63032;61381
212;"31.07.2006";12;130;1836;64429;62593
212;"31.07.2006";13;100;1983;63787;61804
212;"31.07.2006";14;"92.1";2104;62906;60802
212;"31.07.2006";15;"85.3";2156;61715;59559
212;"31.07.2006";16;"83.2";1983;60672;58689
212;"31.07.2006";17;77;1794;59431;57637
212;"31.07.2006";18;"77.9";1414;58877;57463
212;"31.07.2006";19;"76.6";971;58182;57211
212;"31.07.2006";20;"69.7";863;57056;56193
212;"31.07.2006";21;67;738;54688;53950
212;"31.07.2006";22;"67.2";772;54000;53228
212;"31.07.2006";23;"59.9";875;51742;50867
212;"31.07.2006";24;"51.6";1038;47231;46193
213;"01.08.2006";1;"44.3";1049;43631;42582
213;"01.08.2006";2;"35.8";1020;41828;40808
213;"01.08.2006";3;"33.8";1046;40862;39816
213;"01.08.2006";4;31;1273;40786;39513
213;"01.08.2006";5;32;1491;41719;40228
213;"01.08.2006";6;"36.1";1682;44436;42754
213;"01.08.2006";7;"39.6";1736;50987;49251
213;"01.08.2006";8;"54.2";1690;57322;55632
213;"01.08.2006";9;71;1436;60671;59235
213;"01.08.2006";10;71;1699;61912;60213
213;"01.08.2006";11;77;2147;63268;61121
213;"01.08.2006";12;"88.2";2847;64983;62136
213;"01.08.2006";13;"79.9";3627;64034;60407
213;"01.08.2006";14;"71.1";4187;63146;58959
213;"01.08.2006";15;"66.4";4211;61846;57635
213;"01.08.2006";16;67;4477;60670;56193
213;"01.08.2006";17;"63.9";5043;59379;54336
213;"01.08.2006";18;"63.1";4716;58704;53988
213;"01.08.2006";19;"56.5";4548;58440;53892
213;"01.08.2006";20;"55.7";4277;57228;52951
213;"01.08.2006";21;"55.9";3998;55088;51090
213;"01.08.2006";22;"50.9";3289;54112;50823
213;"01.08.2006";23;"48.6";3467;51494;48027
213;"01.08.2006";24;"37.8";3665;46699;43034
214;"02.08.2006";1;"34.1";3817;43514;39697
214;"02.08.2006";2;"32.6";4651;41748;37097
214;"02.08.2006";3;29;4391;40858;36467
214;"02.08.2006";4;"26.9";4368;40809;36441
214;"02.08.2006";5;"27.9";4724;41898;37174
214;"02.08.2006";6;"34.7";4607;44599;39992
214;"02.08.2006";7;36;4642;50973;46331
214;"02.08.2006";8;"57.7";4731;56793;52062
214;"02.08.2006";9;50;5210;60100;54890
214;"02.08.2006";10;"59.8";5920;61459;55539
214;"02.08.2006";11;"58.7";6579;62759;56180
214;"02.08.2006";12;"69.8";6929;64615;57686
214;"02.08.2006";13;"62.8";6842;63519;56677
214;"02.08.2006";14;"60.1";6224;62165;55941
214;"02.08.2006";15;"61.3";5892;60743;54851
214;"02.08.2006";16;"61.6";5622;59628;54006
214;"02.08.2006";17;"68.4";5376;58364;52988
214;"02.08.2006";18;"69.2";4645;58116;53471
214;"02.08.2006";19;"66.9";3523;57628;54105
214;"02.08.2006";20;"60.3";2671;56360;53689
214;"02.08.2006";21;"57.7";2186;54041;51855
214;"02.08.2006";22;"57.8";2023;53699;51676
214;"02.08.2006";23;"55.9";2270;51104;48834
214;"02.08.2006";24;"43.6";2573;46517;43944
215;"03.08.2006";1;"38.3";2413;43258;40845
215;"03.08.2006";2;"33.3";2054;41214;39160
215;"03.08.2006";3;"27.1";1704;40349;38645
215;"03.08.2006";4;"26.9";1526;40461;38935
215;"03.08.2006";5;"29.9";1276;41221;39945
215;"03.08.2006";6;36;1258;44246;42988
215;"03.08.2006";7;"41.1";1041;50351;49310
215;"03.08.2006";8;"54.5";651;56360;55709
215;"03.08.2006";9;"62.9";498;59858;59360
215;"03.08.2006";10;60;462;60884;60422
215;"03.08.2006";11;"66.1";575;62659;62084
215;"03.08.2006";12;"70.1";644;64221;63577
215;"03.08.2006";13;"68.1";702;63119;62417
215;"03.08.2006";14;"63.1";531;61852;61321
215;"03.08.2006";15;"61.4";408;60684;60276
215;"03.08.2006";16;"58.2";362;59649;59287
215;"03.08.2006";17;"56.5";274;58263;57989
215;"03.08.2006";18;"48.3";345;57969;57624
215;"03.08.2006";19;"47.1";291;57528;57237
215;"03.08.2006";20;43;272;56327;56055
215;"03.08.2006";21;"43.3";267;54118;53851
215;"03.08.2006";22;"43.7";302;53564;53262
215;"03.08.2006";23;46;349;50739;50390
215;"03.08.2006";24;"36.5";385;45943;45558
216;"04.08.2006";1;31;421;42731;42310
216;"04.08.2006";2;27;423;40993;40570
216;"04.08.2006";3;"23.1";367;39854;39487
216;"04.08.2006";4;"22.2";289;39944;39655
216;"04.08.2006";5;"22.6";223;40976;40753
216;"04.08.2006";6;"29.9";209;44004;43795
216;"04.08.2006";7;"38.8";280;49598;49318
216;"04.08.2006";8;"65.8";292;55807;55515
216;"04.08.2006";9;60;222;59615;59393
216;"04.08.2006";10;"71.4";170;60895;60725
216;"04.08.2006";11;"73.9";267;62376;62109
216;"04.08.2006";12;"76.7";517;63809;63292
216;"04.08.2006";13;66;543;62458;61915
216;"04.08.2006";14;"59.9";658;60392;59734
216;"04.08.2006";15;"51.5";805;58846;58041
216;"04.08.2006";16;"45.2";871;57616;56745
216;"04.08.2006";17;"44.9";1230;57026;55796
216;"04.08.2006";18;44;1098;56961;55863
216;"04.08.2006";19;42;1122;56353;55231
216;"04.08.2006";20;"39.6";1301;55057;53756
216;"04.08.2006";21;42;1197;52775;51578
216;"04.08.2006";22;41;915;51659;50744
216;"04.08.2006";23;"38.1";909;49100;48191
216;"04.08.2006";24;"34.3";1109;45118;44009
217;"05.08.2006";1;"38.4";1155;42128;40973
217;"05.08.2006";2;36;1136;40278;39142
217;"05.08.2006";3;"33.5";1272;38987;37715
217;"05.08.2006";4;"30.1";1399;38605;37206
217;"05.08.2006";5;"27.1";1440;38671;37231
217;"05.08.2006";6;25;1474;39156;37682
217;"05.08.2006";7;"22.9";1457;41035;39578
217;"05.08.2006";8;"25.9";1281;44408;43127
217;"05.08.2006";9;"34.4";1154;47846;46692
217;"05.08.2006";10;37;1426;50725;49299
217;"05.08.2006";11;"41.4";2036;52234;50198
217;"05.08.2006";12;"44.9";2938;53528;50590
217;"05.08.2006";13;"42.2";3427;52317;48890
217;"05.08.2006";14;38;3601;50128;46527
217;"05.08.2006";15;"35.7";4461;48443;43982
217;"05.08.2006";16;"35.8";4791;47845;43054
217;"05.08.2006";17;"34.9";4474;47219;42745
217;"05.08.2006";18;37;4721;47948;43227
217;"05.08.2006";19;"35.7";4836;48410;43574
217;"05.08.2006";20;"35.7";4240;47530;43290
217;"05.08.2006";21;34;3473;45843;42370
217;"05.08.2006";22;"34.6";3059;45650;42591
217;"05.08.2006";23;"35.8";3376;44470;41094
217;"05.08.2006";24;"26.1";3268;41148;37880
218;"06.08.2006";1;28;3294;38430;35136
218;"06.08.2006";2;"25.1";3371;36669;33298
218;"06.08.2006";3;"23.4";3532;35478;31946
218;"06.08.2006";4;"20.1";3459;34663;31204
218;"06.08.2006";5;18;3290;34340;31050
218;"06.08.2006";6;"16.1";3500;34349;30849
218;"06.08.2006";7;"12.3";3535;34682;31147
218;"06.08.2006";8;"18.1";3203;36636;33433
218;"06.08.2006";9;"24.2";3103;40036;36933
218;"06.08.2006";10;"31.2";2950;42811;39861
218;"06.08.2006";11;"37.4";3105;45173;42068
218;"06.08.2006";12;"43.1";3311;47732;44421
218;"06.08.2006";13;"37.8";3691;46600;42909
218;"06.08.2006";14;33;4368;44570;40202
218;"06.08.2006";15;30;4844;43304;38460
218;"06.08.2006";16;25;5262;42500;37238
218;"06.08.2006";17;"26.9";5679;42600;36921
218;"06.08.2006";18;"32.7";5874;43646;37772
218;"06.08.2006";19;"37.4";5297;44961;39664
218;"06.08.2006";20;"37.9";4747;45252;40505
218;"06.08.2006";21;"37.9";4260;44944;40684
218;"06.08.2006";22;"37.9";4136;45888;41752
218;"06.08.2006";23;41;4355;45547;41192
218;"06.08.2006";24;"31.5";4502;42119;37617
219;"07.08.2006";1;"26.4";4161;39281;35120
219;"07.08.2006";2;"23.4";3886;37354;33468
219;"07.08.2006";3;20;3657;36916;33259
219;"07.08.2006";4;16;3488;36722;33234
219;"07.08.2006";5;17;3629;37834;34205
219;"07.08.2006";6;"23.5";3674;41208;37534
219;"07.08.2006";7;"32.1";3539;48592;45053
219;"07.08.2006";8;42;3028;55069;52041
219;"07.08.2006";9;"56.7";2740;59192;56452
219;"07.08.2006";10;60;3244;60616;57372
219;"07.08.2006";11;"59.3";3751;62189;58438
219;"07.08.2006";12;"65.9";4111;64101;59990
219;"07.08.2006";13;"58.1";4291;63063;58772
219;"07.08.2006";14;"61.3";4573;62105;57532
219;"07.08.2006";15;60;4924;61081;56157
219;"07.08.2006";16;"59.9";5244;59990;54746
219;"07.08.2006";17;"56.2";5543;58593;53050
219;"07.08.2006";18;"50.9";5702;58210;52508
219;"07.08.2006";19;"48.1";5783;57689;51906
219;"07.08.2006";20;"44.9";5101;56286;51185
219;"07.08.2006";21;40;4598;54087;49489
219;"07.08.2006";22;"39.5";4384;53981;49597
219;"07.08.2006";23;"38.1";4493;51162;46669
219;"07.08.2006";24;34;4506;46056;41550
220;"08.08.2006";1;"30.1";4209;42856;38647
220;"08.08.2006";2;"22.8";4211;41205;36994
220;"08.08.2006";3;"20.9";4041;40153;36112
220;"08.08.2006";4;"16.1";3924;40250;36326
220;"08.08.2006";5;21;3942;41205;37263
220;"08.08.2006";6;"29.1";3957;44243;40286
220;"08.08.2006";7;"35.8";4098;50343;46245
220;"08.08.2006";8;"51.4";3837;56260;52423
220;"08.08.2006";9;"67.1";4099;59834;55735
220;"08.08.2006";10;68;4073;60741;56668
220;"08.08.2006";11;"70.1";4702;62517;57815
220;"08.08.2006";12;"66.8";4912;64610;59698
220;"08.08.2006";13;"61.3";4855;63604;58749
220;"08.08.2006";14;"55.1";4773;62260;57487
220;"08.08.2006";15;"58.6";4847;61160;56313
220;"08.08.2006";16;52;5059;59906;54847
220;"08.08.2006";17;"50.9";4799;58318;53519
220;"08.08.2006";18;"50.9";4533;58193;53660
220;"08.08.2006";19;"49.6";3875;57770;53895
220;"08.08.2006";20;"45.6";3090;56543;53453
220;"08.08.2006";21;"45.9";2711;54444;51733
220;"08.08.2006";22;45;2553;54426;51873
220;"08.08.2006";23;"39.2";2518;50783;48265
220;"08.08.2006";24;"35.1";2353;45899;43546
221;"09.08.2006";1;"35.8";2019;42529;40510
221;"09.08.2006";2;"31.3";1858;40848;38990
221;"09.08.2006";3;"25.9";1959;40110;38151
221;"09.08.2006";4;"24.2";1875;40278;38403
221;"09.08.2006";5;"25.6";1752;41375;39623
221;"09.08.2006";6;35;1652;44312;42660
221;"09.08.2006";7;"38.1";1592;50704;49112
221;"09.08.2006";8;"54.9";1290;56585;55295
221;"09.08.2006";9;47;1139;59788;58649
221;"09.08.2006";10;"50.6";1349;60571;59222
221;"09.08.2006";11;"50.5";1375;62046;60671
221;"09.08.2006";12;60;1163;63972;62809
221;"09.08.2006";13;58;1369;62937;61568
221;"09.08.2006";14;"71.5";1419;61956;60537
221;"09.08.2006";15;"70.1";1535;60699;59164
221;"09.08.2006";16;68;1893;59547;57654
221;"09.08.2006";17;"59.5";2293;57910;55617
221;"09.08.2006";18;"51.9";1941;57787;55846
221;"09.08.2006";19;"46.9";1648;57783;56135
221;"09.08.2006";20;"40.4";1310;56622;55312
221;"09.08.2006";21;"46.9";1143;55176;54033
221;"09.08.2006";22;"46.2";999;54396;53397
221;"09.08.2006";23;"40.5";1062;50885;49823
221;"09.08.2006";24;"33.3";1309;46186;44877
222;"10.08.2006";1;"34.9";1352;42998;41646
222;"10.08.2006";2;30;1240;41037;39797
222;"10.08.2006";3;"27.1";1204;40001;38797
222;"10.08.2006";4;"22.8";1149;39992;38843
222;"10.08.2006";5;"25.1";1153;40996;39843
222;"10.08.2006";6;32;1135;43847;42712
222;"10.08.2006";7;37;1101;50549;49448
222;"10.08.2006";8;"51.5";1026;56827;55801
222;"10.08.2006";9;51;796;60376;59580
222;"10.08.2006";10;"52.9";829;61480;60651
222;"10.08.2006";11;"60.2";1048;62940;61892
222;"10.08.2006";12;"68.1";1093;64867;63774
222;"10.08.2006";13;66;1141;63898;62757
222;"10.08.2006";14;"63.3";1163;62796;61633
222;"10.08.2006";15;"60.3";1237;61365;60128
222;"10.08.2006";16;"59.6";1422;60268;58846
222;"10.08.2006";17;"52.9";1359;58469;57110
222;"10.08.2006";18;"48.1";1199;58706;57507
222;"10.08.2006";19;"46.3";1135;58651;57516
222;"10.08.2006";20;"42.2";1219;57465;56246
222;"10.08.2006";21;"43.5";961;55546;54585
222;"10.08.2006";22;"43.9";1024;54507;53483
222;"10.08.2006";23;"36.9";1035;50840;49805
222;"10.08.2006";24;"32.5";968;46041;45073
223;"11.08.2006";1;"32.8";1027;42760;41733
223;"11.08.2006";2;27;947;40890;39943
223;"11.08.2006";3;"23.2";860;39952;39092
223;"11.08.2006";4;"22.3";872;39867;38995
223;"11.08.2006";5;"22.6";762;40838;40076
223;"11.08.2006";6;31;737;44107;43370
223;"11.08.2006";7;"34.7";702;50654;49952
223;"11.08.2006";8;"40.1";605;56714;56109
223;"11.08.2006";9;"50.4";527;60360;59833
223;"11.08.2006";10;59;490;61535;61045
223;"11.08.2006";11;"58.5";492;62940;62448
223;"11.08.2006";12;"65.1";425;64113;63688
223;"11.08.2006";13;"55.6";399;63153;62754
223;"11.08.2006";14;53;522;61098;60576
223;"11.08.2006";15;"46.4";404;59337;58933
223;"11.08.2006";16;"40.8";423;58322;57899
223;"11.08.2006";17;"39.5";519;57292;56773
223;"11.08.2006";18;"39.6";441;57232;56791
223;"11.08.2006";19;"38.9";475;56827;56352
223;"11.08.2006";20;"35.6";321;55352;55031
223;"11.08.2006";21;36;286;53316;53030
223;"11.08.2006";22;36;270;52945;52675
223;"11.08.2006";23;36;301;50095;49794
223;"11.08.2006";24;"32.6";305;45841;45536
224;"12.08.2006";1;"35.9";303;42643;42340
224;"12.08.2006";2;"32.1";316;40456;40140
224;"12.08.2006";3;"29.5";329;38987;38658
224;"12.08.2006";4;"28.9";290;38637;38347
224;"12.08.2006";5;28;272;38663;38391
224;"12.08.2006";6;28;250;39584;39334
224;"12.08.2006";7;"24.3";219;41146;40927
224;"12.08.2006";8;"32.6";195;44548;44353
224;"12.08.2006";9;"35.2";125;48345;48220
224;"12.08.2006";10;45;105;51402;51297
224;"12.08.2006";11;46;117;53102;52985
224;"12.08.2006";12;50;141;54132;53991
224;"12.08.2006";13;"43.5";206;52680;52474
224;"12.08.2006";14;38;265;50127;49862
224;"12.08.2006";15;"37.2";208;48498;48290
224;"12.08.2006";16;35;204;47657;47453
224;"12.08.2006";17;"33.6";165;47102;46937
224;"12.08.2006";18;"33.9";292;47735;47443
224;"12.08.2006";19;"34.2";192;47956;47764
224;"12.08.2006";20;"33.6";234;47307;47073
224;"12.08.2006";21;"35.7";194;45970;45776
224;"12.08.2006";22;"33.7";177;46243;46066
224;"12.08.2006";23;34;258;44474;44216
224;"12.08.2006";24;30;251;40818;40567
225;"13.08.2006";1;"28.5";279;37900;37621
225;"13.08.2006";2;"22.2";280;35696;35416
225;"13.08.2006";3;"19.1";239;34383;34144
225;"13.08.2006";4;"18.1";200;33839;33639
225;"13.08.2006";5;"15.1";204;33939;33735
225;"13.08.2006";6;"15.1";209;34124;33915
225;"13.08.2006";7;"11.1";239;33993;33754
225;"13.08.2006";8;"14.5";249;36101;35852
225;"13.08.2006";9;"22.3";229;39514;39285
225;"13.08.2006";10;29;174;42457;42283
225;"13.08.2006";11;33;97;44877;44780
225;"13.08.2006";12;"36.5";108;47696;47588
225;"13.08.2006";13;"38.2";141;46629;46488
225;"13.08.2006";14;"33.3";239;44571;44332
225;"13.08.2006";15;29;405;42920;42515
225;"13.08.2006";16;"23.5";452;42084;41632
225;"13.08.2006";17;"24.6";482;42151;41669
225;"13.08.2006";18;27;560;43350;42790
225;"13.08.2006";19;"34.3";604;44733;44129
225;"13.08.2006";20;"33.8";705;45203;44498
225;"13.08.2006";21;33;704;45203;44499
225;"13.08.2006";22;"34.5";648;46590;45942
225;"13.08.2006";23;"34.9";840;45110;44270
225;"13.08.2006";24;26;1011;41241;40230
226;"14.08.2006";1;"23.3";1236;38377;37141
226;"14.08.2006";2;"21.3";1639;36874;35235
226;"14.08.2006";3;"13.9";2072;36196;34124
226;"14.08.2006";4;"11.1";2402;36315;33913
226;"14.08.2006";5;15;2750;37546;34796
226;"14.08.2006";6;"23.3";2857;41380;38523
226;"14.08.2006";7;"28.9";3076;48643;45567
226;"14.08.2006";8;39;3139;54808;51669
226;"14.08.2006";9;"49.6";3058;58619;55561
226;"14.08.2006";10;"55.1";3186;59914;56728
226;"14.08.2006";11;"60.1";3577;61694;58117
226;"14.08.2006";12;"63.7";4281;63402;59121
226;"14.08.2006";13;60;4689;62676;57987
226;"14.08.2006";14;"54.9";5042;61838;56796
226;"14.08.2006";15;"59.6";5178;60420;55242
226;"14.08.2006";16;"53.9";5575;59414;53839
226;"14.08.2006";17;"44.9";5609;58100;52491
226;"14.08.2006";18;41;5287;58209;52922
226;"14.08.2006";19;"40.1";5134;58120;52986
226;"14.08.2006";20;"37.8";5158;57767;52609
226;"14.08.2006";21;"38.7";5042;56065;51023
226;"14.08.2006";22;38;5135;54601;49466
226;"14.08.2006";23;"35.3";5313;50839;45526
226;"14.08.2006";24;"30.1";5465;46183;40718
227;"15.08.2006";1;"25.6";5396;42912;37516
227;"15.08.2006";2;"22.8";6070;41183;35113
227;"15.08.2006";3;"20.4";6361;40312;33951
227;"15.08.2006";4;10;6848;40533;33685
227;"15.08.2006";5;"19.9";7112;41201;34089
227;"15.08.2006";6;"23.5";7162;44267;37105
227;"15.08.2006";7;"27.9";7586;50580;42994
227;"15.08.2006";8;38;7478;56218;48740
227;"15.08.2006";9;"50.9";7636;59387;51751
227;"15.08.2006";10;"48.1";8002;60779;52777
227;"15.08.2006";11;"47.4";8323;62285;53962
227;"15.08.2006";12;"56.2";8969;64032;55063
227;"15.08.2006";13;"49.4";9465;62957;53492
227;"15.08.2006";14;"49.9";9841;61588;51747
227;"15.08.2006";15;50;9901;60758;50857
227;"15.08.2006";16;50;9743;59218;49475
227;"15.08.2006";17;"43.3";9127;57747;48620
227;"15.08.2006";18;"43.9";8122;57554;49432
227;"15.08.2006";19;"44.3";6610;57450;50840
227;"15.08.2006";20;"43.2";4676;55864;51188
227;"15.08.2006";21;"43.8";3500;54536;51036
227;"15.08.2006";22;"44.3";3154;54435;51281
227;"15.08.2006";23;"41.3";3118;50986;47868
227;"15.08.2006";24;"31.1";2796;45979;43183
228;"16.08.2006";1;"33.1";2682;42700;40018
228;"16.08.2006";2;"27.9";2556;40854;38298
228;"16.08.2006";3;"27.9";2271;39609;37338
228;"16.08.2006";4;"27.5";1829;39741;37912
228;"16.08.2006";5;"27.8";1619;40630;39011
228;"16.08.2006";6;"37.9";1380;43978;42598
228;"16.08.2006";7;"50.7";1073;50656;49583
228;"16.08.2006";8;"64.6";972;56549;55577
228;"16.08.2006";9;"64.4";547;60071;59524
228;"16.08.2006";10;"68.7";335;61072;60737
228;"16.08.2006";11;"73.3";330;62525;62195
228;"16.08.2006";12;"79.2";340;64301;63961
228;"16.08.2006";13;"73.5";378;63601;63223
228;"16.08.2006";14;"73.8";457;62276;61819
228;"16.08.2006";15;"76.1";586;60995;60409
228;"16.08.2006";16;"73.7";482;59979;59497
228;"16.08.2006";17;"71.5";505;58546;58041
228;"16.08.2006";18;"67.9";572;58144;57572
228;"16.08.2006";19;"60.6";698;57883;57185
228;"16.08.2006";20;"52.6";504;57390;56886
228;"16.08.2006";21;"61.9";620;56020;55400
228;"16.08.2006";22;"56.5";606;55571;54965
228;"16.08.2006";23;"42.1";729;51809;51080
228;"16.08.2006";24;"35.8";641;46598;45957
229;"17.08.2006";1;37;463;43180;42717
229;"17.08.2006";2;"33.2";505;40934;40429
229;"17.08.2006";3;"26.9";493;39885;39392
229;"17.08.2006";4;"23.7";451;39826;39375
229;"17.08.2006";5;"30.3";445;40806;40361
229;"17.08.2006";6;"35.6";452;44175;43723
229;"17.08.2006";7;"44.9";492;51059;50567
229;"17.08.2006";8;"63.2";410;57208;56798
229;"17.08.2006";9;62;343;60366;60023
229;"17.08.2006";10;"64.4";281;61419;61138
229;"17.08.2006";11;"65.7";247;62731;62484
229;"17.08.2006";12;"74.9";250;64522;64272
229;"17.08.2006";13;"66.3";353;63369;63016
229;"17.08.2006";14;"60.6";406;62151;61745
229;"17.08.2006";15;"60.7";456;60822;60366
229;"17.08.2006";16;"57.1";470;59802;59332
229;"17.08.2006";17;"56.5";442;58661;58219
229;"17.08.2006";18;"62.9";380;58571;58191
229;"17.08.2006";19;"60.5";385;58419;58034
229;"17.08.2006";20;"57.3";335;57542;57207
229;"17.08.2006";21;"56.6";364;56384;56020
229;"17.08.2006";22;56;649;55995;55346
229;"17.08.2006";23;"44.3";1129;51984;50855
229;"17.08.2006";24;"36.2";1657;47444;45787
230;"18.08.2006";1;"39.6";1853;43810;41957
230;"18.08.2006";2;"33.1";1957;41886;39929
230;"18.08.2006";3;"27.9";2162;40837;38675
230;"18.08.2006";4;"24.3";2269;40696;38427
230;"18.08.2006";5;"26.9";2199;41342;39143
230;"18.08.2006";6;"33.5";2345;45045;42700
230;"18.08.2006";7;"43.5";2390;51984;49594
230;"18.08.2006";8;"59.9";1851;58027;56176
230;"18.08.2006";9;"65.8";1350;61307;59957
230;"18.08.2006";10;"70.1";1248;62595;61347
230;"18.08.2006";11;"70.3";1400;64009;62609
230;"18.08.2006";12;"76.9";1762;65331;63569
230;"18.08.2006";13;77;2056;63821;61765
230;"18.08.2006";14;"74.5";2451;61629;59178
230;"18.08.2006";15;"62.5";3034;59621;56587
230;"18.08.2006";16;"53.2";3336;58203;54867
230;"18.08.2006";17;"53.2";3433;57322;53889
230;"18.08.2006";18;"53.1";3582;57377;53795
230;"18.08.2006";19;"53.1";3228;57005;53777
230;"18.08.2006";20;"51.7";2386;55556;53170
230;"18.08.2006";21;"51.4";2011;53929;51918
230;"18.08.2006";22;"47.9";2247;53880;51633
230;"18.08.2006";23;"41.6";2397;50582;48185
230;"18.08.2006";24;"33.1";2865;46308;43443
231;"19.08.2006";1;"35.8";2992;43369;40377
231;"19.08.2006";2;"25.2";2909;41094;38185
231;"19.08.2006";3;"23.9";2843;39911;37068
231;"19.08.2006";4;25;2688;39197;36509
231;"19.08.2006";5;"24.2";2663;38911;36248
231;"19.08.2006";6;"23.9";2603;39597;36994
231;"19.08.2006";7;"22.6";2311;41007;38696
231;"19.08.2006";8;"28.5";1806;44291;42485
231;"19.08.2006";9;"34.4";1097;48314;47217
231;"19.08.2006";10;40;694;51174;50480
231;"19.08.2006";11;"48.2";631;52771;52140
231;"19.08.2006";12;"55.9";943;53618;52675
231;"19.08.2006";13;"52.1";1120;52063;50943
231;"19.08.2006";14;"48.1";1256;49649;48393
231;"19.08.2006";15;38;1159;47963;46804
231;"19.08.2006";16;"37.7";1045;47169;46124
231;"19.08.2006";17;"35.4";912;46947;46035
231;"19.08.2006";18;"39.2";894;47898;47004
231;"19.08.2006";19;"41.9";1034;48645;47611
231;"19.08.2006";20;"40.6";941;47978;47037
231;"19.08.2006";21;"42.1";978;47356;46378
231;"19.08.2006";22;"45.1";1217;47220;46003
231;"19.08.2006";23;"39.9";1422;45206;43784
231;"19.08.2006";24;"25.9";1443;41772;40329
232;"20.08.2006";1;"27.5";1692;39218;37526
232;"20.08.2006";2;"22.9";1679;37191;35512
232;"20.08.2006";3;"21.1";2028;35984;33956
232;"20.08.2006";4;"18.5";1938;35293;33355
232;"20.08.2006";5;"15.8";2161;35260;33099
232;"20.08.2006";6;"15.7";2402;35274;32872
232;"20.08.2006";7;"7.5";2434;35157;32723
232;"20.08.2006";8;"13.4";2195;37274;35079
232;"20.08.2006";9;"24.7";2214;41102;38888
232;"20.08.2006";10;"29.6";2868;43719;40851
232;"20.08.2006";11;"35.4";3460;46245;42785
232;"20.08.2006";12;"39.8";4059;49018;44959
232;"20.08.2006";13;"32.5";4589;48053;43464
232;"20.08.2006";14;"29.8";4852;45825;40973
232;"20.08.2006";15;"29.5";5062;44164;39102
232;"20.08.2006";16;"27.2";5037;43386;38349
232;"20.08.2006";17;"27.8";5135;43488;38353
232;"20.08.2006";18;"29.9";5079;44806;39727
232;"20.08.2006";19;"37.8";4588;46561;41973
232;"20.08.2006";20;"38.9";3733;47222;43489
232;"20.08.2006";21;40;3556;47828;44272
232;"20.08.2006";22;"41.7";3636;48654;45018
232;"20.08.2006";23;"39.9";3874;46811;42937
232;"20.08.2006";24;"27.8";4223;43178;38955
233;"21.08.2006";1;"23.2";4157;40327;36170
233;"21.08.2006";2;20;4161;38537;34376
233;"21.08.2006";3;"12.1";4140;37918;33778
233;"21.08.2006";4;"11.9";3967;38120;34153
233;"21.08.2006";5;"16.6";3861;39583;35722
233;"21.08.2006";6;"25.5";3734;43772;40038
233;"21.08.2006";7;36;3888;51782;47894
233;"21.08.2006";8;"55.9";3788;57884;54096
233;"21.08.2006";9;"63.1";4204;61623;57419
233;"21.08.2006";10;65;4663;63023;58360
233;"21.08.2006";11;"65.3";4812;64647;59835
233;"21.08.2006";12;"72.6";4788;66388;61600
233;"21.08.2006";13;"67.1";5074;65115;60041
233;"21.08.2006";14;"66.1";5000;64336;59336
233;"21.08.2006";15;"64.6";5257;63167;57910
233;"21.08.2006";16;"61.3";5143;62045;56902
233;"21.08.2006";17;57;4979;60463;55484
233;"21.08.2006";18;"55.1";4461;59775;55314
233;"21.08.2006";19;"52.9";3458;59619;56161
233;"21.08.2006";20;"51.8";3017;59031;56014
233;"21.08.2006";21;54;2746;58288;55542
233;"21.08.2006";22;49;2543;56877;54334
233;"21.08.2006";23;"37.1";2685;52637;49952
233;"21.08.2006";24;29;2465;47605;45140
234;"22.08.2006";1;37;2428;44309;41881
234;"22.08.2006";2;"32.1";2085;42267;40182
234;"22.08.2006";3;"27.9";1914;41171;39257
234;"22.08.2006";4;"27.8";1820;41441;39621
234;"22.08.2006";5;26;1788;42523;40735
234;"22.08.2006";6;"35.1";1785;46083;44298
234;"22.08.2006";7;"43.1";2080;53158;51078
234;"22.08.2006";8;70;2284;58968;56684
234;"22.08.2006";9;"67.9";2268;62406;60138
234;"22.08.2006";10;"64.3";2613;63812;61199
234;"22.08.2006";11;"74.6";3033;65419;62386
234;"22.08.2006";12;"79.2";3440;66744;63304
234;"22.08.2006";13;"73.4";4051;65499;61448
234;"22.08.2006";14;"68.1";4585;64449;59864
234;"22.08.2006";15;"64.4";4979;63199;58220
234;"22.08.2006";16;"61.7";5322;61958;56636
234;"22.08.2006";17;"49.4";5426;60279;54853
234;"22.08.2006";18;"47.6";5143;60403;55260
234;"22.08.2006";19;"46.5";4569;59786;55217
234;"22.08.2006";20;"45.1";4004;59092;55088
234;"22.08.2006";21;"54.9";3722;58639;54917
234;"22.08.2006";22;55;3640;57322;53682
234;"22.08.2006";23;"43.4";3800;53206;49406
234;"22.08.2006";24;"34.2";3732;48178;44446
235;"23.08.2006";1;37;3522;44808;41286
235;"23.08.2006";2;"34.4";3409;42773;39364
235;"23.08.2006";3;"29.3";3104;41633;38529
235;"23.08.2006";4;"27.1";2995;41572;38577
235;"23.08.2006";5;"27.5";3010;42782;39772
235;"23.08.2006";6;37;2759;46403;43644
235;"23.08.2006";7;"45.1";2593;53203;50610
235;"23.08.2006";8;"55.1";2597;58836;56239
235;"23.08.2006";9;"59.8";2543;61973;59430
235;"23.08.2006";10;64;2493;62439;59946
235;"23.08.2006";11;"60.2";2473;63649;61176
235;"23.08.2006";12;"74.6";2807;65112;62305
235;"23.08.2006";13;"64.3";2751;63999;61248
235;"23.08.2006";14;"75.8";2540;63070;60530
235;"23.08.2006";15;76;2354;62070;59716
235;"23.08.2006";16;"67.2";2013;61108;59095
235;"23.08.2006";17;"65.4";1766;59360;57594
235;"23.08.2006";18;"64.3";1407;59120;57713
235;"23.08.2006";19;"65.8";983;58761;57778
235;"23.08.2006";20;"61.3";667;58186;57519
235;"23.08.2006";21;"61.3";565;58225;57660
235;"23.08.2006";22;"61.5";526;57079;56553
235;"23.08.2006";23;"50.1";508;52695;52187
235;"23.08.2006";24;"41.1";483;47734;47251
236;"24.08.2006";1;"40.1";507;44244;43737
236;"24.08.2006";2;37;539;42292;41753
236;"24.08.2006";3;"33.4";632;41254;40622
236;"24.08.2006";4;"32.6";744;41252;40508
236;"24.08.2006";5;"33.3";757;42087;41330
236;"24.08.2006";6;"41.3";757;45339;44582
236;"24.08.2006";7;"52.4";827;52570;51743
236;"24.08.2006";8;67;876;58404;57528
236;"24.08.2006";9;"63.1";956;61253;60297
236;"24.08.2006";10;"66.1";623;62174;61551
236;"24.08.2006";11;68;550;63837;63287
236;"24.08.2006";12;78;563;65561;64998
236;"24.08.2006";13;"72.3";625;64644;64019
236;"24.08.2006";14;66;1019;63837;62818
236;"24.08.2006";15;65;993;62745;61752
236;"24.08.2006";16;"60.1";1199;61921;60722
236;"24.08.2006";17;60;1355;60852;59497
236;"24.08.2006";18;"53.1";1285;60477;59192
236;"24.08.2006";19;"50.1";1301;60416;59115
236;"24.08.2006";20;"50.1";1086;59392;58306
236;"24.08.2006";21;"60.1";1184;58705;57521
236;"24.08.2006";22;"57.1";1226;56981;55755
236;"24.08.2006";23;"44.8";1338;52745;51407
236;"24.08.2006";24;"38.8";1449;47543;46094
237;"25.08.2006";1;"39.6";1324;44406;43082
237;"25.08.2006";2;"34.7";1150;42529;41379
237;"25.08.2006";3;32;1129;41134;40005
237;"25.08.2006";4;"30.2";1139;41184;40045
237;"25.08.2006";5;"32.1";1005;42470;41465
237;"25.08.2006";6;"35.7";868;46125;45257
237;"25.08.2006";7;"38.6";765;53271;52506
237;"25.08.2006";8;"63.9";722;59266;58544
237;"25.08.2006";9;"59.2";539;62658;62119
237;"25.08.2006";10;68;384;63815;63431
237;"25.08.2006";11;"69.8";383;65127;64744
237;"25.08.2006";12;"78.6";354;66606;66252
237;"25.08.2006";13;"69.9";351;65109;64758
237;"25.08.2006";14;65;355;63229;62874
237;"25.08.2006";15;"63.9";402;61456;61054
237;"25.08.2006";16;"56.1";483;60129;59646
237;"25.08.2006";17;"50.1";533;59292;58759
237;"25.08.2006";18;"47.8";553;59079;58526
237;"25.08.2006";19;"45.7";548;58736;58188
237;"25.08.2006";20;43;473;57901;57428
237;"25.08.2006";21;"50.4";535;57351;56816
237;"25.08.2006";22;"45.8";516;55152;54636
237;"25.08.2006";23;45;612;51518;50906
237;"25.08.2006";24;38;704;47301;46597
238;"26.08.2006";1;"36.6";647;44030;43383
238;"26.08.2006";2;"33.9";718;41816;41098
238;"26.08.2006";3;"33.7";654;40462;39808
238;"26.08.2006";4;"31.5";619;39973;39354
238;"26.08.2006";5;"30.5";605;40239;39634
238;"26.08.2006";6;"35.7";642;41065;40423
238;"26.08.2006";7;"31.5";712;42746;42034
238;"26.08.2006";8;"39.7";706;46122;45416
238;"26.08.2006";9;"48.1";587;50053;49466
238;"26.08.2006";10;64;518;52864;52346
238;"26.08.2006";11;"60.3";564;54548;53984
238;"26.08.2006";12;64;587;55458;54871
238;"26.08.2006";13;"55.4";641;53851;53210
238;"26.08.2006";14;"51.2";689;51438;50749
238;"26.08.2006";15;"53.3";875;49635;48760
238;"26.08.2006";16;"45.1";831;48695;47864
238;"26.08.2006";17;"47.6";1044;48241;47197
238;"26.08.2006";18;"40.1";1065;49202;48137
238;"26.08.2006";19;"45.1";901;49962;49061
238;"26.08.2006";20;"46.8";750;49472;48722
238;"26.08.2006";21;"51.4";689;49509;48820
238;"26.08.2006";22;"43.9";647;48154;47507
238;"26.08.2006";23;"37.2";754;45766;45012
238;"26.08.2006";24;"31.6";886;42526;41640
239;"27.08.2006";1;"34.2";1014;39267;38253
239;"27.08.2006";2;"26.9";1170;37247;36077
239;"27.08.2006";3;"24.3";1264;36134;34870
239;"27.08.2006";4;"21.1";1305;35523;34218
239;"27.08.2006";5;"18.6";1298;35558;34260
239;"27.08.2006";6;21;1474;35764;34290
239;"27.08.2006";7;"14.2";1419;35828;34409
239;"27.08.2006";8;"22.9";1480;37610;36130
239;"27.08.2006";9;"24.6";1513;41115;39602
239;"27.08.2006";10;"30.5";1871;44292;42421
239;"27.08.2006";11;"36.3";2274;47124;44850
239;"27.08.2006";12;45;2856;49780;46924
239;"27.08.2006";13;"44.2";3361;48826;45465
239;"27.08.2006";14;"38.9";3669;46451;42782
239;"27.08.2006";15;"31.7";4238;45183;40945
239;"27.08.2006";16;"27.6";4301;44048;39747
239;"27.08.2006";17;"26.9";3865;43798;39933
239;"27.08.2006";18;"29.4";3639;45059;41420
239;"27.08.2006";19;"33.3";3716;46676;42960
239;"27.08.2006";20;"35.3";3263;47325;44062
239;"27.08.2006";21;"41.7";3421;48755;45334
239;"27.08.2006";22;"42.6";3441;48476;45035
239;"27.08.2006";23;"43.3";3683;46962;43279
239;"27.08.2006";24;"29.9";3998;43118;39120
240;"28.08.2006";1;"30.4";4214;40222;36008
240;"28.08.2006";2;"26.9";4469;38692;34223
240;"28.08.2006";3;"24.2";4577;38241;33664
240;"28.08.2006";4;20;4694;38613;33919
240;"28.08.2006";5;"23.2";4573;40187;35614
240;"28.08.2006";6;"32.1";4216;44164;39948
240;"28.08.2006";7;"48.1";3920;52729;48809
240;"28.08.2006";8;60;3724;59351;55627
240;"28.08.2006";9;67;3334;62603;59269
240;"28.08.2006";10;65;3490;64017;60527
240;"28.08.2006";11;"66.6";3757;65899;62142
240;"28.08.2006";12;"77.7";4041;67811;63770
240;"28.08.2006";13;"72.5";3946;66600;62654
240;"28.08.2006";14;68;3588;65801;62213
240;"28.08.2006";15;"67.9";3193;64733;61540
240;"28.08.2006";16;63;3112;63545;60433
240;"28.08.2006";17;"65.8";2907;61837;58930
240;"28.08.2006";18;65;3031;61652;58621
240;"28.08.2006";19;"56.3";2264;61721;59457
240;"28.08.2006";20;55;2614;60948;58334
240;"28.08.2006";21;55;2995;59994;56999
240;"28.08.2006";22;52;3204;57269;54065
240;"28.08.2006";23;46;3574;52337;48763
240;"28.08.2006";24;"39.6";4181;47393;43212
241;"29.08.2006";1;34;4615;44362;39747
241;"29.08.2006";2;"29.6";4851;42648;37797
241;"29.08.2006";3;"23.6";5080;41537;36457
241;"29.08.2006";4;22;5319;41685;36366
241;"29.08.2006";5;"22.3";5489;43142;37653
241;"29.08.2006";6;"31.4";5152;46898;41746
241;"29.08.2006";7;"37.2";5268;54178;48910
241;"29.08.2006";8;"57.9";5128;60174;55046
241;"29.08.2006";9;66;5168;63517;58349
241;"29.08.2006";10;"66.2";5317;64495;59178
241;"29.08.2006";11;"68.1";5549;66010;60461
241;"29.08.2006";12;"74.1";6205;67293;61088
241;"29.08.2006";13;"66.5";5968;65806;59838
241;"29.08.2006";14;"66.1";5805;64827;59022
241;"29.08.2006";15;"70.2";5382;63906;58524
241;"29.08.2006";16;"70.1";5120;62543;57423
241;"29.08.2006";17;64;4414;61226;56812
241;"29.08.2006";18;58;3718;60613;56895
241;"29.08.2006";19;"58.1";2749;60358;57609
241;"29.08.2006";20;"60.9";2421;60020;57599
241;"29.08.2006";21;"62.9";2471;60050;57579
241;"29.08.2006";22;"57.7";2930;57454;54524
241;"29.08.2006";23;"41.4";3457;52947;49490
241;"29.08.2006";24;"35.9";3718;47994;44276
242;"30.08.2006";1;"34.6";3840;44630;40790
242;"30.08.2006";2;"31.4";3722;42582;38860
242;"30.08.2006";3;"23.5";4013;41643;37630
242;"30.08.2006";4;"23.4";4071;42181;38110
242;"30.08.2006";5;"23.5";4067;43471;39404
242;"30.08.2006";6;"33.6";3885;47273;43388
242;"30.08.2006";7;"37.1";3969;54738;50769
242;"30.08.2006";8;"61.8";4095;60587;56492
242;"30.08.2006";9;70;4052;63518;59466
242;"30.08.2006";10;"74.8";4387;64490;60103
242;"30.08.2006";11;"66.5";5444;66071;60627
242;"30.08.2006";12;"81.9";6483;67848;61365
242;"30.08.2006";13;70;7084;66677;59593
242;"30.08.2006";14;"74.3";7487;65725;58238
242;"30.08.2006";15;"67.1";7610;64767;57157
242;"30.08.2006";16;"61.3";7926;63649;55723
242;"30.08.2006";17;"53.6";8008;62148;54140
242;"30.08.2006";18;"54.2";7842;61563;53721
242;"30.08.2006";19;55;7384;61500;54116
242;"30.08.2006";20;"55.1";6722;61179;54457
242;"30.08.2006";21;"53.1";6121;61297;55176
242;"30.08.2006";22;"51.6";6360;58650;52290
242;"30.08.2006";23;"39.9";6497;54471;47974
242;"30.08.2006";24;"33.5";6799;49567;42768
243;"31.08.2006";1;"30.6";6795;45994;39199
243;"31.08.2006";2;24;6411;44306;37895
243;"31.08.2006";3;"22.9";6038;43021;36983
243;"31.08.2006";4;"21.4";5927;42862;36935
243;"31.08.2006";5;"22.6";5673;43974;38301
243;"31.08.2006";6;"35.5";5598;47604;42006
243;"31.08.2006";7;"37.4";5429;55193;49764
243;"31.08.2006";8;"54.6";4857;60516;55659
243;"31.08.2006";9;54;4161;63030;58869
243;"31.08.2006";10;55;3908;63425;59517
243;"31.08.2006";11;"61.4";4192;64459;60267
243;"31.08.2006";12;"63.2";4514;65701;61187
243;"31.08.2006";13;"61.7";4656;64593;59937
243;"31.08.2006";14;58;5090;63775;58685
243;"31.08.2006";15;"61.3";5298;62601;57303
243;"31.08.2006";16;"61.2";5307;61571;56264
243;"31.08.2006";17;"55.1";5080;59742;54662
243;"31.08.2006";18;55;4447;59787;55340
243;"31.08.2006";19;"52.1";3956;59704;55748
243;"31.08.2006";20;"49.9";3575;59803;56228
243;"31.08.2006";21;"57.3";4054;60301;56247
243;"31.08.2006";22;"51.1";4637;57746;53109
243;"31.08.2006";23;"42.1";4895;53342;48447
243;"31.08.2006";24;"35.3";4963;48208;43245
244;"01.09.2006";1;"24.1";4866;43003;38137
244;"01.09.2006";2;"22.6";4861;43802;38941
244;"01.09.2006";3;"21.3";4782;42710;37928
244;"01.09.2006";4;"13.6";4677;42765;38088
244;"01.09.2006";5;"16.6";4356;43985;39629
244;"01.09.2006";6;"25.6";4083;47417;43334
244;"01.09.2006";7;"33.4";3932;55392;51460
244;"01.09.2006";8;"47.6";3838;60868;57030
244;"01.09.2006";9;"61.6";3506;63667;60161
244;"01.09.2006";10;"61.1";3274;64101;60827
244;"01.09.2006";11;"64.4";3437;64817;61380
244;"01.09.2006";12;67;3717;65708;61991
244;"01.09.2006";13;61;3755;64593;60838
244;"01.09.2006";14;"60.9";3599;62966;59367
244;"01.09.2006";15;"52.9";3333;61266;57933
244;"01.09.2006";16;"46.3";3149;60482;57333
244;"01.09.2006";17;"43.2";2798;59467;56669
244;"01.09.2006";18;"44.2";2243;59118;56875
244;"01.09.2006";19;"46.2";1859;58744;56885
244;"01.09.2006";20;"41.3";1924;58330;56406
244;"01.09.2006";21;"38.5";2257;58700;56443
244;"01.09.2006";22;"38.4";2506;56204;53698
244;"01.09.2006";23;"37.2";2548;52873;50325
244;"01.09.2006";24;"30.1";2450;48311;45861
245;"02.09.2006";1;"35.9";2544;44735;42191
245;"02.09.2006";2;"28.3";2304;42249;39945
245;"02.09.2006";3;"26.5";2019;40785;38766
245;"02.09.2006";4;"30.1";1749;40032;38283
245;"02.09.2006";5;"23.6";1770;40162;38392
245;"02.09.2006";6;30;1922;41307;39385
245;"02.09.2006";7;"28.6";2009;43310;41301
245;"02.09.2006";8;"35.3";2049;46559;44510
245;"02.09.2006";9;"48.1";1649;50300;48651
245;"02.09.2006";10;"62.4";1074;53076;52002
245;"02.09.2006";11;"61.8";909;54633;53724
245;"02.09.2006";12;"62.2";1204;55457;54253
245;"02.09.2006";13;56;1879;54004;52125
245;"02.09.2006";14;55;2488;51567;49079
245;"02.09.2006";15;"45.1";2790;49734;46944
245;"02.09.2006";16;37;2913;48858;45945
245;"02.09.2006";17;"38.6";2887;48445;45558
245;"02.09.2006";18;"38.8";2463;49514;47051
245;"02.09.2006";19;"37.2";2447;50341;47894
245;"02.09.2006";20;36;2528;50654;48126
245;"02.09.2006";21;"37.1";3069;51497;48428
245;"02.09.2006";22;"32.1";3626;49533;45907
245;"02.09.2006";23;30;4844;47173;42329
245;"02.09.2006";24;"21.4";5545;43439;37894
246;"03.09.2006";1;22;6193;40262;34069
246;"03.09.2006";2;"14.4";6892;38100;31208
246;"03.09.2006";3;"9.1";7452;36567;29115
246;"03.09.2006";4;"7.1";8024;36230;28206
246;"03.09.2006";5;"6.7";8427;36446;28019
246;"03.09.2006";6;"6.1";8747;37254;28507
246;"03.09.2006";7;"6.4";8862;37951;29089
246;"03.09.2006";8;6;8813;39567;30754
246;"03.09.2006";9;"8.9";9107;43351;34244
246;"03.09.2006";10;"20.4";9150;46527;37377
246;"03.09.2006";11;"22.5";9073;49322;40249
246;"03.09.2006";12;"22.4";9428;51993;42565
246;"03.09.2006";13;"22.5";9811;51719;41908
246;"03.09.2006";14;"21.5";9758;49659;39901
246;"03.09.2006";15;"20.3";9794;47771;37977
246;"03.09.2006";16;"18.2";10305;47036;36731
246;"03.09.2006";17;"18.7";10771;46941;36170
246;"03.09.2006";18;"20.9";11948;48361;36413
246;"03.09.2006";19;23;12178;49997;37819
246;"03.09.2006";20;"31.3";12552;50954;38402
246;"03.09.2006";21;"33.5";12408;52830;40422
246;"03.09.2006";22;"24.1";12021;51586;39565
246;"03.09.2006";23;"27.1";11720;49614;37894
246;"03.09.2006";24;"20.9";12165;46009;33844
247;"04.09.2006";1;21;12117;43774;31657
247;"04.09.2006";2;15;12218;42308;30090
247;"04.09.2006";3;"12.4";11982;41658;29676
247;"04.09.2006";4;7;11604;42177;30573
247;"04.09.2006";5;"14.1";10773;43376;32603
247;"04.09.2006";6;21;9668;47511;37843
247;"04.09.2006";7;"31.6";8746;56007;47261
247;"04.09.2006";8;46;8489;61721;53232
247;"04.09.2006";9;51;8219;64943;56724
247;"04.09.2006";10;"55.7";8907;65652;56745
247;"04.09.2006";11;55;9882;67276;57394
247;"04.09.2006";12;63;10508;68793;58285
247;"04.09.2006";13;"56.9";11075;68105;57030
247;"04.09.2006";14;56;11445;67419;55974
247;"04.09.2006";15;"52.7";11544;66203;54659
247;"04.09.2006";16;"50.9";11853;65491;53638
247;"04.09.2006";17;"46.5";11533;64023;52490
247;"04.09.2006";18;"45.9";11296;63282;51986
247;"04.09.2006";19;"48.1";10233;62881;52648
247;"04.09.2006";20;"48.1";8670;62399;53729
247;"04.09.2006";21;"51.1";7605;63090;55485
247;"04.09.2006";22;"41.1";7287;60525;53238
247;"04.09.2006";23;"35.6";7134;55655;48521
247;"04.09.2006";24;"29.2";7137;50391;43254
248;"05.09.2006";1;"33.2";6634;47069;40435
248;"05.09.2006";2;"24.1";6131;44987;38856
248;"05.09.2006";3;"20.3";6078;44008;37930
248;"05.09.2006";4;"20.6";6073;44141;38068
248;"05.09.2006";5;"22.3";5775;45182;39407
248;"05.09.2006";6;"32.5";5548;48968;43420
248;"05.09.2006";7;50;5276;56682;51406
248;"05.09.2006";8;69;5061;62185;57124
248;"05.09.2006";9;67;4766;64964;60198
248;"05.09.2006";10;67;5006;65450;60444
248;"05.09.2006";11;"69.5";5455;67009;61554
248;"05.09.2006";12;70;5609;68394;62785
248;"05.09.2006";13;"70.1";5485;67556;62071
248;"05.09.2006";14;70;5319;66682;61363
248;"05.09.2006";15;"72.3";5257;65628;60371
248;"05.09.2006";16;"70.1";5110;64800;59690
248;"05.09.2006";17;"72.1";4531;63082;58551
248;"05.09.2006";18;"77.1";4056;62535;58479
248;"05.09.2006";19;"74.7";2787;62324;59537
248;"05.09.2006";20;"74.8";1802;61600;59798
248;"05.09.2006";21;"80.8";1481;62887;61406
248;"05.09.2006";22;71;1476;59728;58252
248;"05.09.2006";23;"64.3";1490;55037;53547
248;"05.09.2006";24;"39.4";1557;49719;48162
249;"06.09.2006";1;"36.3";1635;45879;44244
249;"06.09.2006";2;"32.9";1514;43928;42414
249;"06.09.2006";3;"28.4";1513;43007;41494
249;"06.09.2006";4;23;1626;43011;41385
249;"06.09.2006";5;"32.1";1655;44059;42404
249;"06.09.2006";6;"40.4";1619;48268;46649
249;"06.09.2006";7;55;1626;56614;54988
249;"06.09.2006";8;"75.1";1610;62406;60796
249;"06.09.2006";9;"74.6";1350;65053;63703
249;"06.09.2006";10;"76.3";1092;65736;64644
249;"06.09.2006";11;"78.2";977;66882;65905
249;"06.09.2006";12;"78.6";1147;68306;67159
249;"06.09.2006";13;"78.6";1518;67000;65482
249;"06.09.2006";14;80;1945;65964;64019
249;"06.09.2006";15;75;1970;64770;62800
249;"06.09.2006";16;70;1897;63781;61884
249;"06.09.2006";17;68;1934;62638;60704
249;"06.09.2006";18;"66.2";1771;62433;60662
249;"06.09.2006";19;"65.6";1372;61908;60536
249;"06.09.2006";20;64;1139;61699;60560
249;"06.09.2006";21;"66.2";1332;63248;61916
249;"06.09.2006";22;66;1528;60245;58717
249;"06.09.2006";23;"45.1";1634;55563;53929
249;"06.09.2006";24;"35.9";1720;50271;48551
250;"07.09.2006";1;"36.5";1643;46656;45013
250;"07.09.2006";2;"33.4";1443;44762;43319
250;"07.09.2006";3;"31.3";1366;43600;42234
250;"07.09.2006";4;"23.8";1251;43509;42258
250;"07.09.2006";5;"25.9";1215;44501;43286
250;"07.09.2006";6;"36.5";1075;47915;46840
250;"07.09.2006";7;"51.3";1199;56274;55075
250;"07.09.2006";8;"65.1";1297;62072;60775
250;"07.09.2006";9;68;1160;64764;63604
250;"07.09.2006";10;67;1063;65682;64619
250;"07.09.2006";11;"69.8";1250;66993;65743
250;"07.09.2006";12;"83.2";2076;68627;66551
250;"07.09.2006";13;"67.1";3304;67529;64225
250;"07.09.2006";14;"66.1";4300;67024;62724
250;"07.09.2006";15;65;4875;65850;60975
250;"07.09.2006";16;61;5389;65173;59784
250;"07.09.2006";17;"60.1";6090;63884;57794
250;"07.09.2006";18;"60.1";7329;63444;56115
250;"07.09.2006";19;"59.1";7912;63205;55293
250;"07.09.2006";20;"58.2";7039;62943;55904
250;"07.09.2006";21;"61.7";6390;63316;56926
250;"07.09.2006";22;"49.1";6068;59572;53504
250;"07.09.2006";23;"39.9";6468;55150;48682
250;"07.09.2006";24;"34.6";7028;50151;43123
251;"08.09.2006";1;"32.4";7203;47093;39890
251;"08.09.2006";2;"28.1";7265;45129;37864
251;"08.09.2006";3;"23.9";7424;44075;36651
251;"08.09.2006";4;20;7015;44120;37105
251;"08.09.2006";5;"10.4";7242;45410;38168
251;"08.09.2006";6;"31.2";7035;48918;41883
251;"08.09.2006";7;"41.6";6672;56608;49936
251;"08.09.2006";8;"65.4";6291;62106;55815
251;"08.09.2006";9;"70.1";5944;64894;58950
251;"08.09.2006";10;"69.3";6136;65323;59187
251;"08.09.2006";11;"72.1";6863;66570;59707
251;"08.09.2006";12;"74.8";6849;67571;60722
251;"08.09.2006";13;"70.5";6474;66092;59618
251;"08.09.2006";14;"69.9";6547;64392;57845
251;"08.09.2006";15;"64.1";6487;62483;55996
251;"08.09.2006";16;65;6440;61214;54774
251;"08.09.2006";17;"58.5";6188;60137;53949
251;"08.09.2006";18;"58.4";5564;59992;54428
251;"08.09.2006";19;"61.4";4712;59625;54913
251;"08.09.2006";20;"66.4";3624;59057;55433
251;"08.09.2006";21;"69.1";2899;60024;57125
251;"08.09.2006";22;"62.5";2916;56898;53982
251;"08.09.2006";23;"53.4";2848;52663;49815
251;"08.09.2006";24;38;2719;48577;45858
252;"09.09.2006";1;"35.1";2388;45319;42931
252;"09.09.2006";2;"30.1";2009;42993;40984
252;"09.09.2006";3;"23.3";1665;41375;39710
252;"09.09.2006";4;"19.9";1488;40907;39419
252;"09.09.2006";5;"17.1";1468;41100;39632
252;"09.09.2006";6;"16.2";1418;42060;40642
252;"09.09.2006";7;"22.5";1310;44173;42863
252;"09.09.2006";8;"26.1";1151;46905;45754
252;"09.09.2006";9;"32.9";854;50815;49961
252;"09.09.2006";10;40;584;53261;52677
252;"09.09.2006";11;"44.3";656;54609;53953
252;"09.09.2006";12;"47.9";940;55458;54518
252;"09.09.2006";13;"46.5";865;53722;52857
252;"09.09.2006";14;44;767;50977;50210
252;"09.09.2006";15;"42.7";754;49070;48316
252;"09.09.2006";16;"40.1";817;48105;47288
252;"09.09.2006";17;"38.8";815;47715;46900
252;"09.09.2006";18;"38.8";924;48591;47667
252;"09.09.2006";19;"41.9";959;49163;48204
252;"09.09.2006";20;"47.9";1034;49768;48734
252;"09.09.2006";21;"56.7";1416;51303;49887
252;"09.09.2006";22;45;1640;48954;47314
252;"09.09.2006";23;41;1689;46327;44638
252;"09.09.2006";24;"32.7";1946;43104;41158
253;"10.09.2006";1;27;2240;40103;37863
253;"10.09.2006";2;"20.4";2307;38009;35702
253;"10.09.2006";3;"8.7";2202;37020;34818
253;"10.09.2006";4;8;2222;36403;34181
253;"10.09.2006";5;"6.9";2113;36496;34383
253;"10.09.2006";6;"6.9";1795;36776;34981
253;"10.09.2006";7;"7.5";1727;37180;35453
253;"10.09.2006";8;"7.1";1717;38447;36730
253;"10.09.2006";9;16;1435;41950;40515
253;"10.09.2006";10;"23.7";1019;44913;43894
253;"10.09.2006";11;"33.3";940;46858;45918
253;"10.09.2006";12;39;912;48897;47985
253;"10.09.2006";13;39;994;48121;47127
253;"10.09.2006";14;"30.5";1130;45867;44737
253;"10.09.2006";15;25;1304;44049;42745
253;"10.09.2006";16;"21.5";1380;43316;41936
253;"10.09.2006";17;"21.1";1458;43173;41715
253;"10.09.2006";18;"25.9";1495;44859;43364
253;"10.09.2006";19;"33.5";1399;46731;45332
253;"10.09.2006";20;"35.8";1778;48404;46626
253;"10.09.2006";21;"45.1";2892;51848;48956
253;"10.09.2006";22;"42.1";3498;50342;46844
253;"10.09.2006";23;"41.4";3530;48415;44885
253;"10.09.2006";24;"29.5";3271;44711;41440
254;"11.09.2006";1;"21.5";3131;42030;38899
254;"11.09.2006";2;19;2841;40479;37638
254;"11.09.2006";3;14;2452;39467;37015
254;"11.09.2006";4;"10.7";2274;39509;37235
254;"11.09.2006";5;"19.6";2278;40901;38623
254;"11.09.2006";6;"26.8";2175;45329;43154
254;"11.09.2006";7;"48.7";2085;55029;52944
254;"11.09.2006";8;"66.7";2104;61035;58931
254;"11.09.2006";9;70;1694;64498;62804
254;"11.09.2006";10;"68.2";933;64931;63998
254;"11.09.2006";11;70;872;65999;65127
254;"11.09.2006";12;"78.8";1048;67622;66574
254;"11.09.2006";13;"71.4";1466;66879;65413
254;"11.09.2006";14;"70.8";1556;66331;64775
254;"11.09.2006";15;70;1405;65296;63891
254;"11.09.2006";16;68;1314;64366;63052
254;"11.09.2006";17;"66.9";1261;63021;61760
254;"11.09.2006";18;66;1204;62821;61617
254;"11.09.2006";19;"65.5";1168;62533;61365
254;"11.09.2006";20;66;1645;62866;61221
254;"11.09.2006";21;"66.4";2687;64179;61492
254;"11.09.2006";22;59;3425;60309;56884
254;"11.09.2006";23;"41.6";3518;55309;51791
254;"11.09.2006";24;"33.3";3439;49960;46521
255;"12.09.2006";1;"37.6";3165;46395;43230
255;"12.09.2006";2;"35.8";2965;44658;41693
255;"12.09.2006";3;"32.8";2773;43580;40807
255;"12.09.2006";4;"24.2";2584;43567;40983
255;"12.09.2006";5;"29.2";2403;44187;41784
255;"12.09.2006";6;"38.1";2201;48304;46103
255;"12.09.2006";7;"47.6";2149;56861;54712
255;"12.09.2006";8;68;2100;62245;60145
255;"12.09.2006";9;"69.9";1631;64873;63242
255;"12.09.2006";10;"69.1";897;64995;64098
255;"12.09.2006";11;"71.1";633;66054;65421
255;"12.09.2006";12;85;752;67451;66699
255;"12.09.2006";13;"75.1";1072;66634;65562
255;"12.09.2006";14;"78.6";1168;66007;64839
255;"12.09.2006";15;76;1090;64960;63870
255;"12.09.2006";16;"69.1";1047;64284;63237
255;"12.09.2006";17;67;1013;63181;62168
255;"12.09.2006";18;"66.2";952;62895;61943
255;"12.09.2006";19;"64.1";994;62446;61452
255;"12.09.2006";20;"64.1";1543;62743;61200
255;"12.09.2006";21;"72.5";2596;64107;61511
255;"12.09.2006";22;"63.4";3087;59980;56893
255;"12.09.2006";23;"42.9";3162;54961;51799
255;"12.09.2006";24;"35.4";3153;50025;46872
256;"13.09.2006";1;35;3025;46880;43855
256;"13.09.2006";2;29;2942;45083;42141
256;"13.09.2006";3;"22.6";2845;43878;41033
256;"13.09.2006";4;"22.5";2547;44018;41471
256;"13.09.2006";5;"24.9";2392;44805;42413
256;"13.09.2006";6;36;2329;48879;46550
256;"13.09.2006";7;"41.3";2199;57384;55185
256;"13.09.2006";8;"60.1";2140;62666;60526
256;"13.09.2006";9;"59.7";1735;65071;63336
256;"13.09.2006";10;"59.6";1050;65357;64307
256;"13.09.2006";11;"61.7";669;66114;65445
256;"13.09.2006";12;"66.7";766;67567;66801
256;"13.09.2006";13;63;991;66761;65770
256;"13.09.2006";14;"64.6";1171;65854;64683
256;"13.09.2006";15;"64.1";1194;64639;63445
256;"13.09.2006";16;"65.4";1252;64046;62794
256;"13.09.2006";17;"64.1";1225;62831;61606
256;"13.09.2006";18;"62.9";1172;62414;61242
256;"13.09.2006";19;"59.7";1072;62359;61287
256;"13.09.2006";20;"59.6";1467;62996;61529
256;"13.09.2006";21;"65.1";2246;64153;61907
256;"13.09.2006";22;"59.5";2892;59991;57099
256;"13.09.2006";23;40;3180;55264;52084
256;"13.09.2006";24;"33.3";3050;49947;46897
257;"14.09.2006";1;"35.8";2827;46633;43806
257;"14.09.2006";2;"33.9";2569;44694;42125
257;"14.09.2006";3;"32.6";2285;43544;41259
257;"14.09.2006";4;"23.5";2089;43691;41602
257;"14.09.2006";5;"28.6";1881;44632;42751
257;"14.09.2006";6;"35.1";1971;48119;46148
257;"14.09.2006";7;"59.8";1993;57227;55234
257;"14.09.2006";8;"78.9";2013;62117;60104
257;"14.09.2006";9;85;1658;64732;63074
257;"14.09.2006";10;"75.5";1073;65314;64241
257;"14.09.2006";11;75;844;66842;65998
257;"14.09.2006";12;"83.6";906;67810;66904
257;"14.09.2006";13;"74.8";1460;66822;65362
257;"14.09.2006";14;"74.9";1754;66031;64277
257;"14.09.2006";15;"72.5";1866;65185;63319
257;"14.09.2006";16;"70.3";1955;64464;62509
257;"14.09.2006";17;"71.2";2092;63097;61005
257;"14.09.2006";18;"70.2";2161;62936;60775
257;"14.09.2006";19;"68.4";2144;62558;60414
257;"14.09.2006";20;"71.7";2935;63583;60648
257;"14.09.2006";21;75;4226;64405;60179
257;"14.09.2006";22;"65.3";4806;59968;55162
257;"14.09.2006";23;"48.4";4624;54977;50353
257;"14.09.2006";24;33;4488;50281;45793
258;"15.09.2006";1;"32.7";4240;46774;42534
258;"15.09.2006";2;"25.9";4145;44978;40833
258;"15.09.2006";3;"22.6";3980;43963;39983
258;"15.09.2006";4;"22.3";4004;43859;39855
258;"15.09.2006";5;"22.5";4129;44696;40567
258;"15.09.2006";6;"32.2";4238;47924;43686
258;"15.09.2006";7;"37.9";4461;56701;52240
258;"15.09.2006";8;62;4473;62093;57620
258;"15.09.2006";9;62;4300;64719;60419
258;"15.09.2006";10;"57.5";3664;65149;61485
258;"15.09.2006";11;"59.2";4307;66447;62140
258;"15.09.2006";12;58;6129;68246;62117
258;"15.09.2006";13;51;7651;67509;59858
258;"15.09.2006";14;46;8953;66638;57685
258;"15.09.2006";15;"43.4";9773;65418;55645
258;"15.09.2006";16;"39.2";9725;64406;54681
258;"15.09.2006";17;40;9594;63380;53786
258;"15.09.2006";18;"35.7";8617;62977;54360
258;"15.09.2006";19;"36.9";7158;62172;55014
258;"15.09.2006";20;"37.1";6794;62806;56012
258;"15.09.2006";21;46;7564;62849;55285
258;"15.09.2006";22;34;7837;58538;50701
258;"15.09.2006";23;"29.4";7496;54808;47312
258;"15.09.2006";24;"24.2";7070;50633;43563
259;"16.09.2006";1;"30.2";6599;46907;40308
259;"16.09.2006";2;27;6095;44666;38571
259;"16.09.2006";3;"23.2";5714;43463;37749
259;"16.09.2006";4;"21.4";5505;42878;37373
259;"16.09.2006";5;"23.2";5471;42865;37394
259;"16.09.2006";6;"29.9";5128;43667;38539
259;"16.09.2006";7;"30.5";4947;46346;41399
259;"16.09.2006";8;"39.2";4720;48912;44192
259;"16.09.2006";9;"46.6";4479;52950;48471
259;"16.09.2006";10;"53.8";4178;55710;51532
259;"16.09.2006";11;"52.6";4346;57077;52731
259;"16.09.2006";12;"53.5";4509;57672;53163
259;"16.09.2006";13;"49.9";4775;56421;51646
259;"16.09.2006";14;"42.4";5241;54210;48969
259;"16.09.2006";15;"35.6";5458;52416;46958
259;"16.09.2006";16;"34.1";5388;51461;46073
259;"16.09.2006";17;"30.6";5170;50817;45647
259;"16.09.2006";18;"30.6";4447;51386;46939
259;"16.09.2006";19;37;3526;51752;48226
259;"16.09.2006";20;40;3317;52972;49655
259;"16.09.2006";21;37;3643;53526;49883
259;"16.09.2006";22;"30.3";3545;50151;46606
259;"16.09.2006";23;"30.5";3534;47826;44292
259;"16.09.2006";24;"22.5";3456;44393;40937
260;"17.09.2006";1;"27.1";3073;41159;38086
260;"17.09.2006";2;"21.1";2776;38846;36070
260;"17.09.2006";3;14;2405;37704;35299
260;"17.09.2006";4;"12.7";2051;36982;34931
260;"17.09.2006";5;10;2021;36789;34768
260;"17.09.2006";6;12;1904;37299;35395
260;"17.09.2006";7;"9.7";1785;38492;36707
260;"17.09.2006";8;20;1670;39621;37951
260;"17.09.2006";9;23;1488;42843;41355
260;"17.09.2006";10;"26.8";1285;45891;44606
260;"17.09.2006";11;"35.6";1044;47983;46939
260;"17.09.2006";12;"41.4";973;50102;49129
260;"17.09.2006";13;"39.6";1231;49178;47947
260;"17.09.2006";14;33;1283;46811;45528
260;"17.09.2006";15;"24.6";1303;45073;43770
260;"17.09.2006";16;"23.4";1248;44364;43116
260;"17.09.2006";17;"23.4";1194;44365;43171
260;"17.09.2006";18;"31.5";1138;45879;44741
260;"17.09.2006";19;37;1083;48155;47072
260;"17.09.2006";20;47;1160;50914;49754
260;"17.09.2006";21;"50.1";1344;52314;50970
260;"17.09.2006";22;"39.9";1451;49680;48229
260;"17.09.2006";23;38;1370;47639;46269
260;"17.09.2006";24;35;1272;44185;42913
261;"18.09.2006";1;"21.4";1288;41658;40370
261;"18.09.2006";2;"19.6";1313;40432;39119
261;"18.09.2006";3;"17.3";1149;39469;38320
261;"18.09.2006";4;"16.5";1094;39560;38466
261;"18.09.2006";5;"16.6";973;40880;39907
261;"18.09.2006";6;"28.5";843;45013;44170
261;"18.09.2006";7;44;691;55867;55176
261;"18.09.2006";8;"63.1";691;62809;62118
261;"18.09.2006";9;"69.4";523;65868;65345
261;"18.09.2006";10;68;376;66409;66033
261;"18.09.2006";11;"69.6";371;67786;67415
261;"18.09.2006";12;70;367;69382;69015
261;"18.09.2006";13;"68.2";490;68486;67996
261;"18.09.2006";14;"67.9";568;67409;66841
261;"18.09.2006";15;66;525;66070;65545
261;"18.09.2006";16;"63.7";427;64954;64527
261;"18.09.2006";17;"63.8";462;63383;62921
261;"18.09.2006";18;"63.5";575;63317;62742
261;"18.09.2006";19;"62.8";697;63542;62845
261;"18.09.2006";20;63;792;64739;63947
261;"18.09.2006";21;"67.3";967;63649;62682
261;"18.09.2006";22;56;988;59120;58132
261;"18.09.2006";23;38;1112;54115;53003
261;"18.09.2006";24;"33.9";1238;48930;47692
262;"19.09.2006";1;"39.6";1315;45844;44529
262;"19.09.2006";2;"34.6";1330;44262;42932
262;"19.09.2006";3;"28.1";1452;43169;41717
262;"19.09.2006";4;"25.4";1596;43365;41769
262;"19.09.2006";5;"29.4";1618;44373;42755
262;"19.09.2006";6;"35.6";1634;48020;46386
262;"19.09.2006";7;"48.1";1664;57751;56087
262;"19.09.2006";8;"75.9";1794;63718;61924
262;"19.09.2006";9;"68.2";2000;65987;63987
262;"19.09.2006";10;"63.8";1916;66120;64204
262;"19.09.2006";11;64;2407;67486;65079
262;"19.09.2006";12;68;2910;68925;66015
262;"19.09.2006";13;"63.8";3571;67988;64417
262;"19.09.2006";14;"63.5";3733;67063;63330
262;"19.09.2006";15;"58.6";3643;65995;62352
262;"19.09.2006";16;"56.9";3362;64876;61514
262;"19.09.2006";17;"50.1";3208;63400;60192
262;"19.09.2006";18;"46.1";2850;63048;60198
262;"19.09.2006";19;"49.3";2282;63037;60755
262;"19.09.2006";20;"59.9";2192;64810;62618
262;"19.09.2006";21;"67.9";2432;64387;61955
262;"19.09.2006";22;"48.9";2417;59334;56917
262;"19.09.2006";23;"40.5";2507;54001;51494
262;"19.09.2006";24;36;2559;48756;46197
263;"20.09.2006";1;"30.9";2244;45299;43055
263;"20.09.2006";2;"29.4";2043;43571;41528
263;"20.09.2006";3;"22.6";2123;42761;40638
263;"20.09.2006";4;"21.1";2070;42938;40868
263;"20.09.2006";5;"22.6";2047;44070;42023
263;"20.09.2006";6;"32.2";2111;47960;45849
263;"20.09.2006";7;"41.1";2210;57694;55484
263;"20.09.2006";8;66;2145;63135;60990
263;"20.09.2006";9;"64.3";1750;65330;63580
263;"20.09.2006";10;"64.6";1091;65099;64008
263;"20.09.2006";11;"67.2";1030;65703;64673
263;"20.09.2006";12;"68.2";1474;67142;65668
263;"20.09.2006";13;68;1913;66286;64373
263;"20.09.2006";14;"69.9";2222;65843;63621
263;"20.09.2006";15;71;2006;64460;62454
263;"20.09.2006";16;"70.3";1754;63243;61489
263;"20.09.2006";17;"63.6";1476;61661;60185
263;"20.09.2006";18;"63.6";1113;61439;60326
263;"20.09.2006";19;"64.1";720;61605;60885
263;"20.09.2006";20;"71.3";714;63579;62865
263;"20.09.2006";21;"72.8";1037;64444;63407
263;"20.09.2006";22;"68.2";1425;59582;58157
263;"20.09.2006";23;"58.6";1927;54134;52207
263;"20.09.2006";24;38;2269;48917;46648
264;"21.09.2006";1;"33.3";2520;45629;43109
264;"21.09.2006";2;"33.5";2632;43678;41046
264;"21.09.2006";3;"27.9";2603;42648;40045
264;"21.09.2006";4;"22.5";2662;42979;40317
264;"21.09.2006";5;"23.3";2641;44140;41499
264;"21.09.2006";6;"32.9";2641;47728;45087
264;"21.09.2006";7;"48.2";2628;57214;54586
264;"21.09.2006";8;68;2611;62383;59772
264;"21.09.2006";9;"61.3";2400;64451;62051
264;"21.09.2006";10;"67.9";1468;64545;63077
264;"21.09.2006";11;64;927;65294;64367
264;"21.09.2006";12;"67.9";1218;66825;65607
264;"21.09.2006";13;"63.5";1762;65844;64082
264;"21.09.2006";14;"66.8";2375;65237;62862
264;"21.09.2006";15;"63.9";2754;64002;61248
264;"21.09.2006";16;60;2986;63223;60237
264;"21.09.2006";17;59;3207;61887;58680
264;"21.09.2006";18;"61.3";3205;61899;58694
264;"21.09.2006";19;"63.9";2980;61828;58848
264;"21.09.2006";20;"63.9";3904;63935;60031
264;"21.09.2006";21;"66.3";5346;64664;59318
264;"21.09.2006";22;45;6173;59827;53654
264;"21.09.2006";23;"37.5";5985;54816;48831
264;"21.09.2006";24;"32.5";5949;49872;43923
265;"22.09.2006";1;"32.2";5754;46324;40570
265;"22.09.2006";2;24;5502;44238;38736
265;"22.09.2006";3;"22.5";5096;43016;37920
265;"22.09.2006";4;"11.9";4826;43099;38273
265;"22.09.2006";5;"22.3";4761;44120;39359
265;"22.09.2006";6;"29.1";4765;48150;43385
265;"22.09.2006";7;"39.4";4817;57811;52994
265;"22.09.2006";8;"64.6";4576;63111;58535
265;"22.09.2006";9;"65.2";3961;65286;61325
265;"22.09.2006";10;"61.3";2916;65322;62406
265;"22.09.2006";11;"64.1";2303;66078;63775
265;"22.09.2006";12;"70.3";2568;67423;64855
265;"22.09.2006";13;"69.2";2790;66469;63679
265;"22.09.2006";14;"60.9";3244;64658;61414
265;"22.09.2006";15;55;3691;63172;59481
265;"22.09.2006";16;"50.2";4012;61948;57936
265;"22.09.2006";17;47;4115;61033;56918
265;"22.09.2006";18;"49.8";4019;61236;57217
265;"22.09.2006";19;"53.5";3779;60893;57114
265;"22.09.2006";20;"59.2";4563;63107;58544
265;"22.09.2006";21;"56.9";5387;62574;57187
265;"22.09.2006";22;"44.3";5211;57812;52601
265;"22.09.2006";23;39;5038;54259;49221
265;"22.09.2006";24;32;4387;49948;45561
266;"23.09.2006";1;"33.6";3876;46468;42592
266;"23.09.2006";2;"29.1";3427;43790;40363
266;"23.09.2006";3;"28.2";3100;42392;39292
266;"23.09.2006";4;"23.4";2872;41803;38931
266;"23.09.2006";5;"21.4";2619;41690;39071
266;"23.09.2006";6;"22.5";2474;42743;40269
266;"23.09.2006";7;"21.4";2463;45713;43250
266;"23.09.2006";8;"28.2";2493;48614;46121
266;"23.09.2006";9;"34.6";2196;52223;50027
266;"23.09.2006";10;39;1763;54944;53181
266;"23.09.2006";11;"40.1";1789;56414;54625
266;"23.09.2006";12;"45.1";2006;56940;54934
266;"23.09.2006";13;42;2214;55453;53239
266;"23.09.2006";14;"40.1";2734;52974;50240
266;"23.09.2006";15;38;2905;50809;47904
266;"23.09.2006";16;35;3180;49868;46688
266;"23.09.2006";17;"33.3";3407;49605;46198
266;"23.09.2006";18;"33.5";3428;50922;47494
266;"23.09.2006";19;"35.1";3112;51602;48490
266;"23.09.2006";20;"40.9";3605;54116;50511
266;"23.09.2006";21;"38.1";4317;53892;49575
266;"23.09.2006";22;"32.1";4577;50209;45632
266;"23.09.2006";23;"28.6";4553;47560;43007
266;"23.09.2006";24;"23.9";4698;44120;39422
267;"24.09.2006";1;"23.1";4748;41468;36720
267;"24.09.2006";2;21;4279;39234;34955
267;"24.09.2006";3;"18.6";3959;37836;33877
267;"24.09.2006";4;11;3872;37308;33436
267;"24.09.2006";5;11;3994;37245;33251
267;"24.09.2006";6;"14.1";3765;37372;33607
267;"24.09.2006";7;"10.4";3689;38474;34785
267;"24.09.2006";8;"14.1";3679;39772;36093
267;"24.09.2006";9;"21.1";3126;42947;39821
267;"24.09.2006";10;"29.9";2561;45743;43182
267;"24.09.2006";11;"35.1";2121;47804;45683
267;"24.09.2006";12;"38.6";2072;50140;48068
267;"24.09.2006";13;"37.9";2075;49127;47052
267;"24.09.2006";14;"32.7";2050;46534;44484
267;"24.09.2006";15;"28.2";2288;44704;42416
267;"24.09.2006";16;26;2133;44079;41946
267;"24.09.2006";17;"23.4";2077;44070;41993
267;"24.09.2006";18;"27.4";1927;45830;43903
267;"24.09.2006";19;"32.6";1716;48275;46559
267;"24.09.2006";20;"41.1";2165;52134;49969
267;"24.09.2006";21;"41.6";2610;53272;50662
267;"24.09.2006";22;"37.7";2689;50574;47885
267;"24.09.2006";23;"37.2";2828;48490;45662
267;"24.09.2006";24;"24.7";2785;44895;42110
268;"25.09.2006";1;"22.6";2779;42035;39256
268;"25.09.2006";2;"21.9";2494;40515;38021
268;"25.09.2006";3;22;2439;39822;37383
268;"25.09.2006";4;"17.1";2411;39974;37563
268;"25.09.2006";5;"23.4";2324;41183;38859
268;"25.09.2006";6;"31.2";2371;45450;43079
268;"25.09.2006";7;"47.7";2496;56627;54131
268;"25.09.2006";8;"67.1";2583;62986;60403
268;"25.09.2006";9;"63.1";2218;65468;63250
268;"25.09.2006";10;"63.4";1832;66086;64254
268;"25.09.2006";11;"65.1";1935;67533;65598
268;"25.09.2006";12;"70.9";2301;69051;66750
268;"25.09.2006";13;"66.3";2588;68039;65451
268;"25.09.2006";14;67;2728;67434;64706
268;"25.09.2006";15;"66.1";2604;66592;63988
268;"25.09.2006";16;"65.3";2485;65559;63074
268;"25.09.2006";17;"63.1";2328;64385;62057
268;"25.09.2006";18;63;1803;64377;62574
268;"25.09.2006";19;"61.9";1352;64722;63370
268;"25.09.2006";20;"64.7";1501;67279;65778
268;"25.09.2006";21;"66.9";1832;64829;62997
268;"25.09.2006";22;"59.7";2017;59783;57766
268;"25.09.2006";23;46;1947;54562;52615
268;"25.09.2006";24;"37.6";1991;49070;47079
269;"26.09.2006";1;38;1914;45949;44035
269;"26.09.2006";2;32;1752;44340;42588
269;"26.09.2006";3;28;1689;43256;41567
269;"26.09.2006";4;"27.1";1503;43331;41828
269;"26.09.2006";5;31;1332;44441;43109
269;"26.09.2006";6;"38.6";1317;48452;47135
269;"26.09.2006";7;"58.9";1221;58355;57134
269;"26.09.2006";8;"71.3";1141;64805;63664
269;"26.09.2006";9;65;1014;67318;66304
269;"26.09.2006";10;62;763;67427;66664
269;"26.09.2006";11;"62.8";1332;68547;67215
269;"26.09.2006";12;71;793;69927;69134
269;"26.09.2006";13;68;900;68787;67887
269;"26.09.2006";14;65;991;67806;66815
269;"26.09.2006";15;60;953;66581;65628
269;"26.09.2006";16;"62.3";931;65700;64769
269;"26.09.2006";17;"64.6";833;64497;63664
269;"26.09.2006";18;"62.1";709;64312;63603
269;"26.09.2006";19;64;695;64994;64299
269;"26.09.2006";20;"70.9";818;67166;66348
269;"26.09.2006";21;"71.2";1111;64807;63696
269;"26.09.2006";22;"61.3";1145;59579;58434
269;"26.09.2006";23;"47.9";1084;54723;53639
269;"26.09.2006";24;"35.8";1145;49498;48353
270;"27.09.2006";1;"37.3";1109;45947;44838
270;"27.09.2006";2;"31.7";1050;44048;42998
270;"27.09.2006";3;"27.4";1153;43006;41853
270;"27.09.2006";4;"27.5";1191;43266;42075
270;"27.09.2006";5;31;1285;44656;43371
270;"27.09.2006";6;"36.9";1102;48617;47515
270;"27.09.2006";7;"57.1";1014;58176;57162
270;"27.09.2006";8;"71.1";871;65088;64217
270;"27.09.2006";9;"68.1";753;67330;66577
270;"27.09.2006";10;"66.1";590;67650;67060
270;"27.09.2006";11;"68.8";510;68376;67866
270;"27.09.2006";12;"70.9";555;69547;68992
270;"27.09.2006";13;"67.4";617;67984;67367
270;"27.09.2006";14;"74.1";604;66943;66339
270;"27.09.2006";15;"74.5";575;65779;65204
270;"27.09.2006";16;"72.7";477;64877;64400
270;"27.09.2006";17;"64.6";329;63281;62952
270;"27.09.2006";18;"61.1";251;62881;62630
270;"27.09.2006";19;"61.9";235;63539;63304
270;"27.09.2006";20;71;320;66621;66301
270;"27.09.2006";21;"70.9";354;65028;64674
270;"27.09.2006";22;"61.1";425;60005;59580
270;"27.09.2006";23;50;495;54972;54477
270;"27.09.2006";24;"33.4";601;49377;48776
271;"28.09.2006";1;"35.8";778;45982;45204
271;"28.09.2006";2;"31.9";916;44347;43431
271;"28.09.2006";3;"27.1";1018;43351;42333
271;"28.09.2006";4;"22.5";1151;43398;42247
271;"28.09.2006";5;"27.8";1238;44488;43250
271;"28.09.2006";6;"34.4";1244;48095;46851
271;"28.09.2006";7;"54.6";1314;57801;56487
271;"28.09.2006";8;"68.1";1396;63799;62403
271;"28.09.2006";9;"66.4";1309;65676;64367
271;"28.09.2006";10;"66.2";905;65710;64805
271;"28.09.2006";11;"69.1";660;66737;66077
271;"28.09.2006";12;71;625;67890;67265
271;"28.09.2006";13;"70.1";813;66916;66103
271;"28.09.2006";14;71;1052;65801;64749
271;"28.09.2006";15;"70.6";1228;64746;63518
271;"28.09.2006";16;"69.9";1157;63989;62832
271;"28.09.2006";17;"68.5";931;62621;61690
271;"28.09.2006";18;"63.9";672;62423;61751
271;"28.09.2006";19;64;506;63245;62739
271;"28.09.2006";20;64;521;66493;65972
271;"28.09.2006";21;"63.6";650;64773;64123
271;"28.09.2006";22;"58.3";914;59588;58674
271;"28.09.2006";23;"45.1";1038;54696;53658
271;"28.09.2006";24;35;1055;49622;48567
272;"29.09.2006";1;"38.5";974;45997;45023
272;"29.09.2006";2;29;1009;43876;42867
272;"29.09.2006";3;"22.7";957;42936;41979
272;"29.09.2006";4;"22.6";917;43121;42204
272;"29.09.2006";5;"28.5";864;44261;43397
272;"29.09.2006";6;"34.3";840;48351;47511
272;"29.09.2006";7;"60.1";909;57616;56707
272;"29.09.2006";8;"70.9";953;63721;62768
272;"29.09.2006";9;64;887;65787;64900
272;"29.09.2006";10;"67.9";722;66039;65317
272;"29.09.2006";11;"66.1";501;66734;66233
272;"29.09.2006";12;"68.5";660;67618;66958
272;"29.09.2006";13;"60.1";955;66353;65398
272;"29.09.2006";14;"59.3";1148;64343;63195
272;"29.09.2006";15;"65.7";1255;62863;61608
272;"29.09.2006";16;61;1126;61604;60478
272;"29.09.2006";17;56;1068;60858;59790
272;"29.09.2006";18;56;806;60956;60150
272;"29.09.2006";19;"57.4";818;61846;61028
272;"29.09.2006";20;"70.9";1107;65146;64039
272;"29.09.2006";21;"66.2";1456;62730;61274
272;"29.09.2006";22;"47.1";1799;57703;55904
272;"29.09.2006";23;39;2158;53729;51571
272;"29.09.2006";24;"31.6";2516;49582;47066
273;"30.09.2006";1;"44.3";2549;45906;43357
273;"30.09.2006";2;"32.6";2125;43655;41530
273;"30.09.2006";3;"30.7";1859;42195;40336
273;"30.09.2006";4;"22.6";1835;41748;39913
273;"30.09.2006";5;"22.6";1768;41931;40163
273;"30.09.2006";6;"29.9";1664;42852;41188
273;"30.09.2006";7;"31.3";1770;45862;44092
273;"30.09.2006";8;"35.1";1877;49177;47300
273;"30.09.2006";9;"33.9";1760;52505;50745
273;"30.09.2006";10;"53.9";1437;54929;53492
273;"30.09.2006";11;"54.1";1095;56181;55086
273;"30.09.2006";12;"50.4";1191;56846;55655
273;"30.09.2006";13;48;1246;55508;54262
273;"30.09.2006";14;45;1368;52737;51369
273;"30.09.2006";15;"36.1";1516;50627;49111
273;"30.09.2006";16;"33.5";1435;49683;48248
273;"30.09.2006";17;"35.4";1204;49209;48005
273;"30.09.2006";18;"37.8";886;50681;49795
273;"30.09.2006";19;50;597;52344;51747
273;"30.09.2006";20;"62.4";624;55544;54920
273;"30.09.2006";21;"64.8";808;53631;52823
273;"30.09.2006";22;"47.9";996;49918;48922
273;"30.09.2006";23;34;1165;47294;46129
273;"30.09.2006";24;30;1109;43619;42510
274;"01.10.2006";1;"29.9";1130;40182;39052
274;"01.10.2006";2;"22.8";1042;37965;36923
274;"01.10.2006";3;19;1111;36886;35775
274;"01.10.2006";4;"11.1";1358;36409;35051
274;"01.10.2006";5;10;1235;36631;35396
274;"01.10.2006";6;"12.1";1328;36802;35474
274;"01.10.2006";7;"19.2";1544;37975;36431
274;"01.10.2006";8;"16.5";1779;40032;38253
274;"01.10.2006";9;"26.9";2102;43243;41141
274;"01.10.2006";10;"30.1";1905;45970;44065
274;"01.10.2006";11;"33.2";1490;48101;46611
274;"01.10.2006";12;"39.9";1700;50109;48409
274;"01.10.2006";13;"37.1";2256;48897;46641
274;"01.10.2006";14;"32.1";2727;46904;44177
274;"01.10.2006";15;26;2985;45120;42135
274;"01.10.2006";16;22;3184;44467;41283
274;"01.10.2006";17;"21.9";3027;44454;41427
274;"01.10.2006";18;30;2632;46258;43626
274;"01.10.2006";19;39;2646;48960;46314
274;"01.10.2006";20;"50.5";3172;52630;49458
274;"01.10.2006";21;46;3569;51458;47889
274;"01.10.2006";22;36;3639;48989;45350
274;"01.10.2006";23;36;3855;46768;42913
274;"01.10.2006";24;"29.1";4068;42708;38640
275;"02.10.2006";1;"22.2";4123;39937;35814
275;"02.10.2006";2;14;4372;38560;34188
275;"02.10.2006";3;"8.9";4343;37797;33454
275;"02.10.2006";4;"5.1";4709;38014;33305
275;"02.10.2006";5;7;5449;39260;33811
275;"02.10.2006";6;"19.9";6351;42366;36015
275;"02.10.2006";7;"28.5";6878;49636;42758
275;"02.10.2006";8;"37.9";7583;55231;47648
275;"02.10.2006";9;"53.6";8023;58433;50410
275;"02.10.2006";10;54;8592;59469;50877
275;"02.10.2006";11;"55.1";10049;60929;50880
275;"02.10.2006";12;"57.8";11074;62933;51859
275;"02.10.2006";13;"55.4";11606;62826;51220
275;"02.10.2006";14;"54.6";11545;61550;50005
275;"02.10.2006";15;"53.8";11193;60495;49302
275;"02.10.2006";16;"48.1";10459;59581;49122
275;"02.10.2006";17;"47.6";10024;58982;48958
275;"02.10.2006";18;45;9132;59159;50027
275;"02.10.2006";19;"51.2";8534;60510;51976
275;"02.10.2006";20;"57.2";8309;62674;54365
275;"02.10.2006";21;55;8010;59292;51282
275;"02.10.2006";22;44;7303;54720;47417
275;"02.10.2006";23;"37.8";6570;51125;44555
275;"02.10.2006";24;"30.7";6149;46806;40657
276;"03.10.2006";1;25;5685;43665;37980
276;"03.10.2006";2;"11.6";5418;41479;36061
276;"03.10.2006";3;"3.1";4698;40008;35310
276;"03.10.2006";4;"7.3";4486;39591;35105
276;"03.10.2006";5;16;3986;39770;35784
276;"03.10.2006";6;"26.8";3699;39845;36146
276;"03.10.2006";7;"21.1";3280;40259;36979
276;"03.10.2006";8;"27.3";3054;41914;38860
276;"03.10.2006";9;"22.5";2922;44982;42060
276;"03.10.2006";10;"27.4";2462;47737;45275
276;"03.10.2006";11;"30.1";2266;50255;47989
276;"03.10.2006";12;"32.2";1969;53085;51116
276;"03.10.2006";13;"32.6";1529;52443;50914
276;"03.10.2006";14;"30.1";1158;50085;48927
276;"03.10.2006";15;30;956;48530;47574
276;"03.10.2006";16;30;677;47484;46807
276;"03.10.2006";17;"30.1";594;47658;47064
276;"03.10.2006";18;"32.9";564;49521;48957
276;"03.10.2006";19;40;635;52414;51779
276;"03.10.2006";20;"52.6";785;55005;54220
276;"03.10.2006";21;"39.1";1072;52815;51743
276;"03.10.2006";22;"34.6";1478;50010;48532
276;"03.10.2006";23;36;1785;48307;46522
276;"03.10.2006";24;"30.8";1990;44187;42197
277;"04.10.2006";1;"27.7";2251;41098;38847
277;"04.10.2006";2;21;2750;39569;36819
277;"04.10.2006";3;"16.5";3153;38922;35769
277;"04.10.2006";4;17;3410;39147;35737
277;"04.10.2006";5;18;3536;41048;37512
277;"04.10.2006";6;"25.5";3827;45393;41566
277;"04.10.2006";7;"36.9";4068;55560;51492
277;"04.10.2006";8;59;4297;62704;58407
277;"04.10.2006";9;"65.7";3985;64952;60967
277;"04.10.2006";10;"66.1";3740;65187;61447
277;"04.10.2006";11;"66.2";3643;66108;62465
277;"04.10.2006";12;"67.7";3622;67268;63646
277;"04.10.2006";13;"66.2";3735;66254;62519
277;"04.10.2006";14;"68.9";3534;65307;61773
277;"04.10.2006";15;67;3269;64023;60754
277;"04.10.2006";16;64;3467;63449;59982
277;"04.10.2006";17;"61.1";3080;62157;59077
277;"04.10.2006";18;61;2763;62308;59545
277;"04.10.2006";19;"63.8";2262;63806;61544
277;"04.10.2006";20;"67.9";2250;67117;64867
277;"04.10.2006";21;"58.1";2351;63601;61250
277;"04.10.2006";22;"50.1";2241;58613;56372
277;"04.10.2006";23;"38.6";2244;54306;52062
277;"04.10.2006";24;"29.1";2218;49194;46976
278;"05.10.2006";1;"29.5";2279;45534;43255
278;"05.10.2006";2;"22.5";2352;43678;41326
278;"05.10.2006";3;"17.8";2404;42766;40362
278;"05.10.2006";4;20;2292;42975;40683
278;"05.10.2006";5;20;2312;44574;42262
278;"05.10.2006";6;29;2221;48002;45781
278;"05.10.2006";7;"38.7";2141;57041;54900
278;"05.10.2006";8;"81.2";2055;63327;61272
278;"05.10.2006";9;67;2032;64995;62963
278;"05.10.2006";10;"57.4";1692;65271;63579
278;"05.10.2006";11;"55.6";1702;66260;64558
278;"05.10.2006";12;"61.4";1929;67463;65534
278;"05.10.2006";13;"54.2";2329;66420;64091
278;"05.10.2006";14;"60.9";2804;65301;62497
278;"05.10.2006";15;"54.7";3232;64102;60870
278;"05.10.2006";16;"48.5";3714;63128;59414
278;"05.10.2006";17;"43.6";3441;61621;58180
278;"05.10.2006";18;"43.6";3018;61678;58660
278;"05.10.2006";19;"48.1";2807;63327;60520
278;"05.10.2006";20;"57.1";3660;67074;63414
278;"05.10.2006";21;"71.9";4794;64045;59251
278;"05.10.2006";22;"42.3";5972;59381;53409
278;"05.10.2006";23;"32.9";7173;55624;48451
278;"05.10.2006";24;30;8117;50766;42649
279;"06.10.2006";1;12;8960;47128;38168
279;"06.10.2006";2;"2.6";9461;45190;35729
279;"06.10.2006";3;"2.7";10018;44765;34747
279;"06.10.2006";4;"2.5";10336;45196;34860
279;"06.10.2006";5;"1.5";10250;46445;36195
279;"06.10.2006";6;"2.5";9972;49926;39954
279;"06.10.2006";7;29;9885;58623;48738
279;"06.10.2006";8;37;10023;65121;55098
279;"06.10.2006";9;"38.1";9556;67460;57904
279;"06.10.2006";10;"40.1";9070;67713;58643
279;"06.10.2006";11;"40.1";9232;68810;59578
279;"06.10.2006";12;"41.2";8954;69604;60650
279;"06.10.2006";13;"41.1";9331;68196;58865
279;"06.10.2006";14;38;9337;66743;57406
279;"06.10.2006";15;35;8918;65189;56271
279;"06.10.2006";16;"32.9";8730;64091;55361
279;"06.10.2006";17;32;7994;62843;54849
279;"06.10.2006";18;"31.6";7383;63043;55660
279;"06.10.2006";19;35;7858;64914;57056
279;"06.10.2006";20;"44.6";8457;67099;58642
279;"06.10.2006";21;"32.1";9010;63132;54122
279;"06.10.2006";22;"29.6";9225;58723;49498
279;"06.10.2006";23;25;9338;55793;46455
279;"06.10.2006";24;"19.4";9280;51591;42311
280;"07.10.2006";1;"35.1";8976;47880;38904
280;"07.10.2006";2;31;8630;45692;37062
280;"07.10.2006";3;"23.4";8607;44293;35686
280;"07.10.2006";4;"23.3";8659;43941;35282
280;"07.10.2006";5;"22.1";8464;44538;36074
280;"07.10.2006";6;"22.1";8472;45292;36820
280;"07.10.2006";7;"19.8";7987;47081;39094
280;"07.10.2006";8;"32.7";7865;50308;42443
280;"07.10.2006";9;"34.7";7713;53340;45627
280;"07.10.2006";10;39;7751;56130;48379
280;"07.10.2006";11;40;8831;57834;49003
280;"07.10.2006";12;"40.7";9778;58806;49028
280;"07.10.2006";13;"39.9";10171;57220;47049
280;"07.10.2006";14;"34.1";10227;55329;45102
280;"07.10.2006";15;"31.7";10174;53271;43097
280;"07.10.2006";16;"27.1";9809;52503;42694
280;"07.10.2006";17;"26.1";9701;52362;42661
280;"07.10.2006";18;"26.1";9185;53642;44457
280;"07.10.2006";19;"35.6";7880;55690;47810
280;"07.10.2006";20;"42.3";6883;58287;51404
280;"07.10.2006";21;"34.1";6590;55204;48614
280;"07.10.2006";22;"29.1";6664;52084;45420
280;"07.10.2006";23;"32.1";6684;50004;43320
280;"07.10.2006";24;"23.4";6718;46328;39610
281;"08.10.2006";1;"22.7";7157;43419;36262
281;"08.10.2006";2;"11.2";7099;41004;33905
281;"08.10.2006";3;11;7014;40157;33143
281;"08.10.2006";4;10;7051;40172;33121
281;"08.10.2006";5;"4.1";6947;40557;33610
281;"08.10.2006";6;"6.9";6408;40201;33793
281;"08.10.2006";7;9;6016;40103;34087
281;"08.10.2006";8;"11.1";5979;41680;35701
281;"08.10.2006";9;"20.2";5954;44190;38236
281;"08.10.2006";10;"28.2";5168;46564;41396
281;"08.10.2006";11;"34.1";4786;48847;44061
281;"08.10.2006";12;"35.1";4854;51181;46327
281;"08.10.2006";13;37;4689;49503;44814
281;"08.10.2006";14;34;4568;47430;42862
281;"08.10.2006";15;"26.1";3925;45150;41225
281;"08.10.2006";16;"24.1";3299;44380;41081
281;"08.10.2006";17;20;2584;44229;41645
281;"08.10.2006";18;"25.9";2030;46421;44391
281;"08.10.2006";19;"35.8";1733;50440;48707
281;"08.10.2006";20;47;1771;54479;52708
281;"08.10.2006";21;"44.5";1737;52610;50873
281;"08.10.2006";22;"39.9";1664;50218;48554
281;"08.10.2006";23;42;1530;49156;47626
281;"08.10.2006";24;35;1743;45584;43841
282;"09.10.2006";1;"20.9";1858;42638;40780
282;"09.10.2006";2;"12.1";1960;41197;39237
282;"09.10.2006";3;"15.2";2068;40359;38291
282;"09.10.2006";4;"13.3";2014;40976;38962
282;"09.10.2006";5;"21.2";1838;43151;41313
282;"09.10.2006";6;"24.8";1864;47420;45556
282;"09.10.2006";7;"41.1";2109;57126;55017
282;"09.10.2006";8;"59.9";2581;63994;61413
282;"09.10.2006";9;63;2813;66012;63199
282;"09.10.2006";10;"59.2";2069;65938;63869
282;"09.10.2006";11;"59.2";1342;66713;65371
282;"09.10.2006";12;"66.5";1247;67924;66677
282;"09.10.2006";13;"59.6";1098;66864;65766
282;"09.10.2006";14;"63.5";1081;65973;64892
282;"09.10.2006";15;"59.1";1084;64900;63816
282;"09.10.2006";16;"58.6";967;63850;62883
282;"09.10.2006";17;58;756;62372;61616
282;"09.10.2006";18;56;731;62339;61608
282;"09.10.2006";19;"59.9";992;65096;64104
282;"09.10.2006";20;67;1481;69238;67757
282;"09.10.2006";21;58;1581;65176;63595
282;"09.10.2006";22;"49.1";1551;60551;59000
282;"09.10.2006";23;"38.4";1407;56328;54921
282;"09.10.2006";24;"33.5";1007;51160;50153
283;"10.10.2006";1;"32.8";831;47583;46752
283;"10.10.2006";2;"30.3";664;45085;44421
283;"10.10.2006";3;"27.5";497;44125;43628
283;"10.10.2006";4;"27.4";348;44353;44005
283;"10.10.2006";5;"30.5";237;46080;45843
283;"10.10.2006";6;"32.8";155;50041;49886
283;"10.10.2006";7;"55.2";154;58926;58772
283;"10.10.2006";8;"73.2";160;65348;65188
283;"10.10.2006";9;"65.8";167;67172;67005
283;"10.10.2006";10;61;191;67037;66846
283;"10.10.2006";11;"61.3";153;67755;67602
283;"10.10.2006";12;71;130;69002;68872
283;"10.10.2006";13;"61.3";132;67961;67829
283;"10.10.2006";14;64;124;66931;66807
283;"10.10.2006";15;"64.8";123;65999;65876
283;"10.10.2006";16;62;93;64969;64876
283;"10.10.2006";17;"56.9";109;63588;63479
283;"10.10.2006";18;59;170;63578;63408
283;"10.10.2006";19;"62.4";405;65676;65271
283;"10.10.2006";20;72;846;69187;68341
283;"10.10.2006";21;"61.2";1235;65293;64058
283;"10.10.2006";22;"59.2";1558;60714;59156
283;"10.10.2006";23;"35.5";1748;56367;54619
283;"10.10.2006";24;"31.9";1763;51209;49446
284;"11.10.2006";1;"31.9";1674;47257;45583
284;"11.10.2006";2;"26.7";1594;45020;43426
284;"11.10.2006";3;"29.1";1491;44192;42701
284;"11.10.2006";4;"25.6";1415;44492;43077
284;"11.10.2006";5;"26.3";1408;46121;44713
284;"11.10.2006";6;33;1566;50095;48529
284;"11.10.2006";7;"47.5";1687;59043;57356
284;"11.10.2006";8;"65.4";1841;65401;63560
284;"11.10.2006";9;"56.1";1840;66980;65140
284;"11.10.2006";10;"56.3";1533;66681;65148
284;"11.10.2006";11;59;1216;67367;66151
284;"11.10.2006";12;"59.6";1414;68479;67065
284;"11.10.2006";13;"55.6";1807;67346;65539
284;"11.10.2006";14;58;2060;66483;64423
284;"11.10.2006";15;"56.4";2272;65007;62735
284;"11.10.2006";16;"54.6";2282;63936;61654
284;"11.10.2006";17;55;2234;62590;60356
284;"11.10.2006";18;48;2317;63182;60865
284;"11.10.2006";19;"49.1";2506;66011;63505
284;"11.10.2006";20;69;3069;69187;66118
284;"11.10.2006";21;57;3154;65293;62139
284;"11.10.2006";22;"39.2";3117;60854;57737
284;"11.10.2006";23;"36.1";2799;56934;54135
284;"11.10.2006";24;"31.9";2426;51603;49177
285;"12.10.2006";1;"30.8";2001;47375;45374
285;"12.10.2006";2;"30.1";1759;45344;43585
285;"12.10.2006";3;"24.9";1522;44247;42725
285;"12.10.2006";4;"22.5";1229;44441;43212
285;"12.10.2006";5;"29.5";1126;45776;44650
285;"12.10.2006";6;"32.9";1076;49732;48656
285;"12.10.2006";7;"49.7";963;58906;57943
285;"12.10.2006";8;"70.9";914;65478;64564
285;"12.10.2006";9;"64.9";743;66969;66226
285;"12.10.2006";10;"69.1";536;66961;66425
285;"12.10.2006";11;71;396;67799;67403
285;"12.10.2006";12;"78.6";331;68962;68631
285;"12.10.2006";13;"73.2";281;67969;67688
285;"12.10.2006";14;"69.9";206;67112;66906
285;"12.10.2006";15;"70.8";171;65630;65459
285;"12.10.2006";16;"67.8";203;64643;64440
285;"12.10.2006";17;"60.8";219;63205;62986
285;"12.10.2006";18;"59.8";169;63736;63567
285;"12.10.2006";19;"72.3";191;66535;66344
285;"12.10.2006";20;"83.3";259;69246;68987
285;"12.10.2006";21;"78.5";276;65035;64759
285;"12.10.2006";22;"61.6";266;60428;60162
285;"12.10.2006";23;"53.9";322;56184;55862
285;"12.10.2006";24;"34.7";262;51132;50870
286;"13.10.2006";1;33;287;47255;46968
286;"13.10.2006";2;"32.2";272;45131;44859
286;"13.10.2006";3;"30.2";227;44071;43844
286;"13.10.2006";4;"23.5";272;44234;43962
286;"13.10.2006";5;"29.7";320;45612;45292
286;"13.10.2006";6;"32.8";288;49672;49384
286;"13.10.2006";7;"52.1";323;58780;58457
286;"13.10.2006";8;71;303;66277;65974
286;"13.10.2006";9;"70.5";291;68413;68122
286;"13.10.2006";10;70;331;68444;68113
286;"13.10.2006";11;"70.5";328;69143;68815
286;"13.10.2006";12;"74.1";393;70094;69701
286;"13.10.2006";13;67;422;68777;68355
286;"13.10.2006";14;"61.2";468;67106;66638
286;"13.10.2006";15;"56.4";491;65329;64838
286;"13.10.2006";16;56;517;63985;63468
286;"13.10.2006";17;53;573;62608;62035
286;"13.10.2006";18;"53.3";638;63325;62687
286;"13.10.2006";19;"63.9";800;65900;65100
286;"13.10.2006";20;64;1079;67276;66197
286;"13.10.2006";21;"55.8";1283;62682;61399
286;"13.10.2006";22;42;1316;58308;56992
286;"13.10.2006";23;"40.9";1317;54955;53638
286;"13.10.2006";24;"32.5";1386;50548;49162
287;"14.10.2006";1;39;1435;46553;45118
287;"14.10.2006";2;"34.6";1467;44415;42948
287;"14.10.2006";3;"31.2";1654;42957;41303
287;"14.10.2006";4;"31.7";1702;42775;41073
287;"14.10.2006";5;"29.9";1722;43423;41701
287;"14.10.2006";6;"33.9";1737;44267;42530
287;"14.10.2006";7;24;1543;46426;44883
287;"14.10.2006";8;"37.4";1452;49832;48380
287;"14.10.2006";9;"45.4";1428;53453;52025
287;"14.10.2006";10;54;1346;55859;54513
287;"14.10.2006";11;"57.4";1400;57335;55935
287;"14.10.2006";12;60;1510;58250;56740
287;"14.10.2006";13;"53.9";1607;56613;55006
287;"14.10.2006";14;"40.1";1625;53987;52362
287;"14.10.2006";15;"38.7";1617;52025;50408
287;"14.10.2006";16;"37.3";1651;51023;49372
287;"14.10.2006";17;"33.9";1622;50867;49245
287;"14.10.2006";18;"39.1";1626;52694;51068
287;"14.10.2006";19;55;1770;55876;54106
287;"14.10.2006";20;60;1944;57363;55419
287;"14.10.2006";21;"47.5";1992;53664;51672
287;"14.10.2006";22;"38.7";2146;50381;48235
287;"14.10.2006";23;"38.9";1963;48584;46621
287;"14.10.2006";24;"34.1";1721;44859;43138
288;"15.10.2006";1;31;1718;41558;39840
288;"15.10.2006";2;"22.2";1625;39455;37830
288;"15.10.2006";3;"16.1";1440;38238;36798
288;"15.10.2006";4;"12.1";1550;37916;36366
288;"15.10.2006";5;"12.1";1568;38503;36935
288;"15.10.2006";6;10;1696;38637;36941
288;"15.10.2006";7;"11.2";1841;38694;36853
288;"15.10.2006";8;"15.1";1735;40278;38543
288;"15.10.2006";9;"23.1";1634;43273;41639
288;"15.10.2006";10;33;1663;46364;44701
288;"15.10.2006";11;"35.1";1651;48839;47188
288;"15.10.2006";12;"41.4";1479;51312;49833
288;"15.10.2006";13;"38.1";1542;49792;48250
288;"15.10.2006";14;36;1418;47086;45668
288;"15.10.2006";15;"31.1";1349;45005;43656
288;"15.10.2006";16;"25.8";1330;43966;42636
288;"15.10.2006";17;"22.9";1273;44300;43027
288;"15.10.2006";18;"31.9";1267;46653;45386
288;"15.10.2006";19;"47.6";1364;51684;50320
288;"15.10.2006";20;55;1728;55214;53486
288;"15.10.2006";21;"48.6";1826;52725;50899
288;"15.10.2006";22;"41.3";1970;50684;48714
288;"15.10.2006";23;40;2033;49930;47897
288;"15.10.2006";24;"33.3";1936;46185;44249
289;"16.10.2006";1;"31.1";1774;43053;41279
289;"16.10.2006";2;23;1756;41354;39598
289;"16.10.2006";3;"21.3";1689;40893;39204
289;"16.10.2006";4;"21.2";1693;41536;39843
289;"16.10.2006";5;"23.2";1790;43532;41742
289;"16.10.2006";6;"32.3";1951;47258;45307
289;"16.10.2006";7;"45.7";1971;55081;53110
289;"16.10.2006";8;"73.6";1788;62341;60553
289;"16.10.2006";9;"64.1";1721;66551;64830
289;"16.10.2006";10;"64.9";1525;67250;65725
289;"16.10.2006";11;"67.6";1295;67903;66608
289;"16.10.2006";12;"72.6";1341;68730;67389
289;"16.10.2006";13;"69.1";1213;67359;66146
289;"16.10.2006";14;"69.4";1167;66248;65081
289;"16.10.2006";15;"65.1";1216;65028;63812
289;"16.10.2006";16;"62.5";1341;64076;62735
289;"16.10.2006";17;"59.6";1392;62537;61145
289;"16.10.2006";18;"59.9";1441;62792;61351
289;"16.10.2006";19;"64.5";1888;66191;64303
289;"16.10.2006";20;"75.3";2706;69601;66895
289;"16.10.2006";21;"66.8";3185;65416;62231
289;"16.10.2006";22;"57.5";3424;61212;57788
289;"16.10.2006";23;"44.8";3407;57239;53832
289;"16.10.2006";24;"33.1";3294;51916;48622
290;"17.10.2006";1;"38.7";3264;48468;45204
290;"17.10.2006";2;"29.5";3028;46316;43288
290;"17.10.2006";3;"28.2";2898;45150;42252
290;"17.10.2006";4;"28.7";2749;45772;43023
290;"17.10.2006";5;"30.5";2948;47576;44628
290;"17.10.2006";6;"37.8";3074;51000;47926
290;"17.10.2006";7;"62.9";3192;59533;56341
290;"17.10.2006";8;"78.6";3369;66089;62720
290;"17.10.2006";9;"78.5";3306;67484;64178
290;"17.10.2006";10;"78.5";2764;67219;64455
290;"17.10.2006";11;"84.9";1838;67641;65803
290;"17.10.2006";12;"92.2";1582;68522;66940
290;"17.10.2006";13;81;1579;67357;65778
290;"17.10.2006";14;"81.9";1391;66297;64906
290;"17.10.2006";15;"71.9";1378;65214;63836
290;"17.10.2006";16;"67.7";1429;64020;62591
290;"17.10.2006";17;"59.6";1668;62881;61213
290;"17.10.2006";18;59;2016;63286;61270
290;"17.10.2006";19;70;2946;67368;64422
290;"17.10.2006";20;"83.3";4037;70185;66148
290;"17.10.2006";21;72;4653;66133;61480
290;"17.10.2006";22;"59.6";4815;61619;56804
290;"17.10.2006";23;"49.7";4926;57956;53030
290;"17.10.2006";24;"35.5";4731;52607;47876
291;"18.10.2006";1;"33.9";4332;48544;44212
291;"18.10.2006";2;30;3952;46429;42477
291;"18.10.2006";3;"29.3";3622;45474;41852
291;"18.10.2006";4;"29.9";3414;46144;42730
291;"18.10.2006";5;"29.5";3215;47743;44528
291;"18.10.2006";6;"31.3";3442;51335;47893
291;"18.10.2006";7;"55.1";3388;59765;56377
291;"18.10.2006";8;"70.9";3137;66573;63436
291;"18.10.2006";9;"70.9";3067;67936;64869
291;"18.10.2006";10;"73.2";2535;67535;65000
291;"18.10.2006";11;"74.6";1787;68162;66375
291;"18.10.2006";12;"79.7";1203;68987;67784
291;"18.10.2006";13;"70.9";1036;67931;66895
291;"18.10.2006";14;"73.1";986;66828;65842
291;"18.10.2006";15;"69.9";1050;65705;64655
291;"18.10.2006";16;"61.9";1146;64527;63381
291;"18.10.2006";17;"58.5";1202;63223;62021
291;"18.10.2006";18;"58.4";1455;63742;62287
291;"18.10.2006";19;"69.8";1758;67818;66060
291;"18.10.2006";20;"78.4";2345;69511;67166
291;"18.10.2006";21;"70.5";2854;65288;62434
291;"18.10.2006";22;"61.5";3094;61002;57908
291;"18.10.2006";23;37;2954;57122;54168
291;"18.10.2006";24;"30.7";2949;52033;49084
292;"19.10.2006";1;"33.3";2958;48130;45172
292;"19.10.2006";2;"29.7";2656;45997;43341
292;"19.10.2006";3;"28.1";2339;44777;42438
292;"19.10.2006";4;"22.4";2420;45398;42978
292;"19.10.2006";5;"25.5";2356;46763;44407
292;"19.10.2006";6;"31.3";2264;50346;48082
292;"19.10.2006";7;55;2511;58833;56322
292;"19.10.2006";8;"71.9";2727;66328;63601
292;"19.10.2006";9;72;2770;67780;65010
292;"19.10.2006";10;72;2580;67477;64897
292;"19.10.2006";11;"72.1";2129;68167;66038
292;"19.10.2006";12;"78.8";1957;69242;67285
292;"19.10.2006";13;"72.1";2011;68160;66149
292;"19.10.2006";14;"72.1";2131;67257;65126
292;"19.10.2006";15;"69.3";2132;66426;64294
292;"19.10.2006";16;"64.8";1920;65651;63731
292;"19.10.2006";17;63;1934;64399;62465
292;"19.10.2006";18;"64.3";2098;65222;63124
292;"19.10.2006";19;"70.9";2565;68968;66403
292;"19.10.2006";20;"72.6";3125;70507;67382
292;"19.10.2006";21;"64.2";3240;65668;62428
292;"19.10.2006";22;"59.1";3197;60980;57783
292;"19.10.2006";23;"42.1";3299;57409;54110
292;"19.10.2006";24;"32.7";3074;52219;49145
293;"20.10.2006";1;"35.5";2711;47902;45191
293;"20.10.2006";2;"33.6";2652;45768;43116
293;"20.10.2006";3;"30.6";2656;44695;42039
293;"20.10.2006";4;"29.7";2189;44808;42619
293;"20.10.2006";5;23;2269;46591;44322
293;"20.10.2006";6;"34.7";2417;50404;47987
293;"20.10.2006";7;"47.6";2266;58873;56607
293;"20.10.2006";8;71;2378;66424;64046
293;"20.10.2006";9;"70.9";2510;68403;65893
293;"20.10.2006";10;"67.4";2487;68242;65755
293;"20.10.2006";11;"68.7";2403;69131;66728
293;"20.10.2006";12;"69.9";2670;69787;67117
293;"20.10.2006";13;"66.8";2772;68317;65545
293;"20.10.2006";14;60;2975;66158;63183
293;"20.10.2006";15;"53.5";3236;64484;61248
293;"20.10.2006";16;"53.4";2791;63016;60225
293;"20.10.2006";17;56;2354;62132;59778
293;"20.10.2006";18;60;1926;63301;61375
293;"20.10.2006";19;"64.5";2572;67313;64741
293;"20.10.2006";20;"66.4";3627;68281;64654
293;"20.10.2006";21;"61.3";4313;63865;59552
293;"20.10.2006";22;"48.5";4199;59413;55214
293;"20.10.2006";23;"49.2";4211;56405;52194
293;"20.10.2006";24;"39.1";3997;51839;47842
294;"21.10.2006";1;"32.7";3980;47518;43538
294;"21.10.2006";2;"30.3";3696;45266;41570
294;"21.10.2006";3;33;3865;43968;40103
294;"21.10.2006";4;"25.9";4030;43913;39883
294;"21.10.2006";5;"23.9";3846;44420;40574
294;"21.10.2006";6;33;3648;45261;41613
294;"21.10.2006";7;30;3540;47160;43620
294;"21.10.2006";8;"33.1";3451;50897;47446
294;"21.10.2006";9;"34.7";3370;54343;50973
294;"21.10.2006";10;"47.3";3145;56904;53759
294;"21.10.2006";11;"52.8";3050;58354;55304
294;"21.10.2006";12;54;3243;59428;56185
294;"21.10.2006";13;"57.7";3595;57823;54228
294;"21.10.2006";14;"42.1";3982;55331;51349
294;"21.10.2006";15;"35.8";3632;52941;49309
294;"21.10.2006";16;"33.4";3306;51845;48539
294;"21.10.2006";17;"33.6";3055;51791;48736
294;"21.10.2006";18;"34.5";2623;53517;50894
294;"21.10.2006";19;59;2967;57972;55005
294;"21.10.2006";20;58;3763;58738;54975
294;"21.10.2006";21;"43.6";4258;54860;50602
294;"21.10.2006";22;"33.3";4481;51829;47348
294;"21.10.2006";23;"32.3";4805;50281;45476
294;"21.10.2006";24;"27.4";4691;47000;42309
295;"22.10.2006";1;31;4712;43220;38508
295;"22.10.2006";2;"23.4";4705;40543;35838
295;"22.10.2006";3;"21.8";4667;39221;34554
295;"22.10.2006";4;"16.3";4647;38874;34227
295;"22.10.2006";5;"20.1";4474;39040;34566
295;"22.10.2006";6;22;4624;39530;34906
295;"22.10.2006";7;"21.4";4887;39560;34673
295;"22.10.2006";8;"23.3";5404;41647;36243
295;"22.10.2006";9;30;5396;44245;38849
295;"22.10.2006";10;"34.4";5321;47076;41755
295;"22.10.2006";11;"39.9";5607;49516;43909
295;"22.10.2006";12;47;6628;52099;45471
295;"22.10.2006";13;"40.6";6755;50826;44071
295;"22.10.2006";14;"32.2";6145;48211;42066
295;"22.10.2006";15;"27.9";5217;46391;41174
295;"22.10.2006";16;26;4408;45421;41013
295;"22.10.2006";17;"26.7";3805;45425;41620
295;"22.10.2006";18;"34.8";3558;48021;44463
295;"22.10.2006";19;"48.3";3959;54231;50272
295;"22.10.2006";20;"57.9";5100;56053;50953
295;"22.10.2006";21;"46.1";6196;53802;47606
295;"22.10.2006";22;"40.8";6889;51940;45051
295;"22.10.2006";23;41;7332;51358;44026
295;"22.10.2006";24;"32.4";7721;47479;39758
296;"23.10.2006";1;"28.1";8573;44113;35540
296;"23.10.2006";2;"22.1";8225;42394;34169
296;"23.10.2006";3;"21.9";8256;41562;33306
296;"23.10.2006";4;"21.2";8179;41880;33701
296;"23.10.2006";5;"22.5";7946;43681;35735
296;"23.10.2006";6;"31.6";8138;48212;40074
296;"23.10.2006";7;"45.5";8377;58021;49644
296;"23.10.2006";8;"65.6";8509;66400;57891
296;"23.10.2006";9;"72.6";8581;69068;60487
296;"23.10.2006";10;"71.8";8309;69239;60930
296;"23.10.2006";11;"69.7";8124;69990;61866
296;"23.10.2006";12;"66.1";8422;71216;62794
296;"23.10.2006";13;"64.5";8345;70455;62110
296;"23.10.2006";14;"69.1";8188;70035;61847
296;"23.10.2006";15;"67.2";7840;69294;61454
296;"23.10.2006";16;"64.4";6863;67970;61107
296;"23.10.2006";17;"60.3";5927;66310;60383
296;"23.10.2006";18;"62.1";5189;66699;61510
296;"23.10.2006";19;"70.9";4523;70468;65945
296;"23.10.2006";20;"68.4";4087;70169;66082
296;"23.10.2006";21;"64.1";3803;65416;61613
296;"23.10.2006";22;"53.2";4037;61355;57318
296;"23.10.2006";23;44;4575;57261;52686
296;"23.10.2006";24;"35.6";5205;52259;47054
297;"24.10.2006";1;"44.8";5588;48374;42786
297;"24.10.2006";2;34;5965;46469;40504
297;"24.10.2006";3;"30.6";6891;45754;38863
297;"24.10.2006";4;"22.1";7402;46351;38949
297;"24.10.2006";5;"22.5";7976;48502;40526
297;"24.10.2006";6;"32.8";8637;52360;43723
297;"24.10.2006";7;"58.9";8965;60634;51669
297;"24.10.2006";8;"78.6";9090;68299;59209
297;"24.10.2006";9;"75.5";8604;69935;61331
297;"24.10.2006";10;"60.7";8560;69301;60741
297;"24.10.2006";11;"55.6";9560;70331;60771
297;"24.10.2006";12;"55.6";10581;71851;61270
297;"24.10.2006";13;"50.1";11581;70970;59389
297;"24.10.2006";14;"47.9";11956;70414;58458
297;"24.10.2006";15;"44.7";12004;69733;57729
297;"24.10.2006";16;41;11391;68624;57233
297;"24.10.2006";17;"40.9";10888;67266;56378
297;"24.10.2006";18;"45.6";10161;67604;57443
297;"24.10.2006";19;"60.5";10573;71379;60806
297;"24.10.2006";20;"64.4";11039;71506;60467
297;"24.10.2006";21;"48.8";10715;66726;56011
297;"24.10.2006";22;"34.3";10024;63029;53005
297;"24.10.2006";23;"33.4";9143;59529;50386
297;"24.10.2006";24;30;9218;54567;45349
298;"25.10.2006";1;"31.1";8764;50784;42020
298;"25.10.2006";2;"27.1";8403;48743;40340
298;"25.10.2006";3;"21.9";7547;47479;39932
298;"25.10.2006";4;"27.6";6630;47752;41122
298;"25.10.2006";5;"25.6";5842;48898;43056
298;"25.10.2006";6;"36.4";5071;52120;47049
298;"25.10.2006";7;61;4529;60117;55588
298;"25.10.2006";8;"70.9";3691;67313;63622
298;"25.10.2006";9;"70.5";3195;68472;65277
298;"25.10.2006";10;71;2399;68072;65673
298;"25.10.2006";11;"75.1";1633;68539;66906
298;"25.10.2006";12;79;1267;69558;68291
298;"25.10.2006";13;79;1100;68428;67328
298;"25.10.2006";14;"83.3";949;67625;66676
298;"25.10.2006";15;"84.1";827;66165;65338
298;"25.10.2006";16;"78.9";787;64906;64119
298;"25.10.2006";17;"74.9";877;63504;62627
298;"25.10.2006";18;"77.9";1203;64124;62921
298;"25.10.2006";19;"87.6";2050;69191;67141
298;"25.10.2006";20;"79.5";3204;70169;66965
298;"25.10.2006";21;"69.2";4378;65836;61458
298;"25.10.2006";22;64;5373;62016;56643
298;"25.10.2006";23;"59.7";5964;58400;52436
298;"25.10.2006";24;"34.4";6238;53187;46949
299;"26.10.2006";1;"32.3";6549;49149;42600
299;"26.10.2006";2;"24.7";7057;47345;40288
299;"26.10.2006";3;"21.2";7595;46417;38822
299;"26.10.2006";4;"20.3";8154;46957;38803
299;"26.10.2006";5;"20.2";8465;48560;40095
299;"26.10.2006";6;"25.6";8098;52009;43911
299;"26.10.2006";7;"29.1";8147;60484;52337
299;"26.10.2006";8;"43.8";8392;68267;59875
299;"26.10.2006";9;"57.3";8395;69545;61150
299;"26.10.2006";10;"57.8";7817;68273;60456
299;"26.10.2006";11;"57.3";7191;68490;61299
299;"26.10.2006";12;"58.4";6469;69630;63161
299;"26.10.2006";13;"52.4";6004;68733;62729
299;"26.10.2006";14;"52.1";5910;68107;62197
299;"26.10.2006";15;"52.8";5799;66932;61133
299;"26.10.2006";16;"51.5";5957;65877;59920
299;"26.10.2006";17;42;6005;64616;58611
299;"26.10.2006";18;"36.1";6062;65129;59067
299;"26.10.2006";19;"44.7";6795;70234;63439
299;"26.10.2006";20;"53.3";7631;71271;63640
299;"26.10.2006";21;"51.9";8790;66811;58021
299;"26.10.2006";22;"33.9";10315;62729;52414
299;"26.10.2006";23;"32.5";10685;59440;48755
299;"26.10.2006";24;28;11478;54588;43110
300;"27.10.2006";1;23;12016;50807;38791
300;"27.10.2006";2;"20.4";12169;48841;36672
300;"27.10.2006";3;"13.1";12236;47656;35420
300;"27.10.2006";4;"9.2";12146;47821;35675
300;"27.10.2006";5;"14.3";12833;49368;36535
300;"27.10.2006";6;"28.1";12663;52940;40277
300;"27.10.2006";7;"33.7";12283;61503;49220
300;"27.10.2006";8;"54.3";11894;68998;57104
300;"27.10.2006";9;40;11246;71279;60033
300;"27.10.2006";10;"50.9";10665;70754;60089
300;"27.10.2006";11;"55.7";10386;71479;61093
300;"27.10.2006";12;60;9834;72188;62354
300;"27.10.2006";13;"59.9";9434;70796;61362
300;"27.10.2006";14;"59.2";9333;68886;59553
300;"27.10.2006";15;"48.4";8046;67095;59049
300;"27.10.2006";16;"43.8";6839;65401;58562
300;"27.10.2006";17;"37.7";5627;64176;58549
300;"27.10.2006";18;"44.3";4432;64985;60553
300;"27.10.2006";19;66;3826;68760;64934
300;"27.10.2006";20;"68.8";3495;68249;64754
300;"27.10.2006";21;"63.4";3022;63189;60167
300;"27.10.2006";22;"53.8";2738;59053;56315
300;"27.10.2006";23;"36.9";2535;56000;53465
300;"27.10.2006";24;"32.6";2536;51874;49338
301;"28.10.2006";1;"36.8";2359;48166;45807
301;"28.10.2006";2;"34.1";2482;45656;43174
301;"28.10.2006";3;"32.6";2483;44153;41670
301;"28.10.2006";4;"31.1";2219;43837;41618
301;"28.10.2006";5;"30.9";2356;44490;42134
301;"28.10.2006";6;"25.1";2310;45146;42836
301;"28.10.2006";7;28;2410;47060;44650
301;"28.10.2006";8;"33.4";2248;51156;48908
301;"28.10.2006";9;"42.5";2356;54265;51909
301;"28.10.2006";10;"43.2";1945;56621;54676
301;"28.10.2006";11;"45.7";1841;58294;56453
301;"28.10.2006";12;"51.2";1892;59374;57482
301;"28.10.2006";13;45;2094;57934;55840
301;"28.10.2006";14;43;2244;55501;53257
301;"28.10.2006";15;"41.2";2362;53533;51171
301;"28.10.2006";16;"36.1";2610;52823;50213
301;"28.10.2006";17;34;2929;52977;50048
301;"28.10.2006";18;34;3201;55522;52321
301;"28.10.2006";19;"40.4";4071;59832;55761
301;"28.10.2006";20;"44.9";4830;58668;53838
301;"28.10.2006";21;"39.8";5934;54549;48615
301;"28.10.2006";22;"32.7";6871;51605;44734
301;"28.10.2006";23;"32.2";7707;50469;42762
301;"28.10.2006";24;"22.5";8435;47190;38755
302;"29.10.2006";1;"29.1";9254;44801;35547
302;"29.10.2006";2;"16.1";9497;42224;32727
302;"29.10.2006";3;"10.1";9410;41015;31605
302;"29.10.2006";4;"7.1";10303;41157;30854
302;"29.10.2006";5;"11.1";10670;41648;30978
302;"29.10.2006";6;"6.5";10661;41952;31291
302;"29.10.2006";7;10;10672;43332;32660
302;"29.10.2006";8;"11.1";10613;45821;35208
302;"29.10.2006";9;"21.1";11051;49237;38186
302;"29.10.2006";10;"29.5";11293;51924;40631
302;"29.10.2006";11;"31.1";11413;54192;42779
302;"29.10.2006";12;"33.1";11708;56349;44641
302;"29.10.2006";13;34;11927;54866;42939
302;"29.10.2006";14;"30.1";11978;52100;40122
302;"29.10.2006";15;"24.7";10991;50078;39087
302;"29.10.2006";16;22;9836;49314;39478
302;"29.10.2006";17;"20.3";8353;49904;41551
302;"29.10.2006";18;"34.8";7160;55688;48528
302;"29.10.2006";19;"40.1";5353;57623;52270
302;"29.10.2006";20;"40.1";4025;55121;51096
302;"29.10.2006";21;34;2997;52346;49349
302;"29.10.2006";22;"31.4";2396;50311;47915
302;"29.10.2006";23;"33.1";1516;49868;48352
302;"29.10.2006";24;30;865;46061;45196
303;"30.10.2006";1;25;667;43002;42335
303;"30.10.2006";2;"22.4";664;41600;40936
303;"30.10.2006";3;"22.2";564;41205;40641
303;"30.10.2006";4;"22.2";462;41980;41518
303;"30.10.2006";5;23;345;44171;43826
303;"30.10.2006";6;"29.8";399;47985;47586
303;"30.10.2006";7;45;521;56790;56269
303;"30.10.2006";8;"70.9";637;63060;62423
303;"30.10.2006";9;"69.9";692;65457;64765
303;"30.10.2006";10;"68.6";699;65604;64905
303;"30.10.2006";11;"68.4";713;66255;65542
303;"30.10.2006";12;"69.6";842;67524;66682
303;"30.10.2006";13;"69.9";1054;66631;65577
303;"30.10.2006";14;70;1327;65709;64382
303;"30.10.2006";15;"69.9";1544;64778;63234
303;"30.10.2006";16;70;1989;64207;62218
303;"30.10.2006";17;70;2254;64091;61837
303;"30.10.2006";18;95;2767;69200;66433
303;"30.10.2006";19;"83.3";3360;70424;67064
303;"30.10.2006";20;"77.9";4298;68232;63934
303;"30.10.2006";21;"69.1";4983;63627;58644
303;"30.10.2006";22;"61.2";5690;59658;53968
303;"30.10.2006";23;46;6333;56098;49765
303;"30.10.2006";24;35;6866;51218;44352
304;"31.10.2006";1;"38.5";6908;47562;40654
304;"31.10.2006";2;"30.8";7048;45904;38856
304;"31.10.2006";3;"27.3";7345;45241;37896
304;"31.10.2006";4;"19.1";8052;46195;38143
304;"31.10.2006";5;"19.1";8119;47888;39769
304;"31.10.2006";6;"30.3";8461;50879;42418
304;"31.10.2006";7;"30.9";8609;58024;49415
304;"31.10.2006";8;"51.9";9125;63408;54283
304;"31.10.2006";9;"57.9";9546;65718;56172
304;"31.10.2006";10;"51.9";10193;66103;55910
304;"31.10.2006";11;"55.6";9973;67131;57158
304;"31.10.2006";12;"55.6";10165;68781;58616
304;"31.10.2006";13;"49.6";10634;68233;57599
304;"31.10.2006";14;"49.8";11203;67941;56738
304;"31.10.2006";15;"44.1";11645;67333;55688
304;"31.10.2006";16;39;12048;66766;54718
304;"31.10.2006";17;"44.4";12815;66722;53907
304;"31.10.2006";18;"58.3";12577;70408;57831
304;"31.10.2006";19;52;12766;71138;58372
304;"31.10.2006";20;"48.3";12762;68507;55745
304;"31.10.2006";21;"45.1";13206;64591;51385
304;"31.10.2006";22;"37.1";13809;60829;47020
304;"31.10.2006";23;"33.4";14093;58065;43972
304;"31.10.2006";24;"24.9";13711;53660;39949
305;"01.11.2006";1;"22.1";13609;50934;37325
305;"01.11.2006";2;19;13734;49312;35578
305;"01.11.2006";3;"18.3";14169;48605;34436
305;"01.11.2006";4;"11.1";14734;49371;34637
305;"01.11.2006";5;9;14696;50035;35339
305;"01.11.2006";6;7;14833;50426;35593
305;"01.11.2006";7;"1.1";15546;52084;36538
305;"01.11.2006";8;3;15602;54279;38677
305;"01.11.2006";9;20;15672;56352;40680
305;"01.11.2006";10;29;15401;57954;42553
305;"01.11.2006";11;"30.1";15389;59766;44377
305;"01.11.2006";12;"37.2";15517;62049;46532
305;"01.11.2006";13;40;15375;61390;46015
305;"01.11.2006";14;"33.1";14894;59742;44848
305;"01.11.2006";15;30;13969;58269;44300
305;"01.11.2006";16;"27.1";13421;57636;44215
305;"01.11.2006";17;32;12137;57888;45751
305;"01.11.2006";18;"47.4";11084;63089;52005
305;"01.11.2006";19;"62.4";10260;65114;54854
305;"01.11.2006";20;"63.4";9840;63648;53808
305;"01.11.2006";21;"39.1";8894;59949;51055
305;"01.11.2006";22;"30.4";8277;57563;49286
305;"01.11.2006";23;"32.4";7627;56458;48831
305;"01.11.2006";24;"29.1";6587;52238;45651
306;"02.11.2006";1;29;5729;49441;43712
306;"02.11.2006";2;"22.2";5178;47814;42636
306;"02.11.2006";3;"19.3";4925;46981;42056
306;"02.11.2006";4;21;4482;47079;42597
306;"02.11.2006";5;"20.2";4529;48369;43840
306;"02.11.2006";6;"32.1";4386;51248;46862
306;"02.11.2006";7;37;4497;59129;54632
306;"02.11.2006";8;"57.2";4430;64475;60045
306;"02.11.2006";9;"65.8";3747;66248;62501
306;"02.11.2006";10;"65.9";3188;66347;63159
306;"02.11.2006";11;"68.4";2962;67422;64460
306;"02.11.2006";12;"69.7";2776;68737;65961
306;"02.11.2006";13;"68.2";2667;68523;65856
306;"02.11.2006";14;70;2410;67966;65556
306;"02.11.2006";15;"68.3";2343;66991;64648
306;"02.11.2006";16;"65.9";2605;66644;64039
306;"02.11.2006";17;"64.2";2441;66703;64262
306;"02.11.2006";18;"77.9";2548;71357;68809
306;"02.11.2006";19;"94.9";2695;72466;69771
306;"02.11.2006";20;"74.6";2790;69982;67192
306;"02.11.2006";21;64;2599;65836;63237
306;"02.11.2006";22;"57.9";2694;62257;59563
306;"02.11.2006";23;"42.1";2783;59827;57044
306;"02.11.2006";24;"37.1";2537;54988;52451
307;"03.11.2006";1;"40.1";2597;51682;49085
307;"03.11.2006";2;"35.1";2511;49741;47230
307;"03.11.2006";3;"34.5";2461;49100;46639
307;"03.11.2006";4;32;2456;49278;46822
307;"03.11.2006";5;"32.3";2269;50266;47997
307;"03.11.2006";6;"37.9";2036;52926;50890
307;"03.11.2006";7;"61.2";1790;59953;58163
307;"03.11.2006";8;"72.3";1704;65365;63661
307;"03.11.2006";9;"79.2";1469;67559;66090
307;"03.11.2006";10;"79.8";983;67773;66790
307;"03.11.2006";11;79;868;68396;67528
307;"03.11.2006";12;"77.5";873;69400;68527
307;"03.11.2006";13;"75.1";932;68285;67353
307;"03.11.2006";14;"73.9";1240;67083;65843
307;"03.11.2006";15;"68.3";1396;65880;64484
307;"03.11.2006";16;"64.9";1292;65579;64287
307;"03.11.2006";17;67;1132;65743;64611
307;"03.11.2006";18;95;1181;70513;69332
307;"03.11.2006";19;"82.1";1277;70698;69421
307;"03.11.2006";20;74;1531;68005;66474
307;"03.11.2006";21;70;1664;63511;61847
307;"03.11.2006";22;"62.5";1692;60330;58638
307;"03.11.2006";23;"63.1";1615;58553;56938
307;"03.11.2006";24;41;1677;54758;53081
308;"04.11.2006";1;58;2032;51205;49173
308;"04.11.2006";2;44;2400;49091;46691
308;"04.11.2006";3;"39.1";2666;47654;44988
308;"04.11.2006";4;"34.6";3032;47563;44531
308;"04.11.2006";5;"32.5";3398;47625;44227
308;"04.11.2006";6;"33.2";3758;47189;43431
308;"04.11.2006";7;"30.8";4314;47785;43471
308;"04.11.2006";8;"34.1";4574;50874;46300
308;"04.11.2006";9;"40.9";5020;54315;49295
308;"04.11.2006";10;"49.1";5488;57535;52047
308;"04.11.2006";11;54;5559;58810;53251
308;"04.11.2006";12;"59.9";6000;59605;53605
308;"04.11.2006";13;"45.1";6512;58485;51973
308;"04.11.2006";14;40;7031;56799;49768
308;"04.11.2006";15;"34.6";7756;55833;48077
308;"04.11.2006";16;"32.1";7886;55777;47891
308;"04.11.2006";17;"35.5";7747;56942;49195
308;"04.11.2006";18;"62.2";8241;62034;53793
308;"04.11.2006";19;61;8054;62448;54394
308;"04.11.2006";20;"48.7";8399;59990;51591
308;"04.11.2006";21;"47.3";8514;55977;47463
308;"04.11.2006";22;"34.6";8771;54120;45349
308;"04.11.2006";23;"31.6";6585;53093;46508
308;"04.11.2006";24;"26.1";7905;50600;42695
309;"05.11.2006";1;"31.4";8061;47815;39754
309;"05.11.2006";2;"26.6";8134;45310;37176
309;"05.11.2006";3;"21.6";8332;44055;35723
309;"05.11.2006";4;"20.4";8661;44026;35365
309;"05.11.2006";5;"12.3";9451;44638;35187
309;"05.11.2006";6;"18.1";10202;44451;34249
309;"05.11.2006";7;"7.2";10960;43676;32716
309;"05.11.2006";8;"16.4";11487;45387;33900
309;"05.11.2006";9;"30.1";12034;48735;36701
309;"05.11.2006";10;31;12478;52397;39919
309;"05.11.2006";11;34;13211;55202;41991
309;"05.11.2006";12;"39.5";13475;58054;44579
309;"05.11.2006";13;"36.1";13642;57650;44008
309;"05.11.2006";14;32;13586;55538;41952
309;"05.11.2006";15;30;13448;53778;40330
309;"05.11.2006";16;"20.2";13009;53234;40225
309;"05.11.2006";17;"28.2";12301;54441;42140
309;"05.11.2006";18;"56.9";11547;58824;47277
309;"05.11.2006";19;"59.5";11020;59818;48798
309;"05.11.2006";20;"48.9";10703;58273;47570
309;"05.11.2006";21;"40.1";10292;55716;45424
309;"05.11.2006";22;36;10008;54691;44683
309;"05.11.2006";23;"41.1";9533;54906;45373
309;"05.11.2006";24;"32.2";9348;51137;41789
310;"06.11.2006";1;"29.1";9550;48127;38577
310;"06.11.2006";2;"28.1";9529;46277;36748
310;"06.11.2006";3;27;9465;45963;36498
310;"06.11.2006";4;22;9187;46495;37308
310;"06.11.2006";5;"24.5";8668;48240;39572
310;"06.11.2006";6;"32.8";8388;52024;43636
310;"06.11.2006";7;45;8455;61020;52565
310;"06.11.2006";8;"64.7";8883;67688;58805
310;"06.11.2006";9;"72.9";8917;69533;60616
310;"06.11.2006";10;75;9167;70221;61054
310;"06.11.2006";11;"73.1";9553;71189;61636
310;"06.11.2006";12;"74.5";9650;72457;62807
310;"06.11.2006";13;"72.7";9237;71831;62594
310;"06.11.2006";14;"75.1";8911;71588;62677
310;"06.11.2006";15;"76.6";8530;70622;62092
310;"06.11.2006";16;"69.6";8309;69841;61532
310;"06.11.2006";17;"69.6";7807;70025;62218
310;"06.11.2006";18;96;7350;73635;66285
310;"06.11.2006";19;"107.4";6763;73622;66859
310;"06.11.2006";20;"90.9";6022;71107;65085
310;"06.11.2006";21;"70.6";5731;66678;60947
310;"06.11.2006";22;"58.9";5219;63531;58312
310;"06.11.2006";23;"56.1";5088;60744;55656
310;"06.11.2006";24;"40.3";4907;55563;50656
311;"07.11.2006";1;33;4685;51651;46966
311;"07.11.2006";2;32;4720;49723;45003
311;"07.11.2006";3;31;4544;49101;44557
311;"07.11.2006";4;"31.3";4494;49585;45091
311;"07.11.2006";5;"32.1";4352;51143;46791
311;"07.11.2006";6;"38.6";4116;54236;50120
311;"07.11.2006";7;"58.9";3998;61478;57480
311;"07.11.2006";8;78;3959;67248;63289
311;"07.11.2006";9;"79.1";4109;68913;64804
311;"07.11.2006";10;82;4221;68528;64307
311;"07.11.2006";11;78;4299;69094;64795
311;"07.11.2006";12;"75.5";4272;69932;65660
311;"07.11.2006";13;"76.8";4151;69249;65098
311;"07.11.2006";14;78;3888;68542;64654
311;"07.11.2006";15;73;3414;67347;63933
311;"07.11.2006";16;"74.7";2702;66853;64151
311;"07.11.2006";17;"67.4";2511;67333;64822
311;"07.11.2006";18;100;2682;72228;69546
311;"07.11.2006";19;"2436.6";2728;71790;69062
311;"07.11.2006";20;95;2749;69838;67089
311;"07.11.2006";21;"79.2";2632;65788;63156
311;"07.11.2006";22;"65.9";2427;62631;60204
311;"07.11.2006";23;"54.1";2137;59834;57697
311;"07.11.2006";24;44;2313;55079;52766
312;"08.11.2006";1;"37.9";2664;51176;48512
312;"08.11.2006";2;"34.5";2585;49415;46830
312;"08.11.2006";3;30;2949;48725;45776
312;"08.11.2006";4;"25.6";3084;49212;46128
312;"08.11.2006";5;"29.1";3747;50773;47026
312;"08.11.2006";6;"40.6";4181;53673;49492
312;"08.11.2006";7;"52.4";4513;61100;56587
312;"08.11.2006";8;"70.6";5036;66735;61699
312;"08.11.2006";9;"79.9";5279;67917;62638
312;"08.11.2006";10;"77.9";5404;67729;62325
312;"08.11.2006";11;"75.4";5523;68578;63055
312;"08.11.2006";12;"74.6";5963;69806;63843
312;"08.11.2006";13;"70.6";6895;69429;62534
312;"08.11.2006";14;"73.5";7177;68909;61732
312;"08.11.2006";15;"68.6";7683;68325;60642
312;"08.11.2006";16;"63.1";7611;67960;60349
312;"08.11.2006";17;"58.6";8375;69015;60640
312;"08.11.2006";18;67;8734;73451;64717
312;"08.11.2006";19;"66.5";9794;72892;63098
312;"08.11.2006";20;"62.1";10879;70859;59980
312;"08.11.2006";21;"66.1";11680;67462;55782
312;"08.11.2006";22;"42.1";12335;64593;52258
312;"08.11.2006";23;33;12539;61727;49188
312;"08.11.2006";24;"27.6";12430;56817;44387
313;"09.11.2006";1;"36.3";12562;53262;40700
313;"09.11.2006";2;"32.3";12497;51039;38542
313;"09.11.2006";3;"30.1";12425;49993;37568
313;"09.11.2006";4;"25.6";12336;50229;37893
313;"09.11.2006";5;"22.2";11591;51366;39775
313;"09.11.2006";6;"32.9";10965;54813;43848
313;"09.11.2006";7;"45.1";11402;63261;51859
313;"09.11.2006";8;"70.5";10701;69204;58503
313;"09.11.2006";9;"69.8";10261;70752;60491
313;"09.11.2006";10;"67.9";10312;70701;60389
313;"09.11.2006";11;"70.5";11285;71849;60564
313;"09.11.2006";12;73;11907;73182;61275
313;"09.11.2006";13;67;12206;72315;60109
313;"09.11.2006";14;"68.7";12561;71767;59206
313;"09.11.2006";15;65;12233;70511;58278
313;"09.11.2006";16;"59.6";11584;70049;58465
313;"09.11.2006";17;"58.9";10803;69986;59183
313;"09.11.2006";18;"79.3";10417;74006;63589
313;"09.11.2006";19;"92.2";10396;74395;63999
313;"09.11.2006";20;"69.9";10647;72073;61426
313;"09.11.2006";21;62;10573;68325;57752
313;"09.11.2006";22;"51.9";10271;64912;54641
313;"09.11.2006";23;"52.8";9368;62033;52665
313;"09.11.2006";24;"42.3";8772;57160;48388
314;"10.11.2006";1;"27.3";7900;53490;45590
314;"10.11.2006";2;"32.1";6991;51611;44620
314;"10.11.2006";3;"30.3";6093;50529;44436
314;"10.11.2006";4;"27.7";5559;50965;45406
314;"10.11.2006";5;30;4834;51850;47016
314;"10.11.2006";6;"37.9";4147;54068;49921
314;"10.11.2006";7;"60.9";3577;60849;57272
314;"10.11.2006";8;78;2881;66205;63324
314;"10.11.2006";9;86;2535;67294;64759
314;"10.11.2006";10;"87.9";2022;66727;64705
314;"10.11.2006";11;87;1604;67478;65874
314;"10.11.2006";12;"89.4";1470;67947;66477
314;"10.11.2006";13;86;1612;67236;65624
314;"10.11.2006";14;78;1808;66288;64480
314;"10.11.2006";15;"75.5";1937;65067;63130
314;"10.11.2006";16;"75.1";1678;64665;62987
314;"10.11.2006";17;"76.8";1845;66295;64450
314;"10.11.2006";18;99;2372;70971;68599
314;"10.11.2006";19;"89.8";2824;70661;67837
314;"10.11.2006";20;"79.9";3106;67954;64848
314;"10.11.2006";21;"72.1";3323;63818;60495
314;"10.11.2006";22;"66.7";3810;60567;56757
314;"10.11.2006";23;"53.7";4181;59183;55002
314;"10.11.2006";24;"39.1";4575;54990;50415
315;"11.11.2006";1;"36.4";4959;51042;46083
315;"11.11.2006";2;"34.1";5515;48885;43370
315;"11.11.2006";3;"32.1";6182;47697;41515
315;"11.11.2006";4;30;7160;48049;40889
315;"11.11.2006";5;"23.9";7495;48054;40559
315;"11.11.2006";6;"29.5";8037;47748;39711
315;"11.11.2006";7;"24.1";8847;48254;39407
315;"11.11.2006";8;"28.4";9274;51250;41976
315;"11.11.2006";9;33;9848;55069;45221
315;"11.11.2006";10;"36.8";10199;58672;48473
315;"11.11.2006";11;"40.1";10097;60793;50696
315;"11.11.2006";12;40;10277;62239;51962
315;"11.11.2006";13;"42.1";11240;61540;50300
315;"11.11.2006";14;41;11509;59984;48475
315;"11.11.2006";15;"33.6";11568;58403;46835
315;"11.11.2006";16;"30.1";11280;58061;46781
315;"11.11.2006";17;"30.1";11479;59348;47869
315;"11.11.2006";18;"38.1";11989;62782;50793
315;"11.11.2006";19;40;12858;62527;49669
315;"11.11.2006";20;"32.1";13294;60031;46737
315;"11.11.2006";21;31;13445;56996;43551
315;"11.11.2006";22;"29.6";13878;55096;41218
315;"11.11.2006";23;"30.1";13625;55288;41663
315;"11.11.2006";24;"22.1";12915;52350;39435
316;"12.11.2006";1;"19.4";12460;48548;36088
316;"12.11.2006";2;"3.8";11626;45667;34041
316;"12.11.2006";3;"2.3";11783;44535;32752
316;"12.11.2006";4;"4.7";11166;43883;32717
316;"12.11.2006";5;1;10999;44401;33402
316;"12.11.2006";6;"5.7";11335;43995;32660
316;"12.11.2006";7;5;11550;42905;31355
316;"12.11.2006";8;"14.3";11672;43929;32257
316;"12.11.2006";9;"22.8";11866;47051;35185
316;"12.11.2006";10;"29.5";12405;50608;38203
316;"12.11.2006";11;34;12656;53581;40925
316;"12.11.2006";12;38;13103;56364;43261
316;"12.11.2006";13;"38.2";13091;55647;42556
316;"12.11.2006";14;"31.9";13764;53922;40158
316;"12.11.2006";15;"29.6";13417;52124;38707
316;"12.11.2006";16;"22.4";12929;51545;38616
316;"12.11.2006";17;23;12579;53291;40712
316;"12.11.2006";18;"47.1";12531;58450;45919
316;"12.11.2006";19;"46.7";12059;59570;47511
316;"12.11.2006";20;"45.1";11749;58298;46549
316;"12.11.2006";21;"42.1";10782;55837;45055
316;"12.11.2006";22;34;9966;54859;44893
316;"12.11.2006";23;"37.9";9190;55585;46395
316;"12.11.2006";24;"32.4";8434;51925;43491
317;"13.11.2006";1;"27.5";7836;48670;40834
317;"13.11.2006";2;"22.8";7071;46682;39611
317;"13.11.2006";3;"21.4";6431;45592;39161
317;"13.11.2006";4;"21.5";6107;45930;39823
317;"13.11.2006";5;"22.1";6112;47431;41319
317;"13.11.2006";6;"29.3";6695;51069;44374
317;"13.11.2006";7;"40.1";7144;59541;52397
317;"13.11.2006";8;"67.9";7541;66935;59394
317;"13.11.2006";9;"74.2";8294;69369;61075
317;"13.11.2006";10;"73.9";8872;69946;61074
317;"13.11.2006";11;"71.9";9797;71298;61501
317;"13.11.2006";12;72;10930;72840;61910
317;"13.11.2006";13;"71.3";11955;72577;60622
317;"13.11.2006";14;72;12555;72866;60311
317;"13.11.2006";15;"68.1";13062;72369;59307
317;"13.11.2006";16;65;13488;72509;59021
317;"13.11.2006";17;66;13316;73122;59806
317;"13.11.2006";18;"75.5";13523;75182;61659
317;"13.11.2006";19;"88.1";13186;74523;61337
317;"13.11.2006";20;"68.1";12619;72100;59481
317;"13.11.2006";21;64;11736;67848;56112
317;"13.11.2006";22;"55.2";10626;64429;53803
317;"13.11.2006";23;"47.5";9783;61421;51638
317;"13.11.2006";24;"32.7";9117;56066;46949
318;"14.11.2006";1;"29.7";8766;51909;43143
318;"14.11.2006";2;"27.1";8453;49395;40942
318;"14.11.2006";3;"26.7";7762;48254;40492
318;"14.11.2006";4;"18.3";7412;48551;41139
318;"14.11.2006";5;"22.1";7304;50125;42821
318;"14.11.2006";6;"29.9";6940;53265;46325
318;"14.11.2006";7;"33.4";7075;60629;53554
318;"14.11.2006";8;"65.9";7242;67374;60132
318;"14.11.2006";9;64;7778;69353;61575
318;"14.11.2006";10;"64.4";7996;69676;61680
318;"14.11.2006";11;"66.1";8248;71085;62837
318;"14.11.2006";12;67;8214;72396;64182
318;"14.11.2006";13;"64.1";8220;71786;63566
318;"14.11.2006";14;68;7452;71068;63616
318;"14.11.2006";15;"73.4";6685;70078;63393
318;"14.11.2006";16;"71.1";5920;69448;63528
318;"14.11.2006";17;"72.3";5373;70360;64987
318;"14.11.2006";18;"87.1";5316;73750;68434
318;"14.11.2006";19;85;5333;72937;67604
318;"14.11.2006";20;"80.2";5047;70505;65458
318;"14.11.2006";21;"65.3";4883;66047;61164
318;"14.11.2006";22;"44.9";4962;62671;57709
318;"14.11.2006";23;38;5313;59813;54500
318;"14.11.2006";24;34;5365;54459;49094
319;"15.11.2006";1;"30.5";5973;50336;44363
319;"15.11.2006";2;"27.6";6480;47973;41493
319;"15.11.2006";3;"20.2";6618;47793;41175
319;"15.11.2006";4;"21.1";7132;49064;41932
319;"15.11.2006";5;"20.1";7518;51050;43532
319;"15.11.2006";6;"28.8";7720;54689;46969
319;"15.11.2006";7;"29.1";7895;62305;54410
319;"15.11.2006";8;"58.1";7393;68170;60777
319;"15.11.2006";9;"56.4";7359;69415;62056
319;"15.11.2006";10;58;6584;68545;61961
319;"15.11.2006";11;"61.3";6311;68739;62428
319;"15.11.2006";12;"66.4";5909;69376;63467
319;"15.11.2006";13;"66.1";5394;68666;63272
319;"15.11.2006";14;"69.1";4647;68058;63411
319;"15.11.2006";15;68;3695;66966;63271
319;"15.11.2006";16;70;3087;66377;63290
319;"15.11.2006";17;"75.5";3349;67766;64417
319;"15.11.2006";18;"89.3";4512;72885;68373
319;"15.11.2006";19;"76.1";5028;72722;67694
319;"15.11.2006";20;"67.7";5182;70145;64963
319;"15.11.2006";21;"61.2";5461;65918;60457
319;"15.11.2006";22;"42.9";6136;62873;56737
319;"15.11.2006";23;42;6260;59738;53478
319;"15.11.2006";24;"30.1";6576;54668;48092
320;"16.11.2006";1;"28.8";6760;50400;43640
320;"16.11.2006";2;"22.8";7027;48397;41370
320;"16.11.2006";3;"16.1";7416;47659;40243
320;"16.11.2006";4;"12.7";7632;48339;40707
320;"16.11.2006";5;18;7813;50367;42554
320;"16.11.2006";6;"29.1";7943;53398;45455
320;"16.11.2006";7;"29.6";7952;60654;52702
320;"16.11.2006";8;"60.1";8155;67011;58856
320;"16.11.2006";9;"60.1";7909;67899;59990
320;"16.11.2006";10;"54.7";6883;67247;60364
320;"16.11.2006";11;"60.1";6343;67666;61323
320;"16.11.2006";12;"59.5";6259;68434;62175
320;"16.11.2006";13;58;6002;67536;61534
320;"16.11.2006";14;60;5401;66988;61587
320;"16.11.2006";15;"58.4";5240;66192;60952
320;"16.11.2006";16;"53.3";5299;66168;60869
320;"16.11.2006";17;50;5761;67692;61931
320;"16.11.2006";18;"72.1";7007;72945;65938
320;"16.11.2006";19;"72.1";7822;72861;65039
320;"16.11.2006";20;"59.7";8090;70795;62705
320;"16.11.2006";21;"46.3";8134;66471;58337
320;"16.11.2006";22;"36.4";7446;62519;55073
320;"16.11.2006";23;"32.6";7505;59640;52135
320;"16.11.2006";24;"28.2";6951;54141;47190
321;"17.11.2006";1;"29.2";6760;49760;43000
321;"17.11.2006";2;"23.9";6126;47719;41593
321;"17.11.2006";3;"21.7";5742;47046;41304
321;"17.11.2006";4;"20.2";5570;47359;41789
321;"17.11.2006";5;"24.8";5229;49165;43936
321;"17.11.2006";6;"30.9";4744;52145;47401
321;"17.11.2006";7;"35.6";4379;59797;55418
321;"17.11.2006";8;"62.1";4154;66952;62798
321;"17.11.2006";9;70;3932;68774;64842
321;"17.11.2006";10;67;3677;68589;64912
321;"17.11.2006";11;"65.9";3621;69324;65703
321;"17.11.2006";12;"68.5";3378;69982;66604
321;"17.11.2006";13;"58.7";3118;68973;65855
321;"17.11.2006";14;56;3573;67654;64081
321;"17.11.2006";15;"46.1";3638;66141;62503
321;"17.11.2006";16;"42.4";3904;65560;61656
321;"17.11.2006";17;"49.8";3402;67270;63868
321;"17.11.2006";18;"66.9";3515;71690;68175
321;"17.11.2006";19;"62.1";3654;70950;67296
321;"17.11.2006";20;"51.6";3889;67930;64041
321;"17.11.2006";21;"46.9";4127;63457;59330
321;"17.11.2006";22;"33.4";4340;59957;55617
321;"17.11.2006";23;"44.1";4773;58254;53481
321;"17.11.2006";24;"31.1";5122;53796;48674
322;"18.11.2006";1;"27.2";5338;49611;44273
322;"18.11.2006";2;"29.8";5300;47228;41928
322;"18.11.2006";3;"22.1";5592;45924;40332
322;"18.11.2006";4;"17.3";5507;46320;40813
322;"18.11.2006";5;"18.1";5143;47027;41884
322;"18.11.2006";6;"20.1";5186;47019;41833
322;"18.11.2006";7;"21.1";5024;47225;42201
322;"18.11.2006";8;31;4524;50727;46203
322;"18.11.2006";9;"33.3";4098;54058;49960
322;"18.11.2006";10;39;3510;56606;53096
322;"18.11.2006";11;"48.2";3340;58183;54843
322;"18.11.2006";12;"48.8";3060;59055;55995
322;"18.11.2006";13;40;2972;57531;54559
322;"18.11.2006";14;35;2797;55557;52760
322;"18.11.2006";15;"32.1";2705;53917;51212
322;"18.11.2006";16;"31.4";2447;53880;51433
322;"18.11.2006";17;"53.3";2551;56329;53778
322;"18.11.2006";18;"63.1";2901;61554;58653
322;"18.11.2006";19;63;2958;61230;58272
322;"18.11.2006";20;"60.7";3168;58539;55371
322;"18.11.2006";21;"46.1";3132;54519;51387
322;"18.11.2006";22;"31.1";3003;52699;49696
322;"18.11.2006";23;"36.1";2722;52042;49320
322;"18.11.2006";24;34;2472;48629;46157
323;"19.11.2006";1;29;2113;44922;42809
323;"19.11.2006";2;"27.9";1951;42365;40414
323;"19.11.2006";3;"21.1";1664;40967;39303
323;"19.11.2006";4;"14.1";1505;41159;39654
323;"19.11.2006";5;8;1428;41519;40091
323;"19.11.2006";6;"15.1";1448;40741;39293
323;"19.11.2006";7;"10.4";1615;39603;37988
323;"19.11.2006";8;10;1783;41026;39243
323;"19.11.2006";9;"22.1";1914;43846;41932
323;"19.11.2006";10;"30.1";1873;47242;45369
323;"19.11.2006";11;33;1880;50537;48657
323;"19.11.2006";12;"36.2";2063;53628;51565
323;"19.11.2006";13;40;2290;53116;50826
323;"19.11.2006";14;"33.6";2491;51174;48683
323;"19.11.2006";15;31;2838;49934;47096
323;"19.11.2006";16;19;3094;50354;47260
323;"19.11.2006";17;"25.5";3476;53150;49674
323;"19.11.2006";18;"38.4";3539;56750;53211
323;"19.11.2006";19;"44.6";3884;57835;53951
323;"19.11.2006";20;"43.5";3971;56083;52112
323;"19.11.2006";21;"42.5";4046;54097;50051
323;"19.11.2006";22;"35.1";3822;53151;49329
323;"19.11.2006";23;"38.6";4112;53655;49543
323;"19.11.2006";24;"32.4";4248;49746;45498
324;"20.11.2006";1;22;4686;46436;41750
324;"20.11.2006";2;19;4765;44735;39970
324;"20.11.2006";3;17;4792;44197;39405
324;"20.11.2006";4;16;5051;45160;40109
324;"20.11.2006";5;"17.1";5386;47277;41891
324;"20.11.2006";6;"22.1";5641;50823;45182
324;"20.11.2006";7;"33.9";6419;59705;53286
324;"20.11.2006";8;58;7069;66988;59919
324;"20.11.2006";9;"62.8";7892;68866;60974
324;"20.11.2006";10;"64.2";8362;68987;60625
324;"20.11.2006";11;63;8696;69556;60860
324;"20.11.2006";12;65;9218;70865;61647
324;"20.11.2006";13;"63.9";9556;70539;60983
324;"20.11.2006";14;65;9787;70118;60331
324;"20.11.2006";15;64;9460;69395;59935
324;"20.11.2006";16;"64.1";9164;69526;60362
324;"20.11.2006";17;"64.1";9649;71564;61915
324;"20.11.2006";18;"70.3";10068;74562;64494
324;"20.11.2006";19;"70.3";10484;73828;63344
324;"20.11.2006";20;"63.9";10365;71721;61356
324;"20.11.2006";21;52;10180;67444;57264
324;"20.11.2006";22;"43.4";9913;64033;54120
324;"20.11.2006";23;"34.1";9590;61211;51621
324;"20.11.2006";24;30;9052;56156;47104
325;"21.11.2006";1;"29.1";8821;52456;43635
325;"21.11.2006";2;"30.4";8278;50224;41946
325;"21.11.2006";3;"28.1";7928;49160;41232
325;"21.11.2006";4;"28.3";7629;49546;41917
325;"21.11.2006";5;"28.5";7010;50481;43471
325;"21.11.2006";6;34;6397;53278;46881
325;"21.11.2006";7;"52.6";6298;60777;54479
325;"21.11.2006";8;"82.9";5741;67700;61959
325;"21.11.2006";9;"85.4";5449;69466;64017
325;"21.11.2006";10;75;5659;69484;63825
325;"21.11.2006";11;"87.1";5565;70188;64623
325;"21.11.2006";12;85;5423;71123;65700
325;"21.11.2006";13;"84.9";5255;70283;65028
325;"21.11.2006";14;"83.5";5086;69890;64804
325;"21.11.2006";15;"85.1";4399;69337;64938
325;"21.11.2006";16;"75.1";3651;69107;65456
325;"21.11.2006";17;"92.2";3474;70302;66828
325;"21.11.2006";18;150;3189;73691;70502
325;"21.11.2006";19;"125.1";3218;72805;69587
325;"21.11.2006";20;96;3018;70174;67156
325;"21.11.2006";21;"76.4";3010;66025;63015
325;"21.11.2006";22;"58.1";3169;62881;59712
325;"21.11.2006";23;"63.3";3121;60316;57195
325;"21.11.2006";24;49;2839;54851;52012
326;"22.11.2006";1;"31.1";2797;50689;47892
326;"22.11.2006";2;"28.2";3076;48689;45613
326;"22.11.2006";3;"27.9";3103;48181;45078
326;"22.11.2006";4;"27.6";3193;49001;45808
326;"22.11.2006";5;"28.4";3349;50473;47124
326;"22.11.2006";6;"28.5";3474;53043;49569
326;"22.11.2006";7;"30.6";3741;59744;56003
326;"22.11.2006";8;58;4000;66504;62504
326;"22.11.2006";9;"75.1";4166;68155;63989
326;"22.11.2006";10;75;4203;68337;64134
326;"22.11.2006";11;75;4250;69154;64904
326;"22.11.2006";12;75;4308;70331;66023
326;"22.11.2006";13;"72.1";4652;69830;65178
326;"22.11.2006";14;70;4705;69375;64670
326;"22.11.2006";15;"70.8";4584;68662;64078
326;"22.11.2006";16;72;4170;68211;64041
326;"22.11.2006";17;70;4402;69901;65499
326;"22.11.2006";18;"79.8";4658;73241;68583
326;"22.11.2006";19;"82.1";5052;72794;67742
326;"22.11.2006";20;"70.5";5392;70457;65065
326;"22.11.2006";21;"61.3";5397;66201;60804
326;"22.11.2006";22;"44.1";5561;63060;57499
326;"22.11.2006";23;"37.5";5595;60877;55282
326;"22.11.2006";24;"30.3";5851;55987;50136
327;"23.11.2006";1;"29.9";6031;52302;46271
327;"23.11.2006";2;"27.3";6353;50436;44083
327;"23.11.2006";3;"23.6";6739;49666;42927
327;"23.11.2006";4;"28.1";7517;50493;42976
327;"23.11.2006";5;"23.6";8027;51590;43563
327;"23.11.2006";6;"28.5";8607;54332;45725
327;"23.11.2006";7;"31.1";9028;61419;52391
327;"23.11.2006";8;"61.3";9065;68170;59105
327;"23.11.2006";9;"64.9";9587;69990;60403
327;"23.11.2006";10;"58.1";10326;70292;59966
327;"23.11.2006";11;"58.1";11074;71583;60509
327;"23.11.2006";12;63;11742;73247;61505
327;"23.11.2006";13;58;12022;72587;60565
327;"23.11.2006";14;58;11888;72436;60548
327;"23.11.2006";15;"52.9";11705;71819;60114
327;"23.11.2006";16;"50.5";11318;71779;60461
327;"23.11.2006";17;"53.7";10558;72851;62293
327;"23.11.2006";18;"64.1";9540;75032;65492
327;"23.11.2006";19;"67.9";8813;73958;65145
327;"23.11.2006";20;"61.1";7885;71288;63403
327;"23.11.2006";21;"51.4";7267;67040;59773
327;"23.11.2006";22;"33.8";6994;63469;56475
327;"23.11.2006";23;"32.9";7183;61012;53829
327;"23.11.2006";24;24;7296;56107;48811
328;"24.11.2006";1;"28.5";7127;51448;44321
328;"24.11.2006";2;"24.1";6905;48684;41779
328;"24.11.2006";3;"18.1";6760;47849;41089
328;"24.11.2006";4;"16.1";6768;48606;41838
328;"24.11.2006";5;"16.1";6821;50216;43395
328;"24.11.2006";6;"28.1";6895;53493;46598
328;"24.11.2006";7;"31.6";6965;61107;54142
328;"24.11.2006";8;"46.4";6645;68031;61386
328;"24.11.2006";9;"58.1";6106;68843;62737
328;"24.11.2006";10;"67.5";5071;68173;63102
328;"24.11.2006";11;"67.5";4335;68841;64506
328;"24.11.2006";12;70;3378;69653;66275
328;"24.11.2006";13;"67.6";3241;68822;65581
328;"24.11.2006";14;65;2884;67787;64903
328;"24.11.2006";15;62;2881;66613;63732
328;"24.11.2006";16;55;3188;66651;63463
328;"24.11.2006";17;"63.2";4177;69447;65270
328;"24.11.2006";18;"71.5";5388;72550;67162
328;"24.11.2006";19;70;5919;71342;65423
328;"24.11.2006";20;57;6182;68446;62264
328;"24.11.2006";21;"37.2";6310;64107;57797
328;"24.11.2006";22;"32.3";6300;60859;54559
328;"24.11.2006";23;"32.2";6588;59129;52541
328;"24.11.2006";24;"29.3";6663;54288;47625
329;"25.11.2006";1;"28.7";6836;50551;43715
329;"25.11.2006";2;"22.1";6886;47904;41018
329;"25.11.2006";3;"20.2";6972;46274;39302
329;"25.11.2006";4;"9.1";7835;46798;38963
329;"25.11.2006";5;"11.1";8527;47717;39190
329;"25.11.2006";6;"15.6";9149;47510;38361
329;"25.11.2006";7;"9.1";9684;48579;38895
329;"25.11.2006";8;17;9979;52464;42485
329;"25.11.2006";9;"26.1";10204;56011;45807
329;"25.11.2006";10;33;10480;58861;48381
329;"25.11.2006";11;"32.1";10108;60098;49990
329;"25.11.2006";12;33;10364;60678;50314
329;"25.11.2006";13;"35.4";10608;59152;48544
329;"25.11.2006";14;"31.7";10363;57493;47130
329;"25.11.2006";15;"29.9";9833;55555;45722
329;"25.11.2006";16;30;9332;55933;46601
329;"25.11.2006";17;"30.1";9380;59157;49777
329;"25.11.2006";18;"37.8";9932;62953;53021
329;"25.11.2006";19;"39.1";10380;62548;52168
329;"25.11.2006";20;"36.7";10454;59805;49351
329;"25.11.2006";21;33;10235;56013;45778
329;"25.11.2006";22;30;9659;54009;44350
329;"25.11.2006";23;"33.6";9025;53820;44795
329;"25.11.2006";24;"29.9";8251;49833;41582
330;"26.11.2006";1;"21.3";7205;45288;38083
330;"26.11.2006";2;15;5780;42405;36625
330;"26.11.2006";3;10;5098;40865;35767
330;"26.11.2006";4;"10.6";4589;40541;35952
330;"26.11.2006";5;"13.6";4232;41382;37150
330;"26.11.2006";6;"15.9";3914;41001;37087
330;"26.11.2006";7;"8.1";3513;39819;36306
330;"26.11.2006";8;"18.5";3280;41903;38623
330;"26.11.2006";9;"21.7";2992;44644;41652
330;"26.11.2006";10;28;2902;47571;44669
330;"26.11.2006";11;32;2680;49774;47094
330;"26.11.2006";12;"36.8";2379;52691;50312
330;"26.11.2006";13;"35.5";2047;51715;49668
330;"26.11.2006";14;"32.6";1867;49381;47514
330;"26.11.2006";15;"28.6";1672;47662;45990
330;"26.11.2006";16;"27.1";1678;47348;45670
330;"26.11.2006";17;"36.2";2174;50598;48424
330;"26.11.2006";18;"56.2";2699;56352;53653
330;"26.11.2006";19;"48.5";3160;57499;54339
330;"26.11.2006";20;"45.1";3471;56041;52570
330;"26.11.2006";21;"35.1";3662;54151;50489
330;"26.11.2006";22;"33.5";3608;53255;49647
330;"26.11.2006";23;"36.1";3268;53494;50226
330;"26.11.2006";24;"33.1";3122;49491;46369
331;"27.11.2006";1;"28.7";2738;45958;43220
331;"27.11.2006";2;"27.5";2499;44113;41614
331;"27.11.2006";3;"27.1";2317;43749;41432
331;"27.11.2006";4;"25.1";2084;44795;42711
331;"27.11.2006";5;"27.8";2086;46594;44508
331;"27.11.2006";6;"29.8";2111;50274;48163
331;"27.11.2006";7;34;2212;58851;56639
331;"27.11.2006";8;62;2505;66718;64213
331;"27.11.2006";9;"73.3";2927;68431;65504
331;"27.11.2006";10;70;2958;68229;65271
331;"27.11.2006";11;"70.2";2848;68818;65970
331;"27.11.2006";12;"70.2";2610;69783;67173
331;"27.11.2006";13;73;2177;69125;66948
331;"27.11.2006";14;"72.9";2066;68752;66686
331;"27.11.2006";15;"70.1";2162;67914;65752
331;"27.11.2006";16;"70.2";2366;67791;65425
331;"27.11.2006";17;"74.9";3138;70382;67244
331;"27.11.2006";18;"91.7";3551;74105;70554
331;"27.11.2006";19;"76.1";4021;73488;69467
331;"27.11.2006";20;"70.1";4116;70933;66817
331;"27.11.2006";21;"61.2";4094;66550;62456
331;"27.11.2006";22;"44.8";3797;62803;59006
331;"27.11.2006";23;"38.7";3617;59933;56316
331;"27.11.2006";24;31;3561;54419;50858
332;"28.11.2006";1;29;3800;50409;46609
332;"28.11.2006";2;"34.4";3666;48315;44649
332;"28.11.2006";3;"27.3";3370;47277;43907
332;"28.11.2006";4;"27.7";3057;48327;45270
332;"28.11.2006";5;"29.1";2862;50064;47202
332;"28.11.2006";6;"29.9";2909;53176;50267
332;"28.11.2006";7;"38.9";3122;60918;57796
332;"28.11.2006";8;"66.4";3190;68313;65123
332;"28.11.2006";9;70;3497;69693;66196
332;"28.11.2006";10;"67.5";3494;69255;65761
332;"28.11.2006";11;"67.5";3158;69917;66759
332;"28.11.2006";12;"64.9";2643;70797;68154
332;"28.11.2006";13;"66.9";2310;69927;67617
332;"28.11.2006";14;67;2179;69410;67231
332;"28.11.2006";15;"67.5";2366;68741;66375
332;"28.11.2006";16;"69.8";2699;68487;65788
332;"28.11.2006";17;"64.1";3504;70910;67406
332;"28.11.2006";18;70;4099;74619;70520
332;"28.11.2006";19;67;4421;74164;69743
332;"28.11.2006";20;61;4300;71446;67146
332;"28.11.2006";21;47;3784;66761;62977
332;"28.11.2006";22;37;3490;63287;59797
332;"28.11.2006";23;"33.8";3647;60573;56926
332;"28.11.2006";24;29;3434;55172;51738
333;"29.11.2006";1;"28.8";2989;50872;47883
333;"29.11.2006";2;"27.6";2796;48728;45932
333;"29.11.2006";3;"27.1";2708;47877;45169
333;"29.11.2006";4;"26.3";2497;48682;46185
333;"29.11.2006";5;"27.9";2497;50278;47781
333;"29.11.2006";6;"32.4";2558;53576;51018
333;"29.11.2006";7;"32.4";2451;61142;58691
333;"29.11.2006";8;"69.9";2214;68526;66312
333;"29.11.2006";9;"64.9";2211;69872;67661
333;"29.11.2006";10;"65.7";2031;69699;67668
333;"29.11.2006";11;"69.9";2070;70523;68453
333;"29.11.2006";12;"69.1";2085;71914;69829
333;"29.11.2006";13;"69.1";2005;70972;68967
333;"29.11.2006";14;70;2167;70629;68462
333;"29.11.2006";15;"68.3";1982;69906;67924
333;"29.11.2006";16;"65.1";1885;69870;67985
333;"29.11.2006";17;"70.6";1950;71651;69701
333;"29.11.2006";18;"72.6";2085;74497;72412
333;"29.11.2006";19;"70.4";2199;73692;71493
333;"29.11.2006";20;"70.7";2459;71594;69135
333;"29.11.2006";21;"64.9";2581;67259;64678
333;"29.11.2006";22;"56.9";2808;63789;60981
333;"29.11.2006";23;"52.4";2876;61071;58195
333;"29.11.2006";24;"34.8";2829;55494;52665
334;"30.11.2006";1;"34.1";2818;51521;48703
334;"30.11.2006";2;29;2684;49411;46727
334;"30.11.2006";3;"27.7";2666;48625;45959
334;"30.11.2006";4;"27.3";2621;49286;46665
334;"30.11.2006";5;"27.3";2498;50911;48413
334;"30.11.2006";6;"32.9";2280;53749;51469
334;"30.11.2006";7;"42.8";2094;60965;58871
334;"30.11.2006";8;"70.5";1995;68475;66480
334;"30.11.2006";9;"66.6";1952;69979;68027
334;"30.11.2006";10;"69.1";1919;69651;67732
334;"30.11.2006";11;"69.1";1750;70046;68296
334;"30.11.2006";12;"67.6";1609;70774;69165
334;"30.11.2006";13;69;1560;69903;68343
334;"30.11.2006";14;"69.9";1300;69353;68053
334;"30.11.2006";15;"70.2";1250;68838;67588
334;"30.11.2006";16;69;1108;68558;67450
334;"30.11.2006";17;"73.1";1545;70762;69217
334;"30.11.2006";18;"73.4";2110;73614;71504
334;"30.11.2006";19;"74.1";2698;72981;70283
334;"30.11.2006";20;67;3565;71263;67698
334;"30.11.2006";21;"58.1";4142;67556;63414
334;"30.11.2006";22;39;4338;64745;60407
334;"30.11.2006";23;"35.1";4394;62200;57806
334;"30.11.2006";24;"28.5";4653;57082;52429
335;"01.12.2006";1;"29.1";5175;52798;47623
335;"01.12.2006";2;29;4836;50555;45719
335;"01.12.2006";3;"27.2";4625;49466;44841
335;"01.12.2006";4;"22.1";4604;49810;45206
335;"01.12.2006";5;"22.3";4717;51150;46433
335;"01.12.2006";6;"27.9";5104;53896;48792
335;"01.12.2006";7;"31.1";5698;61380;55682
335;"01.12.2006";8;58;6223;68918;62695
335;"01.12.2006";9;"52.6";6430;69977;63547
335;"01.12.2006";10;"52.6";6473;69772;63299
335;"01.12.2006";11;"52.6";6067;70181;64114
335;"01.12.2006";12;"58.7";5927;70415;64488
335;"01.12.2006";13;"57.6";6032;69703;63671
335;"01.12.2006";14;53;5264;68294;63030
335;"01.12.2006";15;"41.6";4861;67057;62196
335;"01.12.2006";16;"37.2";5301;66825;61524
335;"01.12.2006";17;52;5671;69049;63378
335;"01.12.2006";18;"60.1";6443;72760;66317
335;"01.12.2006";19;60;6784;72339;65555
335;"01.12.2006";20;"51.1";6786;69380;62594
335;"01.12.2006";21;"36.1";6297;65252;58955
335;"01.12.2006";22;"31.1";6361;62342;55981
335;"01.12.2006";23;"32.1";6297;60658;54361
335;"01.12.2006";24;"29.1";6293;56389;50096
336;"02.12.2006";1;"28.1";6240;52630;46390
336;"02.12.2006";2;"27.4";6818;50490;43672
336;"02.12.2006";3;"26.6";7144;49361;42217
336;"02.12.2006";4;"22.5";7404;49324;41920
336;"02.12.2006";5;"12.7";7454;49489;42035
336;"02.12.2006";6;"18.9";7209;48774;41565
336;"02.12.2006";7;"18.1";7302;49304;42002
336;"02.12.2006";8;"28.3";7393;53614;46221
336;"02.12.2006";9;"30.1";7566;56598;49032
336;"02.12.2006";10;"34.1";7325;58966;51641
336;"02.12.2006";11;36;6738;60104;53366
336;"02.12.2006";12;37;6424;60665;54241
336;"02.12.2006";13;"37.1";6264;59600;53336
336;"02.12.2006";14;"34.9";6043;57623;51580
336;"02.12.2006";15;"32.7";6057;55858;49801
336;"02.12.2006";16;"30.1";6240;56211;49971
336;"02.12.2006";17;"30.8";6964;59870;52906
336;"02.12.2006";18;"38.7";7288;63882;56594
336;"02.12.2006";19;"44.4";7747;63944;56197
336;"02.12.2006";20;40;7712;61612;53900
336;"02.12.2006";21;"35.1";7012;57898;50886
336;"02.12.2006";22;"29.1";6583;55824;49241
336;"02.12.2006";23;"32.1";6093;55086;48993
336;"02.12.2006";24;26;5682;51369;45687
337;"03.12.2006";1;"28.1";5443;47346;41903
337;"03.12.2006";2;26;5026;44407;39381
337;"03.12.2006";3;"19.4";4874;42871;37997
337;"03.12.2006";4;"16.6";4823;42550;37727
337;"03.12.2006";5;17;4728;42941;38213
337;"03.12.2006";6;"17.1";5084;42420;37336
337;"03.12.2006";7;"14.5";5554;41076;35522
337;"03.12.2006";8;"15.1";6250;43101;36851
337;"03.12.2006";9;20;7119;46267;39148
337;"03.12.2006";10;"25.4";7525;49368;41843
337;"03.12.2006";11;"31.5";8243;52043;43800
337;"03.12.2006";12;"33.9";9362;54635;45273
337;"03.12.2006";13;34;10367;53514;43147
337;"03.12.2006";14;"29.6";11171;51552;40381
337;"03.12.2006";15;28;11990;50360;38370
337;"03.12.2006";16;"23.1";12304;51039;38735
337;"03.12.2006";17;"25.8";13065;54975;41910
337;"03.12.2006";18;"36.4";13448;59167;45719
337;"03.12.2006";19;40;13570;60265;46695
337;"03.12.2006";20;40;13454;59560;46106
337;"03.12.2006";21;"37.3";12966;57630;44664
337;"03.12.2006";22;"32.5";12617;56916;44299
337;"03.12.2006";23;34;12215;56779;44564
337;"03.12.2006";24;"26.8";12366;52558;40192
338;"04.12.2006";1;"19.8";12166;48530;36364
338;"04.12.2006";2;"13.6";11984;46242;34258
338;"04.12.2006";3;"12.2";11515;45654;34139
338;"04.12.2006";4;"12.2";11514;46648;35134
338;"04.12.2006";5;"14.8";11588;48726;37138
338;"04.12.2006";6;"19.6";11996;52468;40472
338;"04.12.2006";7;"25.1";12429;61558;49129
338;"04.12.2006";8;"45.1";12188;69676;57488
338;"04.12.2006";9;"45.9";12204;71707;59503
338;"04.12.2006";10;52;11846;71251;59405
338;"04.12.2006";11;50;11600;72176;60576
338;"04.12.2006";12;49;11314;73049;61735
338;"04.12.2006";13;49;10525;72252;61727
338;"04.12.2006";14;53;9865;72238;62373
338;"04.12.2006";15;53;9327;72106;62779
338;"04.12.2006";16;"51.1";8833;71769;62936
338;"04.12.2006";17;57;8414;73118;64704
338;"04.12.2006";18;"64.1";8538;75451;66913
338;"04.12.2006";19;"61.1";8712;74520;65808
338;"04.12.2006";20;57;8743;72071;63328
338;"04.12.2006";21;"43.1";9039;68266;59227
338;"04.12.2006";22;"33.3";9902;65522;55620
338;"04.12.2006";23;"31.1";10679;62643;51964
338;"04.12.2006";24;"27.5";11049;56795;45746
339;"05.12.2006";1;"27.1";11212;52218;41006
339;"05.12.2006";2;"18.8";11928;49956;38028
339;"05.12.2006";3;16;13176;49306;36130
339;"05.12.2006";4;"12.1";13613;50040;36427
339;"05.12.2006";5;"6.5";14471;51930;37459
339;"05.12.2006";6;"15.9";14301;54975;40674
339;"05.12.2006";7;"29.1";14590;63235;48645
339;"05.12.2006";8;"48.9";14328;70682;56354
339;"05.12.2006";9;"41.9";14199;72094;57895
339;"05.12.2006";10;"40.1";13864;71185;57321
339;"05.12.2006";11;"42.8";13859;71749;57890
339;"05.12.2006";12;"44.8";13791;72395;58604
339;"05.12.2006";13;"40.8";14219;71770;57551
339;"05.12.2006";14;"38.9";14305;71648;57343
339;"05.12.2006";15;47;14416;71077;56661
339;"05.12.2006";16;"47.4";14327;71019;56692
339;"05.12.2006";17;"51.5";14077;73033;58956
339;"05.12.2006";18;60;14142;76113;61971
339;"05.12.2006";19;60;13777;75459;61682
339;"05.12.2006";20;"56.4";13605;73486;59881
339;"05.12.2006";21;52;13033;69522;56489
339;"05.12.2006";22;"33.4";12230;66112;53882
339;"05.12.2006";23;"31.1";11728;63214;51486
339;"05.12.2006";24;"27.9";10843;57128;46285
340;"06.12.2006";1;19;10512;52352;41840
340;"06.12.2006";2;14;10089;49342;39253
340;"06.12.2006";3;12;10005;48065;38060
340;"06.12.2006";4;12;10074;48610;38536
340;"06.12.2006";5;"12.1";9972;50636;40664
340;"06.12.2006";6;"19.2";9841;54012;44171
340;"06.12.2006";7;24;9465;61515;52050
340;"06.12.2006";8;46;9139;68598;59459
340;"06.12.2006";9;"56.3";8863;70135;61272
340;"06.12.2006";10;"58.5";9015;69622;60607
340;"06.12.2006";11;"60.5";9819;70784;60965
340;"06.12.2006";12;"58.1";10342;71626;61284
340;"06.12.2006";13;"60.6";11010;71573;60563
340;"06.12.2006";14;"60.6";11504;71580;60076
340;"06.12.2006";15;"59.9";11042;70923;59881
340;"06.12.2006";16;"54.4";10450;70692;60242
340;"06.12.2006";17;"69.6";10166;72931;62765
340;"06.12.2006";18;"74.6";10084;74684;64600
340;"06.12.2006";19;"73.9";10184;73782;63598
340;"06.12.2006";20;64;10083;71878;61795
340;"06.12.2006";21;56;9921;68141;58220
340;"06.12.2006";22;46;9927;64892;54965
340;"06.12.2006";23;44;9632;62089;52457
340;"06.12.2006";24;30;9213;56662;47449
341;"07.12.2006";1;"31.1";8975;52528;43553
341;"07.12.2006";2;"27.9";8893;50291;41398
341;"07.12.2006";3;"19.9";8905;49716;40811
341;"07.12.2006";4;"13.5";8935;50555;41620
341;"07.12.2006";5;"19.9";9115;51840;42725
341;"07.12.2006";6;"30.9";9607;54903;45296
341;"07.12.2006";7;"34.1";10362;62001;51639
341;"07.12.2006";8;"57.1";11068;69042;57974
341;"07.12.2006";9;"58.1";11589;70047;58458
341;"07.12.2006";10;"55.1";11913;69029;57116
341;"07.12.2006";11;54;12383;69474;57091
341;"07.12.2006";12;"49.9";13371;71013;57642
341;"07.12.2006";13;"43.1";13819;70614;56795
341;"07.12.2006";14;"44.3";14062;71138;57076
341;"07.12.2006";15;"39.1";14204;71181;56977
341;"07.12.2006";16;"37.1";14575;72245;57670
341;"07.12.2006";17;"45.9";15061;74565;59504
341;"07.12.2006";18;"59.9";15676;76636;60960
341;"07.12.2006";19;"59.7";15980;76109;60129
341;"07.12.2006";20;"51.4";15359;73826;58467
341;"07.12.2006";21;"40.5";15172;69794;54622
341;"07.12.2006";22;"32.6";15146;66448;51302
341;"07.12.2006";23;"25.6";14688;63555;48867
341;"07.12.2006";24;"28.3";14109;58146;44037
342;"08.12.2006";1;"28.9";13628;53956;40328
342;"08.12.2006";2;"27.3";13121;51543;38422
342;"08.12.2006";3;22;12803;50859;38056
342;"08.12.2006";4;"19.6";12392;51279;38887
342;"08.12.2006";5;20;11414;52291;40877
342;"08.12.2006";6;25;10587;54997;44410
342;"08.12.2006";7;"26.9";9930;62215;52285
342;"08.12.2006";8;"36.9";9942;69450;59508
342;"08.12.2006";9;46;9471;70833;61362
342;"08.12.2006";10;52;9043;70512;61469
342;"08.12.2006";11;"51.6";8713;71136;62423
342;"08.12.2006";12;"56.8";8240;71843;63603
342;"08.12.2006";13;"57.5";8739;71095;62356
342;"08.12.2006";14;"55.2";9552;70302;60750
342;"08.12.2006";15;"57.5";10268;69300;59032
342;"08.12.2006";16;"57.6";10824;69283;58459
342;"08.12.2006";17;"62.7";11117;71478;60361
342;"08.12.2006";18;"70.1";11594;74127;62533
342;"08.12.2006";19;"64.1";12574;73081;60507
342;"08.12.2006";20;"57.6";13632;70772;57140
342;"08.12.2006";21;"39.9";13987;66804;52817
342;"08.12.2006";22;"30.4";14018;63826;49808
342;"08.12.2006";23;"33.6";13584;61798;48214
342;"08.12.2006";24;"31.1";13171;57398;44227
343;"09.12.2006";1;24;12793;53459;40666
343;"09.12.2006";2;"18.9";11280;50269;38989
343;"09.12.2006";3;"18.9";10038;48456;38418
343;"09.12.2006";4;16;8476;47741;39265
343;"09.12.2006";5;13;6385;47856;41471
343;"09.12.2006";6;"17.9";5653;47563;41910
343;"09.12.2006";7;18;4699;47709;43010
343;"09.12.2006";8;"26.9";4320;51700;47380
343;"09.12.2006";9;"30.2";4036;55588;51552
343;"09.12.2006";10;38;4071;58267;54196
343;"09.12.2006";11;"46.9";3574;59490;55916
343;"09.12.2006";12;"49.9";3063;60227;57164
343;"09.12.2006";13;"45.9";2884;59146;56262
343;"09.12.2006";14;"32.7";2433;57445;55012
343;"09.12.2006";15;"33.7";1988;55729;53741
343;"09.12.2006";16;"34.7";1833;55794;53961
343;"09.12.2006";17;"42.2";1907;58906;56999
343;"09.12.2006";18;63;2295;62300;60005
343;"09.12.2006";19;62;2537;61683;59146
343;"09.12.2006";20;"53.9";2602;59580;56978
343;"09.12.2006";21;"41.2";2717;56115;53398
343;"09.12.2006";22;"37.8";2974;54207;51233
343;"09.12.2006";23;"45.3";3030;53901;50871
343;"09.12.2006";24;"32.1";2886;49964;47078
344;"10.12.2006";1;33;2717;46205;43488
344;"10.12.2006";2;28;2871;43963;41092
344;"10.12.2006";3;"24.7";2816;42983;40167
344;"10.12.2006";4;"24.7";2715;42644;39929
344;"10.12.2006";5;"17.4";2896;42781;39885
344;"10.12.2006";6;22;2942;42084;39142
344;"10.12.2006";7;"22.7";3098;40593;37495
344;"10.12.2006";8;"25.4";3091;42672;39581
344;"10.12.2006";9;"28.8";3163;45512;42349
344;"10.12.2006";10;30;2917;48702;45785
344;"10.12.2006";11;34;2523;51238;48715
344;"10.12.2006";12;39;2010;53739;51729
344;"10.12.2006";13;"38.9";1895;52896;51001
344;"10.12.2006";14;33;2254;50770;48516
344;"10.12.2006";15;"27.7";2632;48987;46355
344;"10.12.2006";16;"28.8";3031;48895;45864
344;"10.12.2006";17;"32.4";3975;52590;48615
344;"10.12.2006";18;"43.6";5039;57741;52702
344;"10.12.2006";19;"45.8";5886;58449;52563
344;"10.12.2006";20;"46.1";6421;57869;51448
344;"10.12.2006";21;40;6967;56104;49137
344;"10.12.2006";22;"35.5";7460;55435;47975
344;"10.12.2006";23;36;8199;56118;47919
344;"10.12.2006";24;30;9050;52703;43653
345;"11.12.2006";1;"28.8";9977;49382;39405
345;"11.12.2006";2;"19.2";10610;48291;37681
345;"11.12.2006";3;"16.9";10980;47907;36927
345;"11.12.2006";4;"17.7";11393;48087;36694
345;"11.12.2006";5;"12.2";12040;49633;37593
345;"11.12.2006";6;"29.9";12425;53432;41007
345;"11.12.2006";7;32;12562;61764;49202
345;"11.12.2006";8;"57.6";13050;69994;56944
345;"11.12.2006";9;"61.1";13280;71973;58693
345;"11.12.2006";10;63;13385;72051;58666
345;"11.12.2006";11;"61.1";13297;72826;59529
345;"11.12.2006";12;63;13404;74147;60743
345;"11.12.2006";13;"62.1";13453;74029;60576
345;"11.12.2006";14;"62.1";13414;74070;60656
345;"11.12.2006";15;"62.7";13317;73731;60414
345;"11.12.2006";16;59;13576;74398;60822
345;"11.12.2006";17;66;13529;76141;62612
345;"11.12.2006";18;"70.1";13193;77918;64725
345;"11.12.2006";19;"70.6";12649;76457;63808
345;"11.12.2006";20;"68.1";11605;74212;62607
345;"11.12.2006";21;"57.6";10601;69312;58711
345;"11.12.2006";22;"41.3";9866;65170;55304
345;"11.12.2006";23;"32.6";8595;63177;54582
345;"11.12.2006";24;"29.1";7771;57420;49649
346;"12.12.2006";1;"26.7";6772;52843;46071
346;"12.12.2006";2;"26.2";6201;50464;44263
346;"12.12.2006";3;"26.7";5427;49167;43740
346;"12.12.2006";4;20;4888;49405;44517
346;"12.12.2006";5;"22.1";4862;50939;46077
346;"12.12.2006";6;"28.6";4731;53491;48760
346;"12.12.2006";7;"33.9";4862;61581;56719
346;"12.12.2006";8;"61.2";4978;69137;64159
346;"12.12.2006";9;70;5085;71203;66118
346;"12.12.2006";10;"67.6";5174;70544;65370
346;"12.12.2006";11;"68.9";5098;70853;65755
346;"12.12.2006";12;"66.2";5448;71584;66136
346;"12.12.2006";13;"63.9";5890;71107;65217
346;"12.12.2006";14;"64.9";6368;70677;64309
346;"12.12.2006";15;"62.9";6505;69862;63357
346;"12.12.2006";16;"62.3";6334;69949;63615
346;"12.12.2006";17;"59.3";7393;72420;65027
346;"12.12.2006";18;"70.1";8762;75619;66857
346;"12.12.2006";19;84;10159;75111;64952
346;"12.12.2006";20;64;11215;73172;61957
346;"12.12.2006";21;"55.1";12147;69559;57412
346;"12.12.2006";22;"35.5";12367;66661;54294
346;"12.12.2006";23;"27.8";12697;64446;51749
346;"12.12.2006";24;"26.6";13229;59183;45954
347;"13.12.2006";1;"28.4";13614;55130;41516
347;"13.12.2006";2;26;13302;53045;39743
347;"13.12.2006";3;"24.1";12902;52399;39497
347;"13.12.2006";4;"22.1";12460;52289;39829
347;"13.12.2006";5;"18.9";12142;53703;41561
347;"13.12.2006";6;"26.8";11777;55808;44031
347;"13.12.2006";7;"31.1";11256;62670;51414
347;"13.12.2006";8;55;11022;70312;59290
347;"13.12.2006";9;"53.9";10399;71967;61568
347;"13.12.2006";10;"55.1";10060;71294;61234
347;"13.12.2006";11;"55.5";9604;71807;62203
347;"13.12.2006";12;"55.1";9335;72483;63148
347;"13.12.2006";13;53;9123;72147;63024
347;"13.12.2006";14;51;8747;71892;63145
347;"13.12.2006";15;"50.1";8809;70987;62178
347;"13.12.2006";16;50;8752;71022;62270
347;"13.12.2006";17;69;9211;73157;63946
347;"13.12.2006";18;70;9905;75776;65871
347;"13.12.2006";19;"66.1";11269;75096;63827
347;"13.12.2006";20;"59.1";12333;73150;60817
347;"13.12.2006";21;"36.5";13426;69824;56398
347;"13.12.2006";22;35;14048;67394;53346
347;"13.12.2006";23;"31.8";14583;65244;50661
347;"13.12.2006";24;"26.9";14720;60277;45557
348;"14.12.2006";1;"26.1";14854;56266;41412
348;"14.12.2006";2;"13.1";14958;53856;38898
348;"14.12.2006";3;"10.5";14957;53064;38107
348;"14.12.2006";4;"13.5";14868;53392;38524
348;"14.12.2006";5;"6.9";14349;54552;40203
348;"14.12.2006";6;"20.8";13923;56894;42971
348;"14.12.2006";7;"27.2";13943;63735;49792
348;"14.12.2006";8;"41.4";13769;70917;57148
348;"14.12.2006";9;"41.3";13793;72742;58949
348;"14.12.2006";10;"41.2";13549;71602;58053
348;"14.12.2006";11;"44.2";13187;71870;58683
348;"14.12.2006";12;"49.9";13246;72511;59265
348;"14.12.2006";13;"47.9";13193;71971;58778
348;"14.12.2006";14;"49.4";12961;71643;58682
348;"14.12.2006";15;"47.9";12308;71004;58696
348;"14.12.2006";16;42;11700;71048;59348
348;"14.12.2006";17;"49.9";11719;72923;61204
348;"14.12.2006";18;"69.2";11526;75918;64392
348;"14.12.2006";19;"70.6";11457;75436;63979
348;"14.12.2006";20;"58.9";11311;73215;61904
348;"14.12.2006";21;50;11229;69692;58463
348;"14.12.2006";22;"32.4";10855;66464;55609
348;"14.12.2006";23;"32.5";11013;64374;53361
348;"14.12.2006";24;"26.5";11146;59203;48057
349;"15.12.2006";1;27;11182;55587;44405
349;"15.12.2006";2;"26.3";10988;53125;42137
349;"15.12.2006";3;"26.4";10638;52218;41580
349;"15.12.2006";4;23;10281;52565;42284
349;"15.12.2006";5;15;9872;53749;43877
349;"15.12.2006";6;"26.9";9645;55678;46033
349;"15.12.2006";7;31;9022;62680;53658
349;"15.12.2006";8;"49.9";8521;69909;61388
349;"15.12.2006";9;"54.9";8316;71526;63210
349;"15.12.2006";10;"52.5";7673;70154;62481
349;"15.12.2006";11;"54.1";7299;70282;62983
349;"15.12.2006";12;"52.6";6898;70689;63791
349;"15.12.2006";13;49;6321;69477;63156
349;"15.12.2006";14;"42.6";6086;68052;61966
349;"15.12.2006";15;"35.7";5918;66460;60542
349;"15.12.2006";16;"35.3";6040;66312;60272
349;"15.12.2006";17;"46.5";6608;69050;62442
349;"15.12.2006";18;"55.7";7333;73153;65820
349;"15.12.2006";19;"58.2";7806;72344;64538
349;"15.12.2006";20;55;7898;69703;61805
349;"15.12.2006";21;"46.8";8272;65815;57543
349;"15.12.2006";22;"33.7";9246;63777;54531
349;"15.12.2006";23;37;9557;62885;53328
349;"15.12.2006";24;"28.1";9854;58580;48726
350;"16.12.2006";1;"29.2";10007;54890;44883
350;"16.12.2006";2;"27.5";10086;52664;42578
350;"16.12.2006";3;"27.6";10394;51258;40864
350;"16.12.2006";4;"26.3";10208;50837;40629
350;"16.12.2006";5;21;10293;50819;40526
350;"16.12.2006";6;"22.2";10380;50143;39763
350;"16.12.2006";7;"17.8";10683;49873;39190
350;"16.12.2006";8;"23.2";10884;53504;42620
350;"16.12.2006";9;"25.1";11308;57116;45808
350;"16.12.2006";10;"28.1";11190;59472;48282
350;"16.12.2006";11;"29.9";11375;60943;49568
350;"16.12.2006";12;"33.5";10833;61774;50941
350;"16.12.2006";13;"39.2";10206;60979;50773
350;"16.12.2006";14;"36.3";9360;59446;50086
350;"16.12.2006";15;"32.4";8225;58151;49926
350;"16.12.2006";16;28;7249;58415;51166
350;"16.12.2006";17;"32.4";6412;61304;54892
350;"16.12.2006";18;"41.6";5930;63997;58067
350;"16.12.2006";19;"50.1";5543;63172;57629
350;"16.12.2006";20;"40.4";5035;60618;55583
350;"16.12.2006";21;"37.7";4120;56858;52738
350;"16.12.2006";22;30;3797;54945;51148
350;"16.12.2006";23;"28.7";3485;54798;51313
350;"16.12.2006";24;26;3278;51061;47783
351;"17.12.2006";1;31;3209;47034;43825
351;"17.12.2006";2;27;3190;44354;41164
351;"17.12.2006";3;"21.9";3480;43126;39646
351;"17.12.2006";4;"21.4";4037;43169;39132
351;"17.12.2006";5;"14.3";4189;43242;39053
351;"17.12.2006";6;"20.2";4593;42787;38194
351;"17.12.2006";7;"14.9";4830;41244;36414
351;"17.12.2006";8;"18.7";5176;43547;38371
351;"17.12.2006";9;"24.5";5437;46478;41041
351;"17.12.2006";10;"25.1";5929;49894;43965
351;"17.12.2006";11;"31.1";6265;52655;46390
351;"17.12.2006";12;"36.1";6449;55760;49311
351;"17.12.2006";13;36;6680;55415;48735
351;"17.12.2006";14;29;6511;53578;47067
351;"17.12.2006";15;"27.3";6147;52047;45900
351;"17.12.2006";16;"26.4";5515;51751;46236
351;"17.12.2006";17;"32.1";5568;55198;49630
351;"17.12.2006";18;42;5709;58594;52885
351;"17.12.2006";19;"41.9";5864;59469;53605
351;"17.12.2006";20;36;5379;58342;52963
351;"17.12.2006";21;"32.6";4800;56264;51464
351;"17.12.2006";22;32;4514;55849;51335
351;"17.12.2006";23;36;4051;56209;52158
351;"17.12.2006";24;"28.3";3481;52218;48737
352;"18.12.2006";1;"26.8";3184;48998;45814
352;"18.12.2006";2;28;2893;46848;43955
352;"18.12.2006";3;"26.2";2631;46186;43555
352;"18.12.2006";4;21;2313;46590;44277
352;"18.12.2006";5;"22.1";2010;47919;45909
352;"18.12.2006";6;33;1609;50937;49328
352;"18.12.2006";7;"39.9";1309;59271;57962
352;"18.12.2006";8;"75.5";1108;67234;66126
352;"18.12.2006";9;73;893;69758;68865
352;"18.12.2006";10;"72.2";646;69449;68803
352;"18.12.2006";11;"72.2";482;69739;69257
352;"18.12.2006";12;"72.2";457;70485;70028
352;"18.12.2006";13;"75.3";464;70515;70051
352;"18.12.2006";14;78;429;70388;69959
352;"18.12.2006";15;"76.4";409;69475;69066
352;"18.12.2006";16;"77.1";497;69248;68751
352;"18.12.2006";17;"100.1";565;71415;70850
352;"18.12.2006";18;"155.7";666;73724;73058
352;"18.12.2006";19;"122.8";854;72873;72019
352;"18.12.2006";20;"94.5";880;71010;70130
352;"18.12.2006";21;"73.1";1072;67272;66200
352;"18.12.2006";22;"57.1";1100;64131;63031
352;"18.12.2006";23;"50.7";1132;61599;60467
352;"18.12.2006";24;"44.2";1107;56484;55377
353;"19.12.2006";1;"32.9";1163;52302;51139
353;"19.12.2006";2;"39.7";1181;49662;48481
353;"19.12.2006";3;"31.2";1361;48758;47397
353;"19.12.2006";4;"26.9";1466;49167;47701
353;"19.12.2006";5;"23.9";1582;50385;48803
353;"19.12.2006";6;38;1600;52580;50980
353;"19.12.2006";7;"50.1";1734;60165;58431
353;"19.12.2006";8;"70.5";1700;68033;66333
353;"19.12.2006";9;"72.1";1675;70423;68748
353;"19.12.2006";10;"70.4";1510;69488;67978
353;"19.12.2006";11;72;1321;69834;68513
353;"19.12.2006";12;"72.2";1181;70461;69280
353;"19.12.2006";13;"70.1";1209;69823;68614
353;"19.12.2006";14;"70.5";1249;69380;68131
353;"19.12.2006";15;"68.7";1265;68691;67426
353;"19.12.2006";16;"67.5";1448;68710;67262
353;"19.12.2006";17;"72.1";1779;71340;69561
353;"19.12.2006";18;"80.1";2037;73639;71602
353;"19.12.2006";19;"73.4";2243;72602;70359
353;"19.12.2006";20;"67.3";2248;70524;68276
353;"19.12.2006";21;"61.2";2371;66794;64423
353;"19.12.2006";22;"55.8";2443;63984;61541
353;"19.12.2006";23;"44.2";2598;61881;59283
353;"19.12.2006";24;"29.1";2979;56678;53699
354;"20.12.2006";1;"28.1";3347;52665;49318
354;"20.12.2006";2;"26.6";3635;50486;46851
354;"20.12.2006";3;"26.9";3843;49734;45891
354;"20.12.2006";4;27;4253;50264;46011
354;"20.12.2006";5;"28.6";4191;51426;47235
354;"20.12.2006";6;"33.6";4345;53951;49606
354;"20.12.2006";7;"26.9";4454;60620;56166
354;"20.12.2006";8;"65.8";4657;68208;63551
354;"20.12.2006";9;66;4788;70111;65323
354;"20.12.2006";10;"64.9";4898;69603;64705
354;"20.12.2006";11;"62.4";4966;69919;64953
354;"20.12.2006";12;"62.9";4962;70488;65526
354;"20.12.2006";13;"62.1";4648;69908;65260
354;"20.12.2006";14;"62.4";3974;69433;65459
354;"20.12.2006";15;62;3482;68923;65441
354;"20.12.2006";16;"60.2";3241;68944;65703
354;"20.12.2006";17;"68.7";2777;70912;68135
354;"20.12.2006";18;"95.5";2503;73010;70507
354;"20.12.2006";19;"95.6";2218;72063;69845
354;"20.12.2006";20;"78.2";1829;69900;68071
354;"20.12.2006";21;"65.9";1497;66247;64750
354;"20.12.2006";22;"59.9";1231;63561;62330
354;"20.12.2006";23;"58.1";989;61731;60742
354;"20.12.2006";24;"47.6";787;56291;55504
355;"21.12.2006";1;"39.9";614;51860;51246
355;"21.12.2006";2;"36.9";552;49293;48741
355;"21.12.2006";3;"34.9";459;48273;47814
355;"21.12.2006";4;"32.6";434;48378;47944
355;"21.12.2006";5;"30.4";381;49336;48955
355;"21.12.2006";6;40;369;51608;51239
355;"21.12.2006";7;"47.9";385;57847;57462
355;"21.12.2006";8;"66.9";439;65130;64691
355;"21.12.2006";9;"75.1";455;67746;67291
355;"21.12.2006";10;"72.4";406;67586;67180
355;"21.12.2006";11;"72.1";419;68088;67669
355;"21.12.2006";12;"72.5";443;68534;68091
355;"21.12.2006";13;"72.1";472;67738;67266
355;"21.12.2006";14;"72.1";487;66887;66400
355;"21.12.2006";15;"74.9";494;66042;65548
355;"21.12.2006";16;64;558;66070;65512
355;"21.12.2006";17;"72.3";634;68134;67500
355;"21.12.2006";18;"153.2";736;70374;69638
355;"21.12.2006";19;"125.1";765;69603;68838
355;"21.12.2006";20;75;804;67749;66945
355;"21.12.2006";21;"66.6";784;64162;63378
355;"21.12.2006";22;"55.2";757;61807;61050
355;"21.12.2006";23;"45.1";755;59982;59227
355;"21.12.2006";24;"33.6";851;54725;53874
356;"22.12.2006";1;"31.6";943;50618;49675
356;"22.12.2006";2;"32.4";1144;48152;47008
356;"22.12.2006";3;"28.5";1210;47156;45946
356;"22.12.2006";4;"27.9";1257;47326;46069
356;"22.12.2006";5;"26.8";1213;48283;47070
356;"22.12.2006";6;"38.1";1243;50175;48932
356;"22.12.2006";7;"36.3";1375;55193;53818
356;"22.12.2006";8;68;1328;62069;60741
356;"22.12.2006";9;"69.9";1152;64601;63449
356;"22.12.2006";10;"70.5";907;64083;63176
356;"22.12.2006";11;68;890;63924;63034
356;"22.12.2006";12;68;877;63959;63082
356;"22.12.2006";13;66;983;62977;61994
356;"22.12.2006";14;62;1038;61110;60072
356;"22.12.2006";15;"56.1";1004;60122;59118
356;"22.12.2006";16;"52.9";962;60358;59396
356;"22.12.2006";17;55;905;63306;62401
356;"22.12.2006";18;63;880;66666;65786
356;"22.12.2006";19;"66.1";814;65909;65095
356;"22.12.2006";20;"58.1";731;63011;62280
356;"22.12.2006";21;56;779;59354;58575
356;"22.12.2006";22;"48.5";783;57207;56424
356;"22.12.2006";23;"50.3";842;56382;55540
356;"22.12.2006";24;"35.6";843;51927;51084
357;"23.12.2006";1;"42.6";899;48329;47430
357;"23.12.2006";2;"36.2";808;45801;44993
357;"23.12.2006";3;"32.2";738;44597;43859
357;"23.12.2006";4;"31.4";672;44014;43342
357;"23.12.2006";5;30;651;44243;43592
357;"23.12.2006";6;"30.7";622;43562;42940
357;"23.12.2006";7;"27.2";592;42605;42013
357;"23.12.2006";8;"32.9";549;46105;45556
357;"23.12.2006";9;"40.6";559;49569;49010
357;"23.12.2006";10;58;617;52689;52072
357;"23.12.2006";11;"58.1";681;54346;53665
357;"23.12.2006";12;"56.1";657;55642;54985
357;"23.12.2006";13;56;620;55417;54797
357;"23.12.2006";14;"54.1";595;54198;53603
357;"23.12.2006";15;"46.9";540;53339;52799
357;"23.12.2006";16;46;552;53791;53239
357;"23.12.2006";17;54;601;57081;56480
357;"23.12.2006";18;65;658;61154;60496
357;"23.12.2006";19;"64.1";703;60989;60286
357;"23.12.2006";20;"53.6";728;58942;58214
357;"23.12.2006";21;"49.9";697;55466;54769
357;"23.12.2006";22;"36.9";647;53700;53053
357;"23.12.2006";23;"37.8";714;53490;52776
357;"23.12.2006";24;32;710;49536;48826
358;"24.12.2006";1;"29.4";679;45412;44733
358;"24.12.2006";2;"25.2";706;42947;42241
358;"24.12.2006";3;"21.5";744;41571;40827
358;"24.12.2006";4;"24.3";732;40902;40170
358;"24.12.2006";5;"23.5";738;40839;40101
358;"24.12.2006";6;20;840;39751;38911
358;"24.12.2006";7;"14.5";900;37555;36655
358;"24.12.2006";8;"16.8";905;39458;38553
358;"24.12.2006";9;26;998;42890;41892
358;"24.12.2006";10;"28.8";1010;46377;45367
358;"24.12.2006";11;"33.6";989;49023;48034
358;"24.12.2006";12;"36.2";957;50765;49808
358;"24.12.2006";13;"36.1";920;49928;49008
358;"24.12.2006";14;"33.1";1067;48322;47255
358;"24.12.2006";15;"29.5";1081;47174;46093
358;"24.12.2006";16;"29.5";1147;46876;45729
358;"24.12.2006";17;"35.5";1151;49497;48346
358;"24.12.2006";18;"43.3";1125;52663;51538
358;"24.12.2006";19;"44.3";992;51055;50063
358;"24.12.2006";20;"42.4";921;48301;47380
358;"24.12.2006";21;"34.7";789;46269;45480
358;"24.12.2006";22;35;691;47255;46564
358;"24.12.2006";23;"38.6";625;49206;48581
358;"24.12.2006";24;"28.9";581;46924;46343
359;"25.12.2006";1;"28.3";481;43653;43172
359;"25.12.2006";2;25;428;40635;40207
359;"25.12.2006";3;"18.1";366;39027;38661
359;"25.12.2006";4;"15.4";332;38517;38185
359;"25.12.2006";5;"16.9";336;38610;38274
359;"25.12.2006";6;"18.5";341;37858;37517
359;"25.12.2006";7;"12.9";339;36016;35677
359;"25.12.2006";8;"9.1";283;37796;37513
359;"25.12.2006";9;"27.3";268;41471;41203
359;"25.12.2006";10;"30.1";260;45697;45437
359;"25.12.2006";11;"36.5";261;49147;48886
359;"25.12.2006";12;"38.1";271;51804;51533
359;"25.12.2006";13;"38.9";274;49365;49091
359;"25.12.2006";14;"32.9";262;45779;45517
359;"25.12.2006";15;30;252;44621;44369
359;"25.12.2006";16;"29.2";284;44288;44004
359;"25.12.2006";17;"34.4";317;46334;46017
359;"25.12.2006";18;"39.4";363;49389;49026
359;"25.12.2006";19;44;392;50558;50166
359;"25.12.2006";20;44;436;49916;49480
359;"25.12.2006";21;"39.4";494;48515;48021
359;"25.12.2006";22;"35.2";446;48516;48070
359;"25.12.2006";23;"38.7";434;49652;49218
359;"25.12.2006";24;"28.9";394;46383;45989
360;"26.12.2006";1;28;387;42852;42465
360;"26.12.2006";2;"26.6";413;40320;39907
360;"26.12.2006";3;"19.2";468;39230;38762
360;"26.12.2006";4;"13.3";522;38910;38388
360;"26.12.2006";5;"14.4";517;39158;38641
360;"26.12.2006";6;"20.1";469;38529;38060
360;"26.12.2006";7;"9.5";449;36408;35959
360;"26.12.2006";8;"14.5";412;37862;37450
360;"26.12.2006";9;"22.2";464;40609;40145
360;"26.12.2006";10;"29.8";536;44132;43596
360;"26.12.2006";11;33;626;46796;46170
360;"26.12.2006";12;"34.1";618;49479;48861
360;"26.12.2006";13;"33.5";483;48278;47795
360;"26.12.2006";14;"30.1";415;45398;44983
360;"26.12.2006";15;"28.9";346;44054;43708
360;"26.12.2006";16;"28.5";340;43661;43321
360;"26.12.2006";17;"31.4";359;45987;45628
360;"26.12.2006";18;"38.4";402;50407;50005
360;"26.12.2006";19;46;448;51652;51204
360;"26.12.2006";20;48;510;51263;50753
360;"26.12.2006";21;35;538;49766;49228
360;"26.12.2006";22;"30.1";648;49776;49128
360;"26.12.2006";23;"33.5";688;50898;50210
360;"26.12.2006";24;30;646;48209;47563
361;"27.12.2006";1;"31.5";619;45140;44521
361;"27.12.2006";2;"30.1";603;42882;42279
361;"27.12.2006";3;28;574;41834;41260
361;"27.12.2006";4;"22.3";578;41343;40765
361;"27.12.2006";5;"16.9";553;41709;41156
361;"27.12.2006";6;"26.3";556;42565;42009
361;"27.12.2006";7;"19.1";600;44738;44138
361;"27.12.2006";8;"30.2";613;49855;49242
361;"27.12.2006";9;"33.5";623;53983;53360
361;"27.12.2006";10;"43.4";687;56404;55717
361;"27.12.2006";11;"43.8";677;57913;57236
361;"27.12.2006";12;"55.1";578;59538;58960
361;"27.12.2006";13;"62.1";545;59770;59225
361;"27.12.2006";14;"64.6";537;58816;58279
361;"27.12.2006";15;"55.9";608;57930;57322
361;"27.12.2006";16;"55.8";727;57873;57146
361;"27.12.2006";17;"58.6";884;60528;59644
361;"27.12.2006";18;72;1137;63428;62291
361;"27.12.2006";19;"70.4";1451;63299;61848
361;"27.12.2006";20;"65.9";1661;61230;59569
361;"27.12.2006";21;"49.6";1920;57351;55431
361;"27.12.2006";22;"35.6";2175;55716;53541
361;"27.12.2006";23;37;2287;55552;53265
361;"27.12.2006";24;"31.8";2558;51882;49324
362;"28.12.2006";1;"30.9";2750;48537;45787
362;"28.12.2006";2;29;2873;46018;43145
362;"28.12.2006";3;"28.9";2976;44912;41936
362;"28.12.2006";4;27;3058;44390;41332
362;"28.12.2006";5;26;3158;44660;41502
362;"28.12.2006";6;"25.7";3315;45139;41824
362;"28.12.2006";7;"16.8";3693;46757;43064
362;"28.12.2006";8;"25.5";3718;51523;47805
362;"28.12.2006";9;28;4151;55517;51366
362;"28.12.2006";10;"32.7";4609;58244;53635
362;"28.12.2006";11;"32.5";4731;59587;54856
362;"28.12.2006";12;"38.9";4839;61170;56331
362;"28.12.2006";13;34;4654;61140;56486
362;"28.12.2006";14;"29.1";4340;59857;55517
362;"28.12.2006";15;29;4280;58943;54663
362;"28.12.2006";16;"28.5";4393;58757;54364
362;"28.12.2006";17;"37.4";3992;60917;56925
362;"28.12.2006";18;"57.1";3419;63706;60287
362;"28.12.2006";19;59;3217;63536;60319
362;"28.12.2006";20;"54.8";2780;61339;58559
362;"28.12.2006";21;"29.1";2444;57737;55293
362;"28.12.2006";22;"34.5";2329;56130;53801
362;"28.12.2006";23;"43.8";1845;55655;53810
362;"28.12.2006";24;32;1690;51427;49737
363;"29.12.2006";1;30;1525;47542;46017
363;"29.12.2006";2;"26.6";1235;44729;43494
363;"29.12.2006";3;"26.5";966;43287;42321
363;"29.12.2006";4;"26.3";868;42968;42100
363;"29.12.2006";5;"26.6";868;43638;42770
363;"29.12.2006";6;"28.6";965;44337;43372
363;"29.12.2006";7;"26.1";1100;45828;44728
363;"29.12.2006";8;"26.6";1254;50323;49069
363;"29.12.2006";9;"28.7";1483;54088;52605
363;"29.12.2006";10;"48.9";1716;56010;54294
363;"29.12.2006";11;"54.9";1809;56990;55181
363;"29.12.2006";12;52;1845;57877;56032
363;"29.12.2006";13;"53.6";1980;57491;55511
363;"29.12.2006";14;"49.9";2326;56129;53803
363;"29.12.2006";15;"35.9";2479;54678;52199
363;"29.12.2006";16;"33.5";2999;54501;51502
363;"29.12.2006";17;"41.5";4113;58085;53972
363;"29.12.2006";18;"54.9";5365;62639;57274
363;"29.12.2006";19;"54.9";6273;62505;56232
363;"29.12.2006";20;"31.7";6728;60346;53618
363;"29.12.2006";21;29;6620;56735;50115
363;"29.12.2006";22;27;7063;55664;48601
363;"29.12.2006";23;"26.9";7396;55620;48224
363;"29.12.2006";24;"27.5";7709;51736;44027
364;"30.12.2006";1;"32.7";8201;48442;40241
364;"30.12.2006";2;"29.1";8231;46201;37970
364;"30.12.2006";3;"26.2";8954;45095;36141
364;"30.12.2006";4;20;9245;44451;35206
364;"30.12.2006";5;"18.8";9969;44448;34479
364;"30.12.2006";6;"17.7";10690;43939;33249
364;"30.12.2006";7;"5.3";11364;42895;31531
364;"30.12.2006";8;"12.1";11865;45438;33573
364;"30.12.2006";9;"23.1";12562;48496;35934
364;"30.12.2006";10;"27.6";13236;51652;38416
364;"30.12.2006";11;"28.5";13575;53626;40051
364;"30.12.2006";12;32;13401;54698;41297
364;"30.12.2006";13;"29.1";13730;55197;41467
364;"30.12.2006";14;"29.1";13426;54666;41240
364;"30.12.2006";15;"29.6";12830;53829;40999
364;"30.12.2006";16;30;12832;54117;41285
364;"30.12.2006";17;32;11811;56609;44798
364;"30.12.2006";18;"52.3";11107;59858;48751
364;"30.12.2006";19;"51.7";11113;60058;48945
364;"30.12.2006";20;"48.9";11016;57856;46840
364;"30.12.2006";21;36;11461;55029;43568
364;"30.12.2006";22;"28.6";12828;53850;41022
364;"30.12.2006";23;"30.8";14449;54717;40268
364;"30.12.2006";24;"23.2";15481;52025;36544
365;"31.12.2006";1;"10.4";15920;49001;33081
365;"31.12.2006";2;0;15653;45986;30333
365;"31.12.2006";3;0;14826;44202;29376
365;"31.12.2006";4;0;14742;43767;29025
365;"31.12.2006";5;0;14399;43342;28943
365;"31.12.2006";6;0;14759;42531;27772
365;"31.12.2006";7;0;14665;40746;26081
365;"31.12.2006";8;0;14428;42183;27755
365;"31.12.2006";9;2;14227;44494;30267
365;"31.12.2006";10;"12.1";14106;46940;32834
365;"31.12.2006";11;20;13909;48900;34991
365;"31.12.2006";12;"26.7";13954;51024;37070
365;"31.12.2006";13;"24.6";13833;51242;37409
365;"31.12.2006";14;20;13239;50130;36891
365;"31.12.2006";15;"13.9";11806;48526;36720
365;"31.12.2006";16;"14.6";10858;48133;37275
365;"31.12.2006";17;25;9964;50875;40911
365;"31.12.2006";18;"33.1";10403;55104;44701
365;"31.12.2006";19;31;11114;54614;43500
365;"31.12.2006";20;"27.6";11841;51583;39742
365;"31.12.2006";21;"23.1";11906;48355;36449
365;"31.12.2006";22;"18.6";12240;48164;35924
365;"31.12.2006";23;"20.1";13006;49425;36419
365;"31.12.2006";24;"12.7";13435;47839;34404
366;"01.01.2007";1;"1.6";14292;46293;32001
366;"01.01.2007";2;0;15071;44860;29789
366;"01.01.2007";3;0;15344;43393;28049
366;"01.01.2007";4;0;15450;42247;26797
366;"01.01.2007";5;0;15208;41857;26649
366;"01.01.2007";6;0;14983;41221;26238
366;"01.01.2007";7;0;14899;39013;24114
366;"01.01.2007";8;0;15177;39215;24038
366;"01.01.2007";9;0;15380;39636;24256
366;"01.01.2007";10;0;15004;41604;26600
366;"01.01.2007";11;"0.5";15096;44055;28959
366;"01.01.2007";12;"5.6";15190;47230;32040
366;"01.01.2007";13;7;14802;48285;33483
366;"01.01.2007";14;"2.7";14715;48500;33785
366;"01.01.2007";15;"0.1";13988;47670;33682
366;"01.01.2007";16;"0.1";14138;47640;33502
366;"01.01.2007";17;"11.6";14189;50058;35869
366;"01.01.2007";18;17;14472;54704;40232
366;"01.01.2007";19;"17.7";14695;56083;41388
366;"01.01.2007";20;19;14688;55462;40774
366;"01.01.2007";21;"15.1";14148;53227;39079
366;"01.01.2007";22;"13.5";13533;52868;39335
366;"01.01.2007";23;16;12462;53292;40830
366;"01.01.2007";24;12;11402;49902;38500
367;"02.01.2007";1;"11.1";10664;46821;36157
367;"02.01.2007";2;"6.5";10260;44380;34120
367;"02.01.2007";3;7;9764;43319;33555
367;"02.01.2007";4;"6.9";9058;43218;34160
367;"02.01.2007";5;7;8070;43548;35478
367;"02.01.2007";6;"11.7";7675;45612;37937
367;"02.01.2007";7;"7.2";8224;50695;42471
367;"02.01.2007";8;"23.4";8337;57050;48713
367;"02.01.2007";9;33;8725;61179;52454
367;"02.01.2007";10;"39.7";9335;63319;53984
367;"02.01.2007";11;"48.6";9267;65146;55879
367;"02.01.2007";12;"54.8";9547;67254;57707
367;"02.01.2007";13;"54.9";9568;67488;57920
367;"02.01.2007";14;"53.2";9397;66858;57461
367;"02.01.2007";15;"44.9";8684;66246;57562
367;"02.01.2007";16;"39.7";7704;65678;57974
367;"02.01.2007";17;"42.1";7555;67242;59687
367;"02.01.2007";18;"59.9";7546;69649;62103
367;"02.01.2007";19;"59.6";7698;69281;61583
367;"02.01.2007";20;55;7757;67022;59265
367;"02.01.2007";21;"36.7";7565;63364;55799
367;"02.01.2007";22;31;7133;61539;54406
367;"02.01.2007";23;"29.4";7227;60369;53142
367;"02.01.2007";24;"26.1";7346;55659;48313
368;"03.01.2007";1;"28.5";7044;51554;44510
368;"03.01.2007";2;"28.4";7108;49499;42391
368;"03.01.2007";3;"28.4";6926;48378;41452
368;"03.01.2007";4;"21.7";6947;48448;41501
368;"03.01.2007";5;"20.4";7143;49326;42183
368;"03.01.2007";6;"29.1";7102;51128;44026
368;"03.01.2007";7;29;6840;54971;48131
368;"03.01.2007";8;"39.9";6491;60725;54234
368;"03.01.2007";9;57;6107;64060;57953
368;"03.01.2007";10;64;6156;65303;59147
368;"03.01.2007";11;72;6375;66630;60255
368;"03.01.2007";12;72;6672;68076;61404
368;"03.01.2007";13;"64.9";7161;67819;60658
368;"03.01.2007";14;"60.1";7449;67184;59735
368;"03.01.2007";15;"53.6";7977;66355;58378
368;"03.01.2007";16;"43.9";8093;65722;57629
368;"03.01.2007";17;47;8796;67562;58766
368;"03.01.2007";18;"58.1";9374;70767;61393
368;"03.01.2007";19;61;10014;70346;60332
368;"03.01.2007";20;"54.9";11019;68499;57480
368;"03.01.2007";21;"43.7";11744;65220;53476
368;"03.01.2007";22;"33.4";12389;63161;50772
368;"03.01.2007";23;"30.5";13189;62111;48922
368;"03.01.2007";24;"25.1";13437;57455;44018
369;"04.01.2007";1;"27.7";13304;52841;39537
369;"04.01.2007";2;"23.3";13120;50607;37487
369;"04.01.2007";3;"17.9";13268;49652;36384
369;"04.01.2007";4;"15.1";13309;49953;36644
369;"04.01.2007";5;"12.1";13206;50768;37562
369;"04.01.2007";6;"23.9";13259;52567;39308
369;"04.01.2007";7;"20.4";13435;56873;43438
369;"04.01.2007";8;"26.7";13491;62897;49406
369;"04.01.2007";9;32;13611;66611;53000
369;"04.01.2007";10;29;13299;67938;54639
369;"04.01.2007";11;"28.4";12970;69251;56281
369;"04.01.2007";12;"28.4";13065;70978;57913
369;"04.01.2007";13;29;13420;70614;57194
369;"04.01.2007";14;"32.4";13324;69629;56305
369;"04.01.2007";15;"28.8";13056;68365;55309
369;"04.01.2007";16;"32.3";13116;68116;55000
369;"04.01.2007";17;"32.5";13265;69343;56078
369;"04.01.2007";18;"48.2";13597;72178;58581
369;"04.01.2007";19;"49.4";13785;72030;58245
369;"04.01.2007";20;"38.3";14085;69987;55902
369;"04.01.2007";21;"27.6";14425;66487;52062
369;"04.01.2007";22;"27.4";14661;64427;49766
369;"04.01.2007";23;"27.7";14482;62819;48337
369;"04.01.2007";24;20;14277;58248;43971
370;"05.01.2007";1;"27.9";14191;54485;40294
370;"05.01.2007";2;"25.4";13838;52034;38196
370;"05.01.2007";3;20;13609;50841;37232
370;"05.01.2007";4;"22.3";13081;50643;37562
370;"05.01.2007";5;"15.2";12509;51536;39027
370;"05.01.2007";6;29;12128;53491;41363
370;"05.01.2007";7;"28.2";11401;56961;45560
370;"05.01.2007";8;"35.2";10804;62820;52016
370;"05.01.2007";9;"32.8";10044;66140;56096
370;"05.01.2007";10;"42.1";9373;67352;57979
370;"05.01.2007";11;45;9616;68832;59216
370;"05.01.2007";12;"54.9";9621;70156;60535
370;"05.01.2007";13;50;9432;69827;60395
370;"05.01.2007";14;"48.9";9062;68101;59039
370;"05.01.2007";15;39;8120;66397;58277
370;"05.01.2007";16;35;7538;65803;58265
370;"05.01.2007";17;"31.2";7347;67634;60287
370;"05.01.2007";18;"53.9";7550;70186;62636
370;"05.01.2007";19;"54.8";7787;69431;61644
370;"05.01.2007";20;"40.8";8253;66750;58497
370;"05.01.2007";21;"31.1";8835;62768;53933
370;"05.01.2007";22;"28.1";8842;60465;51623
370;"05.01.2007";23;"32.9";8754;59561;50807
370;"05.01.2007";24;"29.6";8576;55298;46722
371;"06.01.2007";1;25;8142;51141;42999
371;"06.01.2007";2;"21.8";7679;48387;40708
371;"06.01.2007";3;"20.9";7145;46975;39830
371;"06.01.2007";4;"18.9";6925;46727;39802
371;"06.01.2007";5;"16.3";6491;46791;40300
371;"06.01.2007";6;"21.4";5974;45733;39759
371;"06.01.2007";7;"11.2";5405;44531;39126
371;"06.01.2007";8;"19.9";5090;46809;41719
371;"06.01.2007";9;"24.8";4941;49729;44788
371;"06.01.2007";10;"27.6";4868;52794;47926
371;"06.01.2007";11;32;4699;55505;50806
371;"06.01.2007";12;"33.9";4622;57308;52686
371;"06.01.2007";13;"35.9";4473;56852;52379
371;"06.01.2007";14;"29.5";4323;55214;50891
371;"06.01.2007";15;"27.7";3718;53362;49644
371;"06.01.2007";16;"26.6";3118;53188;50070
371;"06.01.2007";17;27;2813;56010;53197
371;"06.01.2007";18;"37.6";3056;59939;56883
371;"06.01.2007";19;"44.7";3401;59987;56586
371;"06.01.2007";20;"40.2";3630;58252;54622
371;"06.01.2007";21;"27.7";3880;54607;50727
371;"06.01.2007";22;"26.9";4114;53165;49051
371;"06.01.2007";23;"26.7";4335;53039;48704
371;"06.01.2007";24;"24.1";4484;49290;44806
372;"07.01.2007";1;"19.6";4921;45469;40548
372;"07.01.2007";2;"16.9";5562;42934;37372
372;"07.01.2007";3;"15.6";5403;41431;36028
372;"07.01.2007";4;"12.1";5297;40937;35640
372;"07.01.2007";5;"14.8";5413;41588;36175
372;"07.01.2007";6;"14.7";5157;40849;35692
372;"07.01.2007";7;"5.5";5147;39156;34009
372;"07.01.2007";8;"8.2";5097;40688;35591
372;"07.01.2007";9;"10.3";5315;43357;38042
372;"07.01.2007";10;"19.8";5768;46663;40895
372;"07.01.2007";11;"25.7";6034;49284;43250
372;"07.01.2007";12;"28.9";6913;52677;45764
372;"07.01.2007";13;"27.7";7383;52629;45246
372;"07.01.2007";14;25;7772;50549;42777
372;"07.01.2007";15;"23.2";7811;49159;41348
372;"07.01.2007";16;"12.9";8109;49143;41034
372;"07.01.2007";17;11;8527;51529;43002
372;"07.01.2007";18;"27.3";9058;57318;48260
372;"07.01.2007";19;"34.4";9638;59181;49543
372;"07.01.2007";20;"35.6";10064;58163;48099
372;"07.01.2007";21;"27.1";10155;55907;45752
372;"07.01.2007";22;"25.9";9663;55087;45424
372;"07.01.2007";23;"28.9";9395;55756;46361
372;"07.01.2007";24;"20.1";9157;51790;42633
373;"08.01.2007";1;"14.7";8190;47912;39722
373;"08.01.2007";2;"11.1";8286;45977;37691
373;"08.01.2007";3;"11.2";8650;45830;37180
373;"08.01.2007";4;"10.8";9367;46611;37244
373;"08.01.2007";5;"11.2";9901;47801;37900
373;"08.01.2007";6;20;10441;51055;40614
373;"08.01.2007";7;"25.7";10593;58411;47818
373;"08.01.2007";8;"42.1";11518;66772;55254
373;"08.01.2007";9;"49.8";11759;69692;57933
373;"08.01.2007";10;48;12217;70120;57903
373;"08.01.2007";11;"48.7";12106;71021;58915
373;"08.01.2007";12;"49.9";11845;72347;60502
373;"08.01.2007";13;"49.9";11149;71955;60806
373;"08.01.2007";14;"49.3";10023;71358;61335
373;"08.01.2007";15;48;9041;69969;60928
373;"08.01.2007";16;"47.9";8175;69014;60839
373;"08.01.2007";17;52;7564;69454;61890
373;"08.01.2007";18;"59.6";6983;72367;65384
373;"08.01.2007";19;64;7030;72161;65131
373;"08.01.2007";20;"54.1";7259;70230;62971
373;"08.01.2007";21;"41.9";7888;65785;57897
373;"08.01.2007";22;"31.6";8345;63335;54990
373;"08.01.2007";23;"30.1";8980;61286;52306
373;"08.01.2007";24;"25.6";9852;55853;46001
374;"09.01.2007";1;25;10733;51609;40876
374;"09.01.2007";2;"22.1";11460;49621;38161
374;"09.01.2007";3;"14.7";11678;48926;37248
374;"09.01.2007";4;"13.9";11689;49402;37713
374;"09.01.2007";5;"18.9";11558;51010;39452
374;"09.01.2007";6;"24.4";11501;53453;41952
374;"09.01.2007";7;"25.1";11831;60684;48853
374;"09.01.2007";8;"39.1";12465;68001;55536
374;"09.01.2007";9;"39.1";13166;71121;57955
374;"09.01.2007";10;40;13341;70889;57548
374;"09.01.2007";11;"39.1";13614;71949;58335
374;"09.01.2007";12;"36.8";13881;73062;59181
374;"09.01.2007";13;"33.1";14275;72482;58207
374;"09.01.2007";14;30;14318;71970;57652
374;"09.01.2007";15;"27.9";14641;71321;56680
374;"09.01.2007";16;"27.6";14534;70789;56255
374;"09.01.2007";17;28;14559;71596;57037
374;"09.01.2007";18;"39.9";14349;74538;60189
374;"09.01.2007";19;"41.4";14452;74431;59979
374;"09.01.2007";20;28;14309;72388;58079
374;"09.01.2007";21;"39.1";14408;68146;53738
374;"09.01.2007";22;"26.7";14236;65171;50935
374;"09.01.2007";23;"25.2";14051;63034;48983
374;"09.01.2007";24;"20.5";13971;57649;43678
375;"10.01.2007";1;"5.1";13835;53256;39421
375;"10.01.2007";2;"1.4";13585;50940;37355
375;"10.01.2007";3;"2.6";13690;50013;36323
375;"10.01.2007";4;"9.9";13575;50586;37011
375;"10.01.2007";5;"9.7";13445;52154;38709
375;"10.01.2007";6;"14.6";13285;55012;41727
375;"10.01.2007";7;"22.3";13495;61887;48392
375;"10.01.2007";8;"36.1";13492;69015;55523
375;"10.01.2007";9;"39.9";13156;70865;57709
375;"10.01.2007";10;39;12871;69931;57060
375;"10.01.2007";11;"39.1";13471;70402;56931
375;"10.01.2007";12;"40.1";13787;71401;57614
375;"10.01.2007";13;"40.2";13802;70527;56725
375;"10.01.2007";14;38;13844;70201;56357
375;"10.01.2007";15;"35.5";14136;69603;55467
375;"10.01.2007";16;"32.6";14521;69281;54760
375;"10.01.2007";17;"28.1";14931;70832;55901
375;"10.01.2007";18;"49.9";15086;74758;59672
375;"10.01.2007";19;"50.5";15211;74475;59264
375;"10.01.2007";20;"42.2";15272;72296;57024
375;"10.01.2007";21;"27.4";15243;68443;53200
375;"10.01.2007";22;27;15459;66162;50703
375;"10.01.2007";23;"26.8";15317;63896;48579
375;"10.01.2007";24;"23.1";15252;58318;43066
376;"11.01.2007";1;"14.7";15442;55124;39682
376;"11.01.2007";2;"10.6";15286;53247;37961
376;"11.01.2007";3;7;14355;52557;38202
376;"11.01.2007";4;"10.8";14020;53017;38997
376;"11.01.2007";5;12;13577;53810;40233
376;"11.01.2007";6;23;13958;56113;42155
376;"11.01.2007";7;"25.2";15000;62312;47312
376;"11.01.2007";8;"37.9";15264;69350;54086
376;"11.01.2007";9;"43.3";15549;71425;55876
376;"11.01.2007";10;"41.9";15873;71376;55503
376;"11.01.2007";11;"39.9";16504;72203;55699
376;"11.01.2007";12;"39.9";16446;73581;57135
376;"11.01.2007";13;"34.2";16865;73417;56552
376;"11.01.2007";14;32;16910;73319;56409
376;"11.01.2007";15;"27.8";16924;73031;56107
376;"11.01.2007";16;"27.5";16651;73148;56497
376;"11.01.2007";17;"27.7";16295;73659;57364
376;"11.01.2007";18;"34.4";16603;76582;59979
376;"11.01.2007";19;"33.3";16370;75558;59188
376;"11.01.2007";20;"27.6";16433;73315;56882
376;"11.01.2007";21;"27.6";16497;69395;52898
376;"11.01.2007";22;"25.5";16777;66803;50026
376;"11.01.2007";23;"24.3";17008;64273;47265
376;"11.01.2007";24;"13.1";17018;59469;42451
377;"12.01.2007";1;"11.1";16777;55679;38902
377;"12.01.2007";2;"0.6";16768;53663;36895
377;"12.01.2007";3;"2.2";16659;52957;36298
377;"12.01.2007";4;5;16487;53366;36879
377;"12.01.2007";5;"10.7";16114;54674;38560
377;"12.01.2007";6;"18.9";16037;56793;40756
377;"12.01.2007";7;"24.1";15655;63181;47526
377;"12.01.2007";8;29;15181;70316;55135
377;"12.01.2007";9;"33.5";14582;72118;57536
377;"12.01.2007";10;"32.2";13880;71429;57549
377;"12.01.2007";11;"33.2";13268;71616;58348
377;"12.01.2007";12;"31.9";13718;72569;58851
377;"12.01.2007";13;"33.1";14204;71799;57595
377;"12.01.2007";14;"27.9";14553;70583;56030
377;"12.01.2007";15;"31.5";14004;69013;55009
377;"12.01.2007";16;"29.5";13734;68912;55178
377;"12.01.2007";17;"29.2";13696;69975;56279
377;"12.01.2007";18;44;15178;73546;58368
377;"12.01.2007";19;"38.1";16112;73167;57055
377;"12.01.2007";20;"36.2";16476;70753;54277
377;"12.01.2007";21;"27.3";16749;66410;49661
377;"12.01.2007";22;"22.3";17195;63926;46731
377;"12.01.2007";23;"23.1";17189;62760;45571
377;"12.01.2007";24;11;17165;58731;41566
378;"13.01.2007";1;"22.3";17036;55196;38160
378;"13.01.2007";2;"12.4";16853;52790;35937
378;"13.01.2007";3;"1.7";16584;51347;34763
378;"13.01.2007";4;"2.1";16829;51396;34567
378;"13.01.2007";5;"0.1";16651;51783;35132
378;"13.01.2007";6;"3.8";16133;51315;35182
378;"13.01.2007";7;"0.1";15787;51273;35486
378;"13.01.2007";8;"18.9";15686;54578;38892
378;"13.01.2007";9;"26.1";15451;58071;42620
378;"13.01.2007";10;"31.2";14603;60459;45856
378;"13.01.2007";11;"32.9";14019;62241;48222
378;"13.01.2007";12;"33.9";13278;62984;49706
378;"13.01.2007";13;"35.9";12782;61915;49133
378;"13.01.2007";14;32;11286;59733;48447
378;"13.01.2007";15;"31.9";9579;57195;47616
378;"13.01.2007";16;"28.9";8445;56707;48262
378;"13.01.2007";17;"37.9";7121;57277;50156
378;"13.01.2007";18;"54.1";6622;61839;55217
378;"13.01.2007";19;"53.7";7583;62378;54795
378;"13.01.2007";20;"41.6";9068;60218;51150
378;"13.01.2007";21;34;10060;56334;46274
378;"13.01.2007";22;"29.4";10940;54558;43618
378;"13.01.2007";23;30;12084;54871;42787
378;"13.01.2007";24;"18.6";12803;51531;38728
379;"14.01.2007";1;"15.5";13727;48093;34366
379;"14.01.2007";2;"2.1";14331;46078;31747
379;"14.01.2007";3;"3.8";14894;45565;30671
379;"14.01.2007";4;"3.9";15399;45681;30282
379;"14.01.2007";5;7;15907;46590;30683
379;"14.01.2007";6;"2.1";16072;46064;29992
379;"14.01.2007";7;0;15583;44483;28900
379;"14.01.2007";8;"1.1";15333;45872;30539
379;"14.01.2007";9;"12.1";15023;48274;33251
379;"14.01.2007";10;"16.4";15027;51212;36185
379;"14.01.2007";11;"24.2";15277;54126;38849
379;"14.01.2007";12;28;15186;56582;41396
379;"14.01.2007";13;"27.7";15165;55970;40805
379;"14.01.2007";14;"25.4";14868;53748;38880
379;"14.01.2007";15;"20.2";14114;51842;37728
379;"14.01.2007";16;14;13095;51241;38146
379;"14.01.2007";17;"17.6";12197;52213;40016
379;"14.01.2007";18;"30.5";11819;58242;46423
379;"14.01.2007";19;"35.2";11768;60954;49186
379;"14.01.2007";20;"36.1";11855;60112;48257
379;"14.01.2007";21;"34.6";11823;57738;45915
379;"14.01.2007";22;30;11370;56924;45554
379;"14.01.2007";23;33;10568;57181;46613
379;"14.01.2007";24;"28.3";9333;53517;44184
380;"15.01.2007";1;"20.1";8443;50572;42129
380;"15.01.2007";2;"17.7";8016;48895;40879
380;"15.01.2007";3;"16.7";7386;48315;40929
380;"15.01.2007";4;"14.2";7376;48553;41177
380;"15.01.2007";5;"22.6";7278;49724;42446
380;"15.01.2007";6;"22.5";7024;52264;45240
380;"15.01.2007";7;26;7117;60012;52895
380;"15.01.2007";8;41;7379;67971;60592
380;"15.01.2007";9;"42.2";7182;70047;62865
380;"15.01.2007";10;"44.1";6881;69173;62292
380;"15.01.2007";11;"45.6";6264;69485;63221
380;"15.01.2007";12;48;5833;70232;64399
380;"15.01.2007";13;"48.2";5853;69540;63687
380;"15.01.2007";14;"47.6";5887;68969;63082
380;"15.01.2007";15;45;5474;68099;62625
380;"15.01.2007";16;42;4834;67322;62488
380;"15.01.2007";17;40;4786;68053;63267
380;"15.01.2007";18;49;5283;73067;67784
380;"15.01.2007";19;"51.9";6013;73408;67395
380;"15.01.2007";20;"44.1";6726;71424;64698
380;"15.01.2007";21;"38.6";7249;67122;59873
380;"15.01.2007";22;31;7391;64127;56736
380;"15.01.2007";23;"28.9";7378;62086;54708
380;"15.01.2007";24;"25.2";7145;57260;50115
381;"16.01.2007";1;"24.9";7109;53732;46623
381;"16.01.2007";2;"25.9";7463;51741;44278
381;"16.01.2007";3;24;7735;50897;43162
381;"16.01.2007";4;"22.5";7880;51133;43253
381;"16.01.2007";5;"22.6";8026;52348;44322
381;"16.01.2007";6;"26.7";8150;55063;46913
381;"16.01.2007";7;"26.4";8266;62139;53873
381;"16.01.2007";8;44;7928;69245;61317
381;"16.01.2007";9;"48.6";7844;71156;63312
381;"16.01.2007";10;"43.1";7508;70606;63098
381;"16.01.2007";11;"43.9";7283;71082;63799
381;"16.01.2007";12;"44.9";7026;72048;65022
381;"16.01.2007";13;46;6163;71277;65114
381;"16.01.2007";14;"43.9";5533;70566;65033
381;"16.01.2007";15;43;5140;69957;64817
381;"16.01.2007";16;"41.9";4592;69507;64915
381;"16.01.2007";17;"43.1";4691;69933;65242
381;"16.01.2007";18;"53.2";4999;73342;68343
381;"16.01.2007";19;60;5513;73543;68030
381;"16.01.2007";20;50;6250;71326;65076
381;"16.01.2007";21;"41.9";6213;67352;61139
381;"16.01.2007";22;"31.9";6303;64665;58362
381;"16.01.2007";23;"30.7";6275;62203;55928
381;"16.01.2007";24;"24.6";6382;56877;50495
382;"17.01.2007";1;24;6094;52786;46692
382;"17.01.2007";2;23;6106;50256;44150
382;"17.01.2007";3;"22.9";6212;49073;42861
382;"17.01.2007";4;"19.6";6507;49613;43106
382;"17.01.2007";5;"23.8";6817;51391;44574
382;"17.01.2007";6;23;6963;54045;47082
382;"17.01.2007";7;"24.3";7426;61481;54055
382;"17.01.2007";8;"43.8";8230;69175;60945
382;"17.01.2007";9;"45.6";8745;71218;62473
382;"17.01.2007";10;44;9467;70601;61134
382;"17.01.2007";11;"44.1";9863;71367;61504
382;"17.01.2007";12;44;10503;72305;61802
382;"17.01.2007";13;"43.9";11499;71895;60396
382;"17.01.2007";14;"40.7";12146;71527;59381
382;"17.01.2007";15;"34.2";12471;70654;58183
382;"17.01.2007";16;"33.1";12938;70441;57503
382;"17.01.2007";17;"34.9";14274;71162;56888
382;"17.01.2007";18;39;15504;74814;59310
382;"17.01.2007";19;42;16255;75337;59082
382;"17.01.2007";20;28;16268;73204;56936
382;"17.01.2007";21;"29.1";16448;69573;53125
382;"17.01.2007";22;"26.1";16475;67071;50596
382;"17.01.2007";23;"24.1";15458;64784;49326
382;"17.01.2007";24;17;14938;58987;44049
383;"18.01.2007";1;"22.2";13630;54246;40616
383;"18.01.2007";2;"15.6";12092;51366;39274
383;"18.01.2007";3;"12.8";10444;49833;39389
383;"18.01.2007";4;"15.8";10056;50415;40359
383;"18.01.2007";5;"15.6";8820;50997;42177
383;"18.01.2007";6;29;7959;53429;45470
383;"18.01.2007";7;"25.1";8197;60639;52442
383;"18.01.2007";8;40;7946;67917;59971
383;"18.01.2007";9;"43.9";7941;70083;62142
383;"18.01.2007";10;39;8830;70464;61634
383;"18.01.2007";11;"42.2";9979;71995;62016
383;"18.01.2007";12;"50.7";12013;73868;61855
383;"18.01.2007";13;"50.1";13436;74130;60694
383;"18.01.2007";14;"33.1";14665;74028;59363
383;"18.01.2007";15;33;15372;73509;58137
383;"18.01.2007";16;31;14911;72964;58053
383;"18.01.2007";17;"36.9";13675;72400;58725
383;"18.01.2007";18;57;12510;74423;61913
383;"18.01.2007";19;55;12249;72640;60391
383;"18.01.2007";20;"42.1";11756;69127;57371
383;"18.01.2007";21;"30.2";11192;64844;53652
383;"18.01.2007";22;26;10736;61453;50717
383;"18.01.2007";23;24;9673;59034;49361
383;"18.01.2007";24;"17.5";9060;53803;44743
384;"19.01.2007";1;"17.1";10163;50963;40800
384;"19.01.2007";2;"11.5";11201;49423;38222
384;"19.01.2007";3;12;11158;49114;37956
384;"19.01.2007";4;"8.6";10737;49902;39165
384;"19.01.2007";5;"6.8";10254;51626;41372
384;"19.01.2007";6;20;10005;53940;43935
384;"19.01.2007";7;"20.2";10141;60446;50305
384;"19.01.2007";8;"28.2";10025;68210;58185
384;"19.01.2007";9;"32.1";10459;70376;59917
384;"19.01.2007";10;"32.8";11681;70634;58953
384;"19.01.2007";11;"31.1";12914;71628;58714
384;"19.01.2007";12;"32.1";14727;72944;58217
384;"19.01.2007";13;"30.5";15609;72200;56591
384;"19.01.2007";14;"28.8";15954;70832;54878
384;"19.01.2007";15;27;16248;69426;53178
384;"19.01.2007";16;"26.3";16585;68901;52316
384;"19.01.2007";17;"26.7";16317;69053;52736
384;"19.01.2007";18;"45.5";15430;72976;57546
384;"19.01.2007";19;"35.5";14702;73312;58610
384;"19.01.2007";20;"27.1";13356;70419;57063
384;"19.01.2007";21;"25.3";11723;65714;53991
384;"19.01.2007";22;"22.3";10455;62667;52212
384;"19.01.2007";23;"22.2";9194;61244;52050
384;"19.01.2007";24;17;7979;56559;48580
385;"20.01.2007";1;"17.7";7129;51801;44672
385;"20.01.2007";2;"15.5";6539;48612;42073
385;"20.01.2007";3;"13.3";6252;47042;40790
385;"20.01.2007";4;11;7215;46953;39738
385;"20.01.2007";5;5;8775;47674;38899
385;"20.01.2007";6;11;9985;47421;37436
385;"20.01.2007";7;"0.6";11218;48114;36896
385;"20.01.2007";8;"10.3";12546;52133;39587
385;"20.01.2007";9;"19.2";13761;56825;43064
385;"20.01.2007";10;"22.3";14501;59875;45374
385;"20.01.2007";11;"22.7";15267;61852;46585
385;"20.01.2007";12;"22.3";16215;63330;47115
385;"20.01.2007";13;"22.8";16776;62548;45772
385;"20.01.2007";14;"19.6";16806;60691;43885
385;"20.01.2007";15;18;16897;59069;42172
385;"20.01.2007";16;15;16677;58879;42202
385;"20.01.2007";17;"14.7";16584;59629;43045
385;"20.01.2007";18;"22.2";16384;64004;47620
385;"20.01.2007";19;"28.1";15644;64906;49262
385;"20.01.2007";20;"22.8";15197;62231;47034
385;"20.01.2007";21;18;14374;58075;43701
385;"20.01.2007";22;"13.6";14092;56197;42105
385;"20.01.2007";23;"14.7";13901;56154;42253
385;"20.01.2007";24;"10.2";13117;52724;39607
386;"21.01.2007";1;"11.2";13098;49064;35966
386;"21.01.2007";2;"5.9";13329;46524;33195
386;"21.01.2007";3;"1.5";13349;45716;32367
386;"21.01.2007";4;"0.6";13497;46022;32525
386;"21.01.2007";5;"0.6";13906;46557;32651
386;"21.01.2007";6;"0.5";14183;45858;31675
386;"21.01.2007";7;0;14511;43939;29428
386;"21.01.2007";8;"0.1";14784;45100;30316
386;"21.01.2007";9;"0.3";14610;47677;33067
386;"21.01.2007";10;7;15018;50963;35945
386;"21.01.2007";11;"13.3";15182;54278;39096
386;"21.01.2007";12;"20.1";15730;57307;41577
386;"21.01.2007";13;"18.9";16043;56662;40619
386;"21.01.2007";14;17;15926;54452;38526
386;"21.01.2007";15;"11.2";15779;52528;36749
386;"21.01.2007";16;"11.1";16057;52422;36365
386;"21.01.2007";17;"6.5";15723;53632;37909
386;"21.01.2007";18;"25.1";15108;58991;43883
386;"21.01.2007";19;29;14155;61625;47470
386;"21.01.2007";20;"29.7";13298;60403;47105
386;"21.01.2007";21;"28.1";12906;57774;44868
386;"21.01.2007";22;"23.4";12622;56908;44286
386;"21.01.2007";23;"25.7";11917;57420;45503
386;"21.01.2007";24;"19.2";11321;53787;42466
387;"22.01.2007";1;"20.7";11112;50976;39864
387;"22.01.2007";2;"19.7";10948;49068;38120
387;"22.01.2007";3;"19.9";10669;48365;37696
387;"22.01.2007";4;"12.9";10400;49166;38766
387;"22.01.2007";5;"16.7";9894;50527;40633
387;"22.01.2007";6;"23.6";9187;53639;44452
387;"22.01.2007";7;"24.7";8581;61012;52431
387;"22.01.2007";8;"49.5";7987;68304;60317
387;"22.01.2007";9;"53.7";7519;70341;62822
387;"22.01.2007";10;"54.7";7665;70144;62479
387;"22.01.2007";11;55;8141;71255;63114
387;"22.01.2007";12;"52.5";8334;72270;63936
387;"22.01.2007";13;"50.3";8643;71767;63124
387;"22.01.2007";14;"52.6";8694;71442;62748
387;"22.01.2007";15;"51.3";8184;70837;62653
387;"22.01.2007";16;"50.1";7873;70286;62413
387;"22.01.2007";17;54;7443;70065;62622
387;"22.01.2007";18;"63.4";6659;73552;66893
387;"22.01.2007";19;"67.8";6056;74020;67964
387;"22.01.2007";20;51;5880;71861;65981
387;"22.01.2007";21;"41.4";4543;67319;62776
387;"22.01.2007";22;"30.7";3556;64321;60765
387;"22.01.2007";23;"29.7";3114;62610;59496
387;"22.01.2007";24;"24.8";2385;57528;55143
388;"23.01.2007";1;"33.9";1900;54483;52583
388;"23.01.2007";2;"26.2";1732;52697;50965
388;"23.01.2007";3;"28.1";1660;51773;50113
388;"23.01.2007";4;"26.5";1845;51782;49937
388;"23.01.2007";5;"26.9";1803;52605;50802
388;"23.01.2007";6;"26.7";1985;54792;52807
388;"23.01.2007";7;"30.3";2106;61288;59182
388;"23.01.2007";8;"62.8";2031;68248;66217
388;"23.01.2007";9;"62.8";1964;69375;67411
388;"23.01.2007";10;59;1910;69077;67167
388;"23.01.2007";11;"62.8";1724;69810;68086
388;"23.01.2007";12;"62.9";1705;70554;68849
388;"23.01.2007";13;"61.7";1812;70189;68377
388;"23.01.2007";14;"55.2";1743;70016;68273
388;"23.01.2007";15;"53.3";1877;69541;67664
388;"23.01.2007";16;"51.9";2120;68723;66603
388;"23.01.2007";17;"62.8";2169;68767;66598
388;"23.01.2007";18;"110.1";2280;72617;70337
388;"23.01.2007";19;"114.9";2541;73350;70809
388;"23.01.2007";20;"76.9";2806;71449;68643
388;"23.01.2007";21;58;2775;67737;64962
388;"23.01.2007";22;"41.7";2593;65311;62718
388;"23.01.2007";23;"38.5";2593;63905;61312
388;"23.01.2007";24;"30.5";2547;59956;57409
389;"24.01.2007";1;"29.5";2458;57148;54690
389;"24.01.2007";2;"28.5";2393;55331;52938
389;"24.01.2007";3;"27.1";2254;53852;51598
389;"24.01.2007";4;"23.5";2283;53283;51000
389;"24.01.2007";5;"23.1";2376;53798;51422
389;"24.01.2007";6;"27.1";2378;55942;53564
389;"24.01.2007";7;"30.4";2433;62224;59791
389;"24.01.2007";8;"55.2";2610;69002;66392
389;"24.01.2007";9;"64.2";2452;70462;68010
389;"24.01.2007";10;"65.1";2504;70406;67902
389;"24.01.2007";11;"64.6";2368;71120;68752
389;"24.01.2007";12;"63.8";2274;71980;69706
389;"24.01.2007";13;"57.9";2455;71390;68935
389;"24.01.2007";14;60;2825;71186;68361
389;"24.01.2007";15;51;3298;70432;67134
389;"24.01.2007";16;"47.1";3530;69636;66106
389;"24.01.2007";17;46;3639;69285;65646
389;"24.01.2007";18;50;3889;73584;69695
389;"24.01.2007";19;58;4124;74559;70435
389;"24.01.2007";20;52;4396;72828;68432
389;"24.01.2007";21;"47.7";4969;68866;63897
389;"24.01.2007";22;"31.3";5274;66856;61582
389;"24.01.2007";23;"30.4";5103;65608;60505
389;"24.01.2007";24;"23.2";5023;61863;56840
390;"25.01.2007";1;"27.9";4895;59045;54150
390;"25.01.2007";2;"26.9";5247;56967;51720
390;"25.01.2007";3;"27.5";5220;55618;50398
390;"25.01.2007";4;"26.4";4995;54634;49639
390;"25.01.2007";5;"27.1";4866;54367;49501
390;"25.01.2007";6;"28.9";4788;56395;51607
390;"25.01.2007";7;"34.5";4656;63046;58390
390;"25.01.2007";8;"58.5";4338;69435;65097
390;"25.01.2007";9;"58.1";3700;70367;66667
390;"25.01.2007";10;"58.3";3116;70033;66917
390;"25.01.2007";11;"60.3";2887;70421;67534
390;"25.01.2007";12;"64.8";2831;71287;68456
390;"25.01.2007";13;"69.8";2274;70863;68589
390;"25.01.2007";14;"75.5";2033;70639;68606
390;"25.01.2007";15;"69.9";1748;69911;68163
390;"25.01.2007";16;"64.7";1520;69055;67535
390;"25.01.2007";17;"67.4";1252;68576;67324
390;"25.01.2007";18;"100.1";1182;72622;71440
390;"25.01.2007";19;300;1056;73947;72891
390;"25.01.2007";20;"90.4";1056;72075;71019
390;"25.01.2007";21;"69.5";1067;68494;67427
390;"25.01.2007";22;"58.6";1062;65859;64797
390;"25.01.2007";23;"54.2";1222;64819;63597
390;"25.01.2007";24;46;1571;61501;59930
391;"26.01.2007";1;"36.5";2008;59302;57294
391;"26.01.2007";2;"32.1";2715;57610;54895
391;"26.01.2007";3;"27.4";3567;56206;52639
391;"26.01.2007";4;26;4427;55651;51224
391;"26.01.2007";5;24;5386;56284;50898
391;"26.01.2007";6;"23.3";6576;58169;51593
391;"26.01.2007";7;"27.3";7637;64457;56820
391;"26.01.2007";8;52;8496;71264;62768
391;"26.01.2007";9;"52.5";9436;73190;63754
391;"26.01.2007";10;"49.6";10489;73496;63007
391;"26.01.2007";11;"48.3";11831;74286;62455
391;"26.01.2007";12;"43.1";12520;75082;62562
391;"26.01.2007";13;"37.3";13211;74790;61579
391;"26.01.2007";14;35;13679;73729;60050
391;"26.01.2007";15;32;13380;72499;59119
391;"26.01.2007";16;"30.8";13460;71852;58392
391;"26.01.2007";17;"31.9";13706;72360;58654
391;"26.01.2007";18;45;13584;75785;62201
391;"26.01.2007";19;"42.8";13324;75897;62573
391;"26.01.2007";20;"41.4";13121;73214;60093
391;"26.01.2007";21;40;12831;69349;56518
391;"26.01.2007";22;"28.1";12109;67100;54991
391;"26.01.2007";23;"27.5";11838;66137;54299
391;"26.01.2007";24;24;12010;63608;51598
392;"27.01.2007";1;"30.8";11709;60572;48863
392;"27.01.2007";2;"26.1";11011;58091;47080
392;"27.01.2007";3;"24.7";10686;55797;45111
392;"27.01.2007";4;"22.2";10356;54687;44331
392;"27.01.2007";5;"18.7";10241;53619;43378
392;"27.01.2007";6;"14.7";10290;52424;42134
392;"27.01.2007";7;8;10585;51631;41046
392;"27.01.2007";8;"24.5";10365;54739;44374
392;"27.01.2007";9;"16.8";9814;57448;47634
392;"27.01.2007";10;"24.6";9355;60287;50932
392;"27.01.2007";11;"34.9";8932;62428;53496
392;"27.01.2007";12;"26.8";8740;63643;54903
392;"27.01.2007";13;"24.6";8769;62748;53979
392;"27.01.2007";14;"19.2";8270;60641;52371
392;"27.01.2007";15;"14.7";7456;58597;51141
392;"27.01.2007";16;"14.7";7131;57782;50651
392;"27.01.2007";17;"18.9";6246;58008;51762
392;"27.01.2007";18;"37.3";6013;62586;56573
392;"27.01.2007";19;60;6235;64455;58220
392;"27.01.2007";20;"50.1";6076;61907;55831
392;"27.01.2007";21;"24.7";6592;58278;51686
392;"27.01.2007";22;"20.6";6896;56988;50092
392;"27.01.2007";23;"24.1";6783;58166;51383
392;"27.01.2007";24;"21.5";7144;55187;48043
393;"28.01.2007";1;"28.5";7899;52537;44638
393;"28.01.2007";2;"23.1";8983;50185;41202
393;"28.01.2007";3;"17.6";9693;48841;39148
393;"28.01.2007";4;"7.7";10476;48624;38148
393;"28.01.2007";5;"10.7";11695;48814;37119
393;"28.01.2007";6;"2.3";12570;47800;35230
393;"28.01.2007";7;0;13275;45456;32181
393;"28.01.2007";8;0;13946;46861;32915
393;"28.01.2007";9;"10.7";14665;49680;35015
393;"28.01.2007";10;18;15197;53438;38241
393;"28.01.2007";11;"25.1";15755;56630;40875
393;"28.01.2007";12;"26.2";16327;59441;43114
393;"28.01.2007";13;"25.8";16972;59462;42490
393;"28.01.2007";14;"20.1";17344;57799;40455
393;"28.01.2007";15;12;17560;56677;39117
393;"28.01.2007";16;"9.9";17605;56217;38612
393;"28.01.2007";17;"7.1";17424;56900;39476
393;"28.01.2007";18;"27.9";17288;61036;43748
393;"28.01.2007";19;"32.8";16950;63029;46079
393;"28.01.2007";20;31;16701;61747;45046
393;"28.01.2007";21;"25.7";16769;59717;42948
393;"28.01.2007";22;"22.8";16566;59360;42794
393;"28.01.2007";23;"25.6";16517;60661;44144
393;"28.01.2007";24;"24.9";16682;57876;41194
394;"29.01.2007";1;23;16339;55276;38937
394;"29.01.2007";2;"11.9";15967;53120;37153
394;"29.01.2007";3;"4.8";15355;52134;36779
394;"29.01.2007";4;5;14568;52267;37699
394;"29.01.2007";5;"13.3";13868;53212;39344
394;"29.01.2007";6;"25.2";12843;55365;42522
394;"29.01.2007";7;"28.6";11549;62450;50901
394;"29.01.2007";8;"44.7";10059;69451;59392
394;"29.01.2007";9;"49.9";8804;71310;62506
394;"29.01.2007";10;"51.7";7163;71342;64179
394;"29.01.2007";11;52;6246;72241;65995
394;"29.01.2007";12;"54.5";5603;72812;67209
394;"29.01.2007";13;"55.9";5534;72345;66811
394;"29.01.2007";14;63;5752;71970;66218
394;"29.01.2007";15;"58.7";5146;71001;65855
394;"29.01.2007";16;"53.9";4302;69793;65491
394;"29.01.2007";17;56;3890;68674;64784
394;"29.01.2007";18;"78.6";3794;72145;68351
394;"29.01.2007";19;"89.6";3471;73179;69708
394;"29.01.2007";20;70;3209;71021;67812
394;"29.01.2007";21;"49.3";3067;67156;64089
394;"29.01.2007";22;"36.1";3354;64652;61298
394;"29.01.2007";23;38;3858;63150;59292
394;"29.01.2007";24;"25.9";4580;58392;53812
395;"30.01.2007";1;"30.1";5411;55201;49790
395;"30.01.2007";2;"28.1";6202;53304;47102
395;"30.01.2007";3;"28.1";6962;52572;45610
395;"30.01.2007";4;"26.1";7621;53382;45761
395;"30.01.2007";5;"22.3";8200;54924;46724
395;"30.01.2007";6;"24.4";8594;57041;48447
395;"30.01.2007";7;"30.3";8861;63860;54999
395;"30.01.2007";8;"53.9";8641;70429;61788
395;"30.01.2007";9;58;8302;71915;63613
395;"30.01.2007";10;"57.6";8020;71496;63476
395;"30.01.2007";11;63;8146;72057;63911
395;"30.01.2007";12;"64.5";7709;72880;65171
395;"30.01.2007";13;"60.2";7401;72325;64924
395;"30.01.2007";14;"56.5";6952;71631;64679
395;"30.01.2007";15;54;6465;70772;64307
395;"30.01.2007";16;50;5899;69826;63927
395;"30.01.2007";17;"53.5";4903;69293;64390
395;"30.01.2007";18;"67.3";4483;72427;67944
395;"30.01.2007";19;"75.1";4522;73618;69096
395;"30.01.2007";20;"58.4";4613;71384;66771
395;"30.01.2007";21;"52.4";4924;67433;62509
395;"30.01.2007";22;"38.5";5206;64544;59338
395;"30.01.2007";23;36;5390;62924;57534
395;"30.01.2007";24;"27.7";5945;58305;52360
396;"31.01.2007";1;"26.8";6360;54313;47953
396;"31.01.2007";2;"25.3";6972;52502;45530
396;"31.01.2007";3;"25.1";7183;51453;44270
396;"31.01.2007";4;"24.1";7852;52286;44434
396;"31.01.2007";5;"19.2";8541;53526;44985
396;"31.01.2007";6;"29.3";9059;56313;47254
396;"31.01.2007";7;"30.4";9735;63224;53489
396;"31.01.2007";8;51;10169;70065;59896
396;"31.01.2007";9;"51.4";10864;71552;60688
396;"31.01.2007";10;"52.4";11466;71791;60325
396;"31.01.2007";11;"51.1";12773;72765;59992
396;"31.01.2007";12;"50.3";13871;73926;60055
396;"31.01.2007";13;"49.7";14736;73522;58786
396;"31.01.2007";14;56;14936;73335;58399
396;"31.01.2007";15;50;15234;72603;57369
396;"31.01.2007";16;45;15262;71925;56663
396;"31.01.2007";17;"42.1";15110;71663;56553
396;"31.01.2007";18;"47.7";15256;74638;59382
396;"31.01.2007";19;"53.4";15355;76446;61091
396;"31.01.2007";20;"49.5";15315;74703;59388
396;"31.01.2007";21;"41.5";14734;70370;55636
396;"31.01.2007";22;"26.1";14229;67728;53499
396;"31.01.2007";23;"26.1";13469;66017;52548
396;"31.01.2007";24;"22.8";12581;61317;48736
397;"01.02.2007";1;"22.8";11198;54332;43134
397;"01.02.2007";2;"22.3";10205;52388;42183
397;"01.02.2007";3;"21.8";9301;51501;42200
397;"01.02.2007";4;"22.5";8228;51526;43298
397;"01.02.2007";5;"22.1";7203;52433;45230
397;"01.02.2007";6;26;6511;54705;48194
397;"01.02.2007";7;"29.8";5833;60831;54998
397;"01.02.2007";8;"49.7";4923;67568;62645
397;"01.02.2007";9;"53.6";4062;69171;65109
397;"01.02.2007";10;"54.2";3152;69061;65909
397;"01.02.2007";11;"54.9";2598;69738;67140
397;"01.02.2007";12;"58.8";2389;70666;68277
397;"01.02.2007";13;"55.3";2086;69900;67814
397;"01.02.2007";14;"59.6";1828;69339;67511
397;"01.02.2007";15;"54.7";1779;68434;66655
397;"01.02.2007";16;"53.2";1780;67895;66115
397;"01.02.2007";17;"50.8";1771;67411;65640
397;"01.02.2007";18;"58.9";1953;70828;68875
397;"01.02.2007";19;74;1966;72301;70335
397;"01.02.2007";20;"55.9";1971;70177;68206
397;"01.02.2007";21;"49.7";1830;66940;65110
397;"01.02.2007";22;"41.4";1854;64180;62326
397;"01.02.2007";23;"36.1";2016;62610;60594
397;"01.02.2007";24;"25.4";1925;57990;56065
398;"02.02.2007";1;"34.1";1839;53900;52061
398;"02.02.2007";2;"31.1";1742;51957;50215
398;"02.02.2007";3;"29.5";1747;50792;49045
398;"02.02.2007";4;"25.7";1708;51172;49464
398;"02.02.2007";5;"25.2";1763;51931;50168
398;"02.02.2007";6;"34.6";1942;54451;52509
398;"02.02.2007";7;"43.3";2104;60766;58662
398;"02.02.2007";8;"67.2";2184;67503;65319
398;"02.02.2007";9;"63.8";2357;69394;67037
398;"02.02.2007";10;"62.9";2565;69480;66915
398;"02.02.2007";11;"57.4";2910;70200;67290
398;"02.02.2007";12;"54.6";3624;71079;67455
398;"02.02.2007";13;"49.9";4522;70424;65902
398;"02.02.2007";14;"47.1";5486;69234;63748
398;"02.02.2007";15;"43.9";6708;68402;61694
398;"02.02.2007";16;"38.1";7376;67719;60343
398;"02.02.2007";17;"37.8";8514;67487;58973
398;"02.02.2007";18;"39.9";9381;70710;61329
398;"02.02.2007";19;"44.1";9860;71660;61800
398;"02.02.2007";20;44;10739;69288;58549
398;"02.02.2007";21;"38.5";11060;64877;53817
398;"02.02.2007";22;"32.3";11078;62488;51410
398;"02.02.2007";23;"27.6";11528;61413;49885
398;"02.02.2007";24;"23.4";11603;57309;45706
399;"03.02.2007";1;"34.2";11594;54045;42451
399;"03.02.2007";2;28;11599;51574;39975
399;"03.02.2007";3;"27.9";11987;50377;38390
399;"03.02.2007";4;26;11560;50084;38524
399;"03.02.2007";5;"22.2";11260;50086;38826
399;"03.02.2007";6;"26.8";11042;49869;38827
399;"03.02.2007";7;"25.4";10660;49825;39165
399;"03.02.2007";8;29;10429;53541;43112
399;"03.02.2007";9;31;9624;56595;46971
399;"03.02.2007";10;"40.8";9245;59335;50090
399;"03.02.2007";11;"44.3";9142;60533;51391
399;"03.02.2007";12;"49.7";9055;61195;52140
399;"03.02.2007";13;"40.7";8474;60212;51738
399;"03.02.2007";14;"32.6";7431;58403;50972
399;"03.02.2007";15;"29.5";6783;56887;50104
399;"03.02.2007";16;"25.6";5764;56377;50613
399;"03.02.2007";17;26;4444;56444;52000
399;"03.02.2007";18;"44.4";4174;60570;56396
399;"03.02.2007";19;45;3949;63303;59354
399;"03.02.2007";20;39;3821;60836;57015
399;"03.02.2007";21;"34.2";3641;57274;53633
399;"03.02.2007";22;"32.8";3386;55240;51854
399;"03.02.2007";23;"35.3";3047;55818;52771
399;"03.02.2007";24;"32.1";2890;52407;49517
400;"04.02.2007";1;"28.8";2417;48861;46444
400;"04.02.2007";2;"25.4";2318;46238;43920
400;"04.02.2007";3;"24.5";2388;45128;42740
400;"04.02.2007";4;"20.1";2515;44666;42151
400;"04.02.2007";5;"16.4";2160;44385;42225
400;"04.02.2007";6;"17.1";2065;43360;41295
400;"04.02.2007";7;"14.1";1923;41319;39396
400;"04.02.2007";8;"18.1";1760;43250;41490
400;"04.02.2007";9;24;1844;46458;44614
400;"04.02.2007";10;"27.7";2150;49781;47631
400;"04.02.2007";11;"28.1";2921;52379;49458
400;"04.02.2007";12;"30.1";3923;54866;50943
400;"04.02.2007";13;30;4531;54056;49525
400;"04.02.2007";14;28;4699;51776;47077
400;"04.02.2007";15;"25.3";4706;49791;45085
400;"04.02.2007";16;"18.8";4281;48670;44389
400;"04.02.2007";17;"22.8";3808;48895;45087
400;"04.02.2007";18;"27.8";3570;53214;49644
400;"04.02.2007";19;"33.6";3722;58160;54438
400;"04.02.2007";20;36;4017;58109;54092
400;"04.02.2007";21;"35.2";4138;55388;51250
400;"04.02.2007";22;"31.1";4119;54539;50420
400;"04.02.2007";23;"34.9";4308;56214;51906
400;"04.02.2007";24;"31.1";4352;53478;49126
401;"05.02.2007";1;"25.5";4070;50733;46663
401;"05.02.2007";2;"25.1";3768;49174;45406
401;"05.02.2007";3;"24.2";3482;48295;44813
401;"05.02.2007";4;"19.8";3239;48113;44874
401;"05.02.2007";5;18;3002;48894;45892
401;"05.02.2007";6;"26.3";3155;51226;48071
401;"05.02.2007";7;32;3353;57189;53836
401;"05.02.2007";8;"58.7";3383;63469;60086
401;"05.02.2007";9;"60.1";3231;65839;62608
401;"05.02.2007";10;"59.9";2784;66259;63475
401;"05.02.2007";11;56;2981;68027;65046
401;"05.02.2007";12;58;3263;69675;66412
401;"05.02.2007";13;58;3527;69129;65602
401;"05.02.2007";14;58;3919;68147;64228
401;"05.02.2007";15;"50.9";4181;67407;63226
401;"05.02.2007";16;50;4389;66730;62341
401;"05.02.2007";17;46;4110;65989;61879
401;"05.02.2007";18;"49.3";4268;69235;64967
401;"05.02.2007";19;"59.7";4264;70741;66477
401;"05.02.2007";20;"52.1";4349;68971;64622
401;"05.02.2007";21;"47.3";4560;65522;60962
401;"05.02.2007";22;"34.6";4707;63281;58574
401;"05.02.2007";23;"28.1";4734;62227;57493
401;"05.02.2007";24;"21.9";4391;57493;53102
402;"06.02.2007";1;"24.4";4253;53862;49609
402;"06.02.2007";2;"24.6";4009;51732;47723
402;"06.02.2007";3;"24.8";3694;50950;47256
402;"06.02.2007";4;"24.9";3538;51160;47622
402;"06.02.2007";5;24;3086;52336;49250
402;"06.02.2007";6;"31.2";2988;54709;51721
402;"06.02.2007";7;36;2909;61235;58326
402;"06.02.2007";8;56;2539;68162;65623
402;"06.02.2007";9;"56.8";2436;69727;67291
402;"06.02.2007";10;"56.9";2067;69619;67552
402;"06.02.2007";11;"55.9";1729;70415;68686
402;"06.02.2007";12;"51.5";1517;71152;69635
402;"06.02.2007";13;"50.7";1566;70845;69279
402;"06.02.2007";14;"55.2";1457;70079;68622
402;"06.02.2007";15;"52.6";1354;69466;68112
402;"06.02.2007";16;"49.8";1376;68907;67531
402;"06.02.2007";17;"51.3";1181;67771;66590
402;"06.02.2007";18;"50.7";1186;70816;69630
402;"06.02.2007";19;"71.9";1525;73170;71645
402;"06.02.2007";20;54;1689;71309;69620
402;"06.02.2007";21;"53.2";1913;67567;65654
402;"06.02.2007";22;"42.2";1999;65120;63121
402;"06.02.2007";23;"37.3";1994;63775;61781
402;"06.02.2007";24;"28.1";1758;59432;57674
403;"07.02.2007";1;"28.1";1672;56104;54432
403;"07.02.2007";2;"28.9";1485;54187;52702
403;"07.02.2007";3;"28.1";1404;53572;52168
403;"07.02.2007";4;"28.1";1222;53654;52432
403;"07.02.2007";5;"23.4";1008;54498;53490
403;"07.02.2007";6;"24.8";933;56432;55499
403;"07.02.2007";7;36;901;62999;62098
403;"07.02.2007";8;"57.6";805;69322;68517
403;"07.02.2007";9;"56.1";805;71154;70349
403;"07.02.2007";10;58;837;71220;70383
403;"07.02.2007";11;"58.1";729;71948;71219
403;"07.02.2007";12;"67.1";656;72593;71937
403;"07.02.2007";13;"68.9";618;71971;71353
403;"07.02.2007";14;"67.4";666;71511;70845
403;"07.02.2007";15;"61.4";752;70634;69882
403;"07.02.2007";16;"55.1";787;69914;69127
403;"07.02.2007";17;56;874;69124;68250
403;"07.02.2007";18;"58.1";1198;71902;70704
403;"07.02.2007";19;"112.3";1641;73694;72053
403;"07.02.2007";20;"68.9";1795;71530;69735
403;"07.02.2007";21;"57.6";1781;67672;65891
403;"07.02.2007";22;"46.5";1690;65094;63404
403;"07.02.2007";23;41;1514;63602;62088
403;"07.02.2007";24;"31.9";1401;58975;57574
404;"08.02.2007";1;"25.7";1311;55502;54191
404;"08.02.2007";2;"25.7";1192;53426;52234
404;"08.02.2007";3;"25.7";1111;52448;51337
404;"08.02.2007";4;25;1004;52607;51603
404;"08.02.2007";5;"23.7";997;53576;52579
404;"08.02.2007";6;"27.5";1103;55916;54813
404;"08.02.2007";7;"29.1";1130;62526;61396
404;"08.02.2007";8;"57.5";1375;68626;67251
404;"08.02.2007";9;54;1818;70144;68326
404;"08.02.2007";10;"53.9";2129;70260;68131
404;"08.02.2007";11;54;2276;71271;68995
404;"08.02.2007";12;"53.9";3004;72565;69561
404;"08.02.2007";13;"50.1";4032;72119;68087
404;"08.02.2007";14;"48.7";4909;71663;66754
404;"08.02.2007";15;"46.1";6021;71038;65017
404;"08.02.2007";16;"41.5";6594;69913;63319
404;"08.02.2007";17;"36.1";6902;68572;61670
404;"08.02.2007";18;"41.6";7032;71217;64185
404;"08.02.2007";19;"48.5";6913;73818;66905
404;"08.02.2007";20;"44.3";6906;72195;65289
404;"08.02.2007";21;"46.9";7187;68767;61580
404;"08.02.2007";22;"28.1";6697;66230;59533
404;"08.02.2007";23;"26.4";6537;64847;58310
404;"08.02.2007";24;24;6430;60249;53819
405;"09.02.2007";1;"24.4";6479;57165;50686
405;"09.02.2007";2;"25.6";6507;54865;48358
405;"09.02.2007";3;"22.7";6433;53886;47453
405;"09.02.2007";4;"23.4";6648;54329;47681
405;"09.02.2007";5;"21.6";6632;55366;48734
405;"09.02.2007";6;26;6000;57113;51113
405;"09.02.2007";7;"25.5";5723;63502;57779
405;"09.02.2007";8;"45.7";5462;69086;63624
405;"09.02.2007";9;"50.9";5401;70775;65374
405;"09.02.2007";10;51;5156;70544;65388
405;"09.02.2007";11;50;4942;71201;66259
405;"09.02.2007";12;"50.9";5023;72040;67017
405;"09.02.2007";13;51;4086;71047;66961
405;"09.02.2007";14;"53.2";3624;69322;65698
405;"09.02.2007";15;"49.1";3411;68173;64762
405;"09.02.2007";16;"42.3";2984;67167;64183
405;"09.02.2007";17;"42.6";2436;66473;64037
405;"09.02.2007";18;"48.5";2221;69207;66986
405;"09.02.2007";19;"55.9";2154;71847;69693
405;"09.02.2007";20;52;2261;69624;67363
405;"09.02.2007";21;"42.7";2402;65278;62876
405;"09.02.2007";22;"37.2";2405;62828;60423
405;"09.02.2007";23;"33.8";2496;62319;59823
405;"09.02.2007";24;"28.2";2546;58462;55916
406;"10.02.2007";1;"31.7";2688;55017;52329
406;"10.02.2007";2;"34.9";3123;52952;49829
406;"10.02.2007";3;32;3574;51727;48153
406;"10.02.2007";4;"25.6";4190;51196;47006
406;"10.02.2007";5;"15.9";4641;51132;46491
406;"10.02.2007";6;"18.1";5057;50583;45526
406;"10.02.2007";7;"12.6";5617;50885;45268
406;"10.02.2007";8;"15.3";5796;54141;48345
406;"10.02.2007";9;"26.1";6439;57289;50850
406;"10.02.2007";10;24;6993;59730;52737
406;"10.02.2007";11;"23.8";7404;61518;54114
406;"10.02.2007";12;"23.2";7978;62421;54443
406;"10.02.2007";13;"31.8";7984;61628;53644
406;"10.02.2007";14;32;8119;59971;51852
406;"10.02.2007";15;"28.3";8031;58529;50498
406;"10.02.2007";16;28;7980;57774;49794
406;"10.02.2007";17;"24.8";7461;58040;50579
406;"10.02.2007";18;"22.6";7240;62331;55091
406;"10.02.2007";19;"32.1";7328;64396;57068
406;"10.02.2007";20;"32.1";7476;62027;54551
406;"10.02.2007";21;"30.2";7657;57819;50162
406;"10.02.2007";22;"22.5";7562;55930;48368
406;"10.02.2007";23;"28.1";7633;56531;48898
406;"10.02.2007";24;"21.8";7567;53101;45534
407;"11.02.2007";1;24;7518;49665;42147
407;"11.02.2007";2;"24.1";7546;47276;39730
407;"11.02.2007";3;"20.4";7259;45719;38460
407;"11.02.2007";4;"13.7";6835;45228;38393
407;"11.02.2007";5;"10.1";6574;45144;38570
407;"11.02.2007";6;"13.4";6340;43884;37544
407;"11.02.2007";7;"2.2";6583;41806;35223
407;"11.02.2007";8;"7.1";6891;43195;36304
407;"11.02.2007";9;"16.5";6984;46263;39279
407;"11.02.2007";10;22;7473;49972;42499
407;"11.02.2007";11;"24.3";7662;53305;45643
407;"11.02.2007";12;"25.9";7861;56357;48496
407;"11.02.2007";13;25;8041;55522;47481
407;"11.02.2007";14;"22.7";8368;53321;44953
407;"11.02.2007";15;"19.4";8037;50948;42911
407;"11.02.2007";16;"16.1";7919;50345;42426
407;"11.02.2007";17;11;7139;50326;43187
407;"11.02.2007";18;"24.1";6249;54360;48111
407;"11.02.2007";19;"29.5";5732;58859;53127
407;"11.02.2007";20;28;5264;58094;52830
407;"11.02.2007";21;"26.1";5166;55163;49997
407;"11.02.2007";22;"24.4";5218;54150;48932
407;"11.02.2007";23;"24.9";5063;55451;50388
407;"11.02.2007";24;"22.9";4769;52095;47326
408;"12.02.2007";1;"23.3";4468;48502;44034
408;"12.02.2007";2;"23.2";4247;46475;42228
408;"12.02.2007";3;"20.1";3990;45768;41778
408;"12.02.2007";4;"15.6";3762;46290;42528
408;"12.02.2007";5;"19.9";3419;47659;44240
408;"12.02.2007";6;"24.9";3494;50264;46770
408;"12.02.2007";7;"27.4";3245;56420;53175
408;"12.02.2007";8;"45.1";3258;62699;59441
408;"12.02.2007";9;"47.5";3497;65348;61851
408;"12.02.2007";10;"48.4";3561;66717;63156
408;"12.02.2007";11;49;3578;68417;64839
408;"12.02.2007";12;"48.2";4061;70529;66468
408;"12.02.2007";13;"45.4";4258;69099;64841
408;"12.02.2007";14;45;4431;68200;63769
408;"12.02.2007";15;45;4710;66781;62071
408;"12.02.2007";16;"42.2";4991;65858;60867
408;"12.02.2007";17;"40.9";5651;64876;59225
408;"12.02.2007";18;"49.1";5940;67179;61239
408;"12.02.2007";19;50;6352;70333;63981
408;"12.02.2007";20;"45.1";6537;68869;62332
408;"12.02.2007";21;"31.8";6345;64891;58546
408;"12.02.2007";22;"28.1";6386;62315;55929
408;"12.02.2007";23;"27.2";6673;61018;54345
408;"12.02.2007";24;"23.6";6682;55957;49275
409;"13.02.2007";1;"24.4";6444;52118;45674
409;"13.02.2007";2;"23.1";6385;49834;43449
409;"13.02.2007";3;"22.6";6754;49141;42387
409;"13.02.2007";4;"22.7";6917;49596;42679
409;"13.02.2007";5;"21.9";7211;51113;43902
409;"13.02.2007";6;"27.6";7741;53677;45936
409;"13.02.2007";7;"23.8";7595;60628;53033
409;"13.02.2007";8;"43.1";7408;67556;60148
409;"13.02.2007";9;"40.1";7181;69192;62011
409;"13.02.2007";10;"41.6";7068;69424;62356
409;"13.02.2007";11;"41.1";7570;70449;62879
409;"13.02.2007";12;37;7652;71544;63892
409;"13.02.2007";13;"34.8";7373;70557;63184
409;"13.02.2007";14;"33.4";7305;70190;62885
409;"13.02.2007";15;"32.2";7111;69231;62120
409;"13.02.2007";16;"30.2";7289;68180;60891
409;"13.02.2007";17;"30.8";7400;67122;59722
409;"13.02.2007";18;33;6911;69586;62675
409;"13.02.2007";19;42;6498;72843;66345
409;"13.02.2007";20;"46.1";5974;70995;65021
409;"13.02.2007";21;"40.1";5570;67036;61466
409;"13.02.2007";22;27;5042;64091;59049
409;"13.02.2007";23;"28.7";4759;62644;57885
409;"13.02.2007";24;"25.1";4348;57809;53461
410;"14.02.2007";1;"22.1";4178;53701;49523
410;"14.02.2007";2;"21.4";3762;51717;47955
410;"14.02.2007";3;"18.4";3232;51021;47789
410;"14.02.2007";4;"15.1";2568;51424;48856
410;"14.02.2007";5;"20.5";2204;52762;50558
410;"14.02.2007";6;"23.8";2137;54789;52652
410;"14.02.2007";7;"25.4";2121;60865;58744
410;"14.02.2007";8;"43.1";2140;66970;64830
410;"14.02.2007";9;"51.9";2502;68473;65971
410;"14.02.2007";10;"53.1";2450;68665;66215
410;"14.02.2007";11;56;2265;69518;67253
410;"14.02.2007";12;56;2272;70514;68242
410;"14.02.2007";13;49;2206;69819;67613
410;"14.02.2007";14;"45.1";2243;69870;67627
410;"14.02.2007";15;43;2379;69399;67020
410;"14.02.2007";16;"31.8";2715;68546;65831
410;"14.02.2007";17;"28.1";2915;67885;64970
410;"14.02.2007";18;"30.9";3259;70252;66993
410;"14.02.2007";19;34;3570;72887;69317
410;"14.02.2007";20;33;3558;70920;67362
410;"14.02.2007";21;"25.1";3453;67172;63719
410;"14.02.2007";22;"22.6";3206;63501;60295
410;"14.02.2007";23;"22.5";3215;62040;58825
410;"14.02.2007";24;"13.2";3616;56920;53304
411;"15.02.2007";1;"26.1";3837;53241;49404
411;"15.02.2007";2;"23.8";4000;50631;46631
411;"15.02.2007";3;"23.3";4352;49792;45440
411;"15.02.2007";4;"22.3";4858;49952;45094
411;"15.02.2007";5;"22.2";4871;51132;46261
411;"15.02.2007";6;"26.2";5335;53814;48479
411;"15.02.2007";7;"23.7";5681;60569;54888
411;"15.02.2007";8;43;5748;67079;61331
411;"15.02.2007";9;"43.8";5507;68655;63148
411;"15.02.2007";10;"40.8";5029;68866;63837
411;"15.02.2007";11;43;4679;69452;64773
411;"15.02.2007";12;"46.1";4248;70191;65943
411;"15.02.2007";13;"42.8";3668;69160;65492
411;"15.02.2007";14;"43.7";3372;68338;64966
411;"15.02.2007";15;35;3019;67214;64195
411;"15.02.2007";16;"32.1";2485;66450;63965
411;"15.02.2007";17;"29.1";2223;65762;63539
411;"15.02.2007";18;"35.1";1862;67885;66023
411;"15.02.2007";19;"56.5";1782;72010;70228
411;"15.02.2007";20;46;2084;70663;68579
411;"15.02.2007";21;"37.5";2231;66561;64330
411;"15.02.2007";22;"26.8";2264;63642;61378
411;"15.02.2007";23;"26.9";2245;62167;59922
411;"15.02.2007";24;"25.7";2237;57871;55634
412;"16.02.2007";1;"23.1";2618;54144;51526
412;"16.02.2007";2;21;3112;52050;48938
412;"16.02.2007";3;"20.1";3791;51435;47644
412;"16.02.2007";4;"19.7";3979;51805;47826
412;"16.02.2007";5;"19.9";3996;52546;48550
412;"16.02.2007";6;21;4210;54609;50399
412;"16.02.2007";7;22;4442;60087;55645
412;"16.02.2007";8;"28.9";5133;65565;60432
412;"16.02.2007";9;"28.6";5350;67125;61775
412;"16.02.2007";10;"33.2";5473;67499;62026
412;"16.02.2007";11;"28.7";5639;67994;62355
412;"16.02.2007";12;32;5733;68484;62751
412;"16.02.2007";13;"29.1";5915;67451;61536
412;"16.02.2007";14;"23.6";6227;66243;60016
412;"16.02.2007";15;"23.5";6804;64782;57978
412;"16.02.2007";16;21;7341;63822;56481
412;"16.02.2007";17;"20.5";7678;63265;55587
412;"16.02.2007";18;"24.1";8940;66145;57205
412;"16.02.2007";19;"27.2";10134;70608;60474
412;"16.02.2007";20;"21.9";10890;68937;58047
412;"16.02.2007";21;"20.5";11272;64075;52803
412;"16.02.2007";22;"21.1";10884;60849;49965
412;"16.02.2007";23;"21.1";11147;60336;49189
412;"16.02.2007";24;"20.3";11605;56778;45173
413;"17.02.2007";1;"22.2";11496;52817;41321
413;"17.02.2007";2;"18.9";11110;50381;39271
413;"17.02.2007";3;"15.9";10904;49234;38330
413;"17.02.2007";4;17;10075;49011;38936
413;"17.02.2007";5;17;9770;49340;39570
413;"17.02.2007";6;13;9603;48975;39372
413;"17.02.2007";7;"12.9";9850;49286;39436
413;"17.02.2007";8;"19.9";9773;52108;42335
413;"17.02.2007";9;25;9615;54894;45279
413;"17.02.2007";10;"30.8";9744;57523;47779
413;"17.02.2007";11;"26.7";9548;58826;49278
413;"17.02.2007";12;30;9321;59435;50114
413;"17.02.2007";13;"29.7";8939;58025;49086
413;"17.02.2007";14;25;8371;55929;47558
413;"17.02.2007";15;"25.6";7835;54244;46409
413;"17.02.2007";16;"23.5";7129;53755;46626
413;"17.02.2007";17;25;6553;54202;47649
413;"17.02.2007";18;"32.2";6621;57885;51264
413;"17.02.2007";19;"40.8";6880;62798;55918
413;"17.02.2007";20;32;7714;61120;53406
413;"17.02.2007";21;"23.1";7384;56828;49444
413;"17.02.2007";22;"22.5";6527;54478;47951
413;"17.02.2007";23;"27.4";5460;54705;49245
413;"17.02.2007";24;"22.2";5117;51500;46383
414;"18.02.2007";1;23;4638;48258;43620
414;"18.02.2007";2;"20.1";4503;46347;41844
414;"18.02.2007";3;"19.1";4209;45379;41170
414;"18.02.2007";4;16;3923;45405;41482
414;"18.02.2007";5;12;3744;45523;41779
414;"18.02.2007";6;"13.1";3406;44469;41063
414;"18.02.2007";7;"6.5";3211;42112;38901
414;"18.02.2007";8;"11.1";3276;43219;39943
414;"18.02.2007";9;"17.1";2794;46542;43748
414;"18.02.2007";10;"23.4";2306;49255;46949
414;"18.02.2007";11;"25.9";1770;51278;49508
414;"18.02.2007";12;27;1586;53554;51968
414;"18.02.2007";13;27;1637;51876;50239
414;"18.02.2007";14;"24.1";1737;49153;47416
414;"18.02.2007";15;22;1664;47037;45373
414;"18.02.2007";16;13;1586;46709;45123
414;"18.02.2007";17;"12.6";1597;47439;45842
414;"18.02.2007";18;"23.2";1806;51211;49405
414;"18.02.2007";19;"29.1";1894;56865;54971
414;"18.02.2007";20;"30.3";2161;56245;54084
414;"18.02.2007";21;28;2545;53838;51293
414;"18.02.2007";22;"26.1";2773;53205;50432
414;"18.02.2007";23;28;2589;54267;51678
414;"18.02.2007";24;"24.1";2146;51270;49124
415;"19.02.2007";1;"24.2";1526;48120;46594
415;"19.02.2007";2;"23.5";1282;45897;44615
415;"19.02.2007";3;"22.2";973;45047;44074
415;"19.02.2007";4;"16.9";892;45340;44448
415;"19.02.2007";5;"18.5";839;46472;45633
415;"19.02.2007";6;"23.1";644;48356;47712
415;"19.02.2007";7;"25.1";551;52096;51545
415;"19.02.2007";8;"32.1";428;57050;56622
415;"19.02.2007";9;34;296;60221;59925
415;"19.02.2007";10;"36.4";198;62337;62139
415;"19.02.2007";11;"37.9";187;63974;63787
415;"19.02.2007";12;39;206;65712;65506
415;"19.02.2007";13;38;231;64326;64095
415;"19.02.2007";14;"37.9";250;62455;62205
415;"19.02.2007";15;"35.9";247;60564;60317
415;"19.02.2007";16;"33.2";208;59590;59382
415;"19.02.2007";17;"31.5";235;58749;58514
415;"19.02.2007";18;"32.9";301;61185;60884
415;"19.02.2007";19;"43.9";370;65916;65546
415;"19.02.2007";20;"43.1";508;65036;64528
415;"19.02.2007";21;"34.9";600;61513;60913
415;"19.02.2007";22;"27.1";731;59343;58612
415;"19.02.2007";23;"28.1";720;58797;58077
415;"19.02.2007";24;"25.9";783;54946;54163
416;"20.02.2007";1;"25.3";775;50842;50067
416;"20.02.2007";2;"23.1";697;48908;48211
416;"20.02.2007";3;22;703;48113;47410
416;"20.02.2007";4;21;628;48543;47915
416;"20.02.2007";5;21;595;49796;49201
416;"20.02.2007";6;"26.9";539;52152;51613
416;"20.02.2007";7;"27.5";536;57442;56906
416;"20.02.2007";8;"42.3";613;62690;62077
416;"20.02.2007";9;"42.8";607;65146;64539
416;"20.02.2007";10;"43.1";497;66131;65634
416;"20.02.2007";11;"46.2";415;67355;66940
416;"20.02.2007";12;"47.9";345;68383;68038
416;"20.02.2007";13;"46.1";335;67296;66961
416;"20.02.2007";14;43;332;65570;65238
416;"20.02.2007";15;"42.8";306;63681;63375
416;"20.02.2007";16;"41.5";328;62709;62381
416;"20.02.2007";17;32;347;61754;61407
416;"20.02.2007";18;"35.4";402;64054;63652
416;"20.02.2007";19;"42.8";720;69213;68493
416;"20.02.2007";20;"39.4";1017;68407;67390
416;"20.02.2007";21;"32.1";1184;64235;63051
416;"20.02.2007";22;"27.6";1522;61713;60191
416;"20.02.2007";23;"27.5";1799;60481;58682
416;"20.02.2007";24;"23.6";2058;55799;53741
417;"21.02.2007";1;"25.5";2278;51904;49626
417;"21.02.2007";2;"23.3";2387;49885;47498
417;"21.02.2007";3;22;2462;49234;46772
417;"21.02.2007";4;"21.4";2623;49924;47301
417;"21.02.2007";5;"20.5";2800;51380;48580
417;"21.02.2007";6;"23.5";3043;53976;50933
417;"21.02.2007";7;"24.1";3492;59860;56368
417;"21.02.2007";8;32;4007;65568;61561
417;"21.02.2007";9;"40.9";4205;67483;63278
417;"21.02.2007";10;"42.4";4189;67981;63792
417;"21.02.2007";11;"42.8";4523;68956;64433
417;"21.02.2007";12;"46.6";4325;70179;65854
417;"21.02.2007";13;43;4324;68971;64647
417;"21.02.2007";14;"41.9";4387;68064;63677
417;"21.02.2007";15;"40.1";4504;67197;62693
417;"21.02.2007";16;"35.1";4785;66807;62022
417;"21.02.2007";17;33;5370;66398;61028
417;"21.02.2007";18;"35.5";5783;68646;62863
417;"21.02.2007";19;"40.3";6385;72596;66211
417;"21.02.2007";20;41;6918;70453;63535
417;"21.02.2007";21;33;6483;66218;59735
417;"21.02.2007";22;"25.2";6179;63198;57019
417;"21.02.2007";23;"26.1";5852;61218;55366
417;"21.02.2007";24;"22.3";5081;56054;50973
418;"22.02.2007";1;"21.2";4423;52193;47770
418;"22.02.2007";2;"20.6";4421;49786;45365
418;"22.02.2007";3;"19.1";4336;48842;44506
418;"22.02.2007";4;"19.4";4222;49366;45144
418;"22.02.2007";5;21;4018;50885;46867
418;"22.02.2007";6;"22.8";3773;53238;49465
418;"22.02.2007";7;"22.7";3454;59619;56165
418;"22.02.2007";8;"30.1";3216;65342;62126
418;"22.02.2007";9;"38.2";2587;67241;64654
418;"22.02.2007";10;"38.2";2026;67197;65171
418;"22.02.2007";11;"38.2";1699;68138;66439
418;"22.02.2007";12;"43.6";1512;69109;67597
418;"22.02.2007";13;"38.9";1208;67801;66593
418;"22.02.2007";14;42;982;67093;66111
418;"22.02.2007";15;"38.2";809;66250;65441
418;"22.02.2007";16;"35.4";692;65437;64745
418;"22.02.2007";17;28;728;64359;63631
418;"22.02.2007";18;"32.9";974;66303;65329
418;"22.02.2007";19;"46.7";1521;70939;69418
418;"22.02.2007";20;"42.7";2224;70053;67829
418;"22.02.2007";21;"30.1";2673;66091;63418
418;"22.02.2007";22;25;2942;62911;59969
418;"22.02.2007";23;"25.9";3249;60813;57564
418;"22.02.2007";24;"22.9";3432;55880;52448
419;"23.02.2007";1;"23.4";3659;52076;48417
419;"23.02.2007";2;"21.3";3913;50061;46148
419;"23.02.2007";3;"17.6";4002;49266;45264
419;"23.02.2007";4;"17.1";4156;49817;45661
419;"23.02.2007";5;19;4411;51149;46738
419;"23.02.2007";6;"23.2";4597;53509;48912
419;"23.02.2007";7;"22.4";4812;59740;54928
419;"23.02.2007";8;"28.1";4984;65353;60369
419;"23.02.2007";9;"25.2";5048;67517;62469
419;"23.02.2007";10;"25.1";4911;68019;63108
419;"23.02.2007";11;"25.2";4867;68669;63802
419;"23.02.2007";12;"27.5";4753;69658;64905
419;"23.02.2007";13;"25.5";4891;68508;63617
419;"23.02.2007";14;"24.9";4930;66854;61924
419;"23.02.2007";15;"23.6";4878;65232;60354
419;"23.02.2007";16;23;5235;64042;58807
419;"23.02.2007";17;23;5382;63358;57976
419;"23.02.2007";18;"22.9";5771;65276;59505
419;"23.02.2007";19;"29.1";6355;69970;63615
419;"23.02.2007";20;"29.5";6998;68645;61647
419;"23.02.2007";21;"26.1";7044;64195;57151
419;"23.02.2007";22;"22.2";7132;61350;54218
419;"23.02.2007";23;"21.4";7374;60346;52972
419;"23.02.2007";24;"17.3";7313;55937;48624
420;"24.02.2007";1;24;6973;52332;45359
420;"24.02.2007";2;"22.3";6689;49907;43218
420;"24.02.2007";3;"21.5";6653;48767;42114
420;"24.02.2007";4;20;6364;48572;42208
420;"24.02.2007";5;"19.8";6453;49136;42683
420;"24.02.2007";6;17;6649;49334;42685
420;"24.02.2007";7;14;6823;49723;42900
420;"24.02.2007";8;"18.2";6838;52524;45686
420;"24.02.2007";9;"22.8";7333;55806;48473
420;"24.02.2007";10;"30.5";7121;58447;51326
420;"24.02.2007";11;"29.6";7002;59933;52931
420;"24.02.2007";12;33;6891;61167;54276
420;"24.02.2007";13;"29.4";7294;60254;52960
420;"24.02.2007";14;"26.1";8006;58595;50589
420;"24.02.2007";15;23;8417;57228;48811
420;"24.02.2007";16;"21.8";8562;56309;47747
420;"24.02.2007";17;"20.3";8350;55950;47600
420;"24.02.2007";18;"21.2";8061;57878;49817
420;"24.02.2007";19;"32.9";8174;62610;54436
420;"24.02.2007";20;"30.3";8333;61519;53186
420;"24.02.2007";21;"27.1";8499;57385;48886
420;"24.02.2007";22;"22.1";8385;54890;46505
420;"24.02.2007";23;"23.2";8539;55079;46540
420;"24.02.2007";24;"20.2";8376;51417;43041
421;"25.02.2007";1;"17.3";7888;47599;39711
421;"25.02.2007";2;"13.5";7795;45314;37519
421;"25.02.2007";3;12;7227;43905;36678
421;"25.02.2007";4;12;6470;43375;36905
421;"25.02.2007";5;"10.9";5971;43660;37689
421;"25.02.2007";6;"11.4";5683;42576;36893
421;"25.02.2007";7;3;6004;40728;34724
421;"25.02.2007";8;"7.7";6068;41999;35931
421;"25.02.2007";9;"12.3";5979;45929;39950
421;"25.02.2007";10;"16.7";5878;50126;44248
421;"25.02.2007";11;"20.6";5832;52855;47023
421;"25.02.2007";12;"23.8";6286;55632;49346
421;"25.02.2007";13;"23.2";6922;54677;47755
421;"25.02.2007";14;"19.4";7696;52418;44722
421;"25.02.2007";15;"14.9";8035;50647;42612
421;"25.02.2007";16;12;7867;49708;41841
421;"25.02.2007";17;"13.4";7218;49194;41976
421;"25.02.2007";18;"22.6";7081;51993;44912
421;"25.02.2007";19;"28.3";6578;57753;51175
421;"25.02.2007";20;"28.2";5647;57675;52028
421;"25.02.2007";21;"24.6";5249;54759;49510
421;"25.02.2007";22;"25.1";5210;53483;48273
421;"25.02.2007";23;"26.1";5005;53973;48968
421;"25.02.2007";24;"21.9";5519;50799;45280
422;"26.02.2007";1;"20.5";5709;47669;41960
422;"26.02.2007";2;20;5679;45933;40254
422;"26.02.2007";3;17;5584;45254;39670
422;"26.02.2007";4;12;5918;45687;39769
422;"26.02.2007";5;"19.4";6380;47125;40745
422;"26.02.2007";6;"21.5";6289;49404;43115
422;"26.02.2007";7;"22.7";6495;56200;49705
422;"26.02.2007";8;"32.2";6719;61718;54999
422;"26.02.2007";9;"33.1";6405;64785;58380
422;"26.02.2007";10;"34.5";6184;66206;60022
422;"26.02.2007";11;"35.4";6321;67958;61637
422;"26.02.2007";12;"38.7";6491;69508;63017
422;"26.02.2007";13;"36.6";6876;68743;61867
422;"26.02.2007";14;35;7372;67909;60537
422;"26.02.2007";15;"32.1";7401;66576;59175
422;"26.02.2007";16;"31.3";7609;65619;58010
422;"26.02.2007";17;"29.3";8161;64044;55883
422;"26.02.2007";18;"33.9";8291;65296;57005
422;"26.02.2007";19;"39.3";8681;69192;60511
422;"26.02.2007";20;"35.1";8963;68257;59294
422;"26.02.2007";21;"30.1";9481;64677;55196
422;"26.02.2007";22;"25.9";9092;61763;52671
422;"26.02.2007";23;"25.6";8889;60464;51575
422;"26.02.2007";24;"22.3";8551;55732;47181
423;"27.02.2007";1;22;8690;51915;43225
423;"27.02.2007";2;"19.9";8140;49687;41547
423;"27.02.2007";3;"19.8";8441;48841;40400
423;"27.02.2007";4;"17.6";9757;49411;39654
423;"27.02.2007";5;"10.3";9234;50651;41417
423;"27.02.2007";6;"20.5";8052;53150;45098
423;"27.02.2007";7;"19.5";7487;60067;52580
423;"27.02.2007";8;"23.2";7258;65854;58596
423;"27.02.2007";9;"26.1";7288;68153;60865
423;"27.02.2007";10;29;7547;68251;60704
423;"27.02.2007";11;30;7521;69532;62011
423;"27.02.2007";12;"32.9";7835;70853;63018
423;"27.02.2007";13;"31.5";7979;70294;62315
423;"27.02.2007";14;"29.1";8152;70069;61917
423;"27.02.2007";15;29;7128;68991;61863
423;"27.02.2007";16;28;5441;68127;62686
423;"27.02.2007";17;"26.9";3986;66775;62789
423;"27.02.2007";18;"25.3";3739;68145;64406
423;"27.02.2007";19;"38.7";4444;72167;67723
423;"27.02.2007";20;"30.9";5483;70974;65491
423;"27.02.2007";21;27;6370;66622;60252
423;"27.02.2007";22;"23.3";7419;63452;56033
423;"27.02.2007";23;"21.1";8541;61764;53223
423;"27.02.2007";24;"10.7";8888;56088;47200
424;"28.02.2007";1;"20.9";9817;52151;42334
424;"28.02.2007";2;"18.6";10991;50522;39531
424;"28.02.2007";3;13;11643;49271;37628
424;"28.02.2007";4;"12.1";12291;49588;37297
424;"28.02.2007";5;"18.5";12461;51029;38568
424;"28.02.2007";6;"22.5";12192;53782;41590
424;"28.02.2007";7;"22.4";11899;60805;48906
424;"28.02.2007";8;"34.6";11933;66144;54211
424;"28.02.2007";9;"39.5";11287;67972;56685
424;"28.02.2007";10;"38.8";11225;68444;57219
424;"28.02.2007";11;"38.5";11750;69512;57762
424;"28.02.2007";12;"40.2";12067;70268;58201
424;"28.02.2007";13;"36.2";12259;69419;57160
424;"28.02.2007";14;38;11794;68952;57158
424;"28.02.2007";15;"35.1";11691;67766;56075
424;"28.02.2007";16;"32.1";11132;67065;55933
424;"28.02.2007";17;"24.7";11432;66347;54915
424;"28.02.2007";18;33;10344;67013;56669
424;"28.02.2007";19;"34.5";10195;71104;60909
424;"28.02.2007";20;"34.5";10366;70667;60301
424;"28.02.2007";21;"29.1";10355;66568;56213
424;"28.02.2007";22;"24.1";10703;63858;53155
424;"28.02.2007";23;"22.3";11008;61327;50319
424;"28.02.2007";24;"16.1";11442;55540;44098
425;"01.03.2007";1;13;11765;52526;40761
425;"01.03.2007";2;"7.2";12506;50404;37898
425;"01.03.2007";3;"6.6";12768;49727;36959
425;"01.03.2007";4;"6.5";12761;50757;37996
425;"01.03.2007";5;"9.1";11702;52044;40342
425;"01.03.2007";6;"16.1";11065;54356;43291
425;"01.03.2007";7;"22.4";10446;60790;50344
425;"01.03.2007";8;"28.8";9220;65873;56653
425;"01.03.2007";9;"27.1";8901;68207;59306
425;"01.03.2007";10;"28.7";8967;68547;59580
425;"01.03.2007";11;28;9978;69523;59545
425;"01.03.2007";12;29;10968;70898;59930
425;"01.03.2007";13;28;12092;70645;58553
425;"01.03.2007";14;"26.1";12573;70698;58125
425;"01.03.2007";15;"25.1";12478;69417;56939
425;"01.03.2007";16;25;12244;68467;56223
425;"01.03.2007";17;"24.1";11547;66873;55326
425;"01.03.2007";18;"24.1";10889;67170;56281
425;"01.03.2007";19;"30.9";10289;71021;60732
425;"01.03.2007";20;"33.6";10763;71094;60331
425;"01.03.2007";21;"29.1";11365;67600;56235
425;"01.03.2007";22;"24.3";12201;64803;52602
425;"01.03.2007";23;"23.5";12610;62950;50340
425;"01.03.2007";24;"19.1";12467;58093;45626
426;"02.03.2007";1;"15.1";12255;54856;42601
426;"02.03.2007";2;"15.1";12383;52812;40429
426;"02.03.2007";3;12;12262;51915;39653
426;"02.03.2007";4;"11.1";12084;52554;40470
426;"02.03.2007";5;"6.7";11074;53255;42181
426;"02.03.2007";6;"19.2";10792;55592;44800
426;"02.03.2007";7;"23.3";10756;62195;51439
426;"02.03.2007";8;"29.2";10616;66891;56275
426;"02.03.2007";9;"30.7";10476;68967;58491
426;"02.03.2007";10;"30.3";10779;69136;58357
426;"02.03.2007";11;"31.5";11092;69924;58832
426;"02.03.2007";12;"31.5";10951;70733;59782
426;"02.03.2007";13;"30.9";10927;69937;59010
426;"02.03.2007";14;28;11249;68708;57459
426;"02.03.2007";15;"26.2";11461;67133;55672
426;"02.03.2007";16;"25.2";10778;66431;55653
426;"02.03.2007";17;24;9751;65258;55507
426;"02.03.2007";18;"26.9";8053;65657;57604
426;"02.03.2007";19;"33.9";6549;69585;63036
426;"02.03.2007";20;36;5488;69105;63617
426;"02.03.2007";21;"27.1";4200;64320;60120
426;"02.03.2007";22;"26.2";3704;61054;57350
426;"02.03.2007";23;"26.6";3284;59820;56536
426;"02.03.2007";24;"22.6";2800;55771;52971
427;"03.03.2007";1;"30.4";2591;52217;49626
427;"03.03.2007";2;"26.1";2763;50115;47352
427;"03.03.2007";3;"23.4";2913;48677;45764
427;"03.03.2007";4;"22.3";2919;47995;45076
427;"03.03.2007";5;"20.9";3051;47721;44670
427;"03.03.2007";6;"19.9";4145;47499;43354
427;"03.03.2007";7;"16.8";4713;47463;42750
427;"03.03.2007";8;"17.7";5110;49985;44875
427;"03.03.2007";9;"22.7";5357;53938;48581
427;"03.03.2007";10;"25.4";4993;56732;51739
427;"03.03.2007";11;26;4838;58753;53915
427;"03.03.2007";12;"25.1";4658;59839;55181
427;"03.03.2007";13;"27.4";4254;58198;53944
427;"03.03.2007";14;"28.8";3825;56178;52353
427;"03.03.2007";15;27;3764;54046;50282
427;"03.03.2007";16;"22.9";4321;53850;49529
427;"03.03.2007";17;"21.5";4094;53718;49624
427;"03.03.2007";18;"23.1";3989;55772;51783
427;"03.03.2007";19;"29.4";3624;59833;56209
427;"03.03.2007";20;"28.9";3463;59221;55758
427;"03.03.2007";21;"25.1";3252;55134;51882
427;"03.03.2007";22;"21.1";3041;52998;49957
427;"03.03.2007";23;24;2989;53529;50540
427;"03.03.2007";24;22;2811;50261;47450
428;"04.03.2007";1;20;2417;46718;44301
428;"04.03.2007";2;20;2186;44207;42021
428;"04.03.2007";3;"15.4";1945;42945;41000
428;"04.03.2007";4;"11.1";2009;42844;40835
428;"04.03.2007";5;12;1928;43221;41293
428;"04.03.2007";6;"9.1";1713;42399;40686
428;"04.03.2007";7;11;1517;39952;38435
428;"04.03.2007";8;"6.1";1431;40436;39005
428;"04.03.2007";9;"13.9";1146;44132;42986
428;"04.03.2007";10;"19.2";838;46874;46036
428;"04.03.2007";11;"23.1";691;49265;48574
428;"04.03.2007";12;"25.4";756;51894;51138
428;"04.03.2007";13;"25.7";953;50422;49469
428;"04.03.2007";14;"21.4";952;47758;46806
428;"04.03.2007";15;"14.9";1017;45594;44577
428;"04.03.2007";16;"12.1";1251;44536;43285
428;"04.03.2007";17;"11.1";1409;44574;43165
428;"04.03.2007";18;"17.9";1738;47670;45932
428;"04.03.2007";19;"24.2";2954;55217;52263
428;"04.03.2007";20;"27.1";4503;56690;52187
428;"04.03.2007";21;"25.4";5545;53855;48310
428;"04.03.2007";22;23;6487;52737;46250
428;"04.03.2007";23;"24.4";7330;53592;46262
428;"04.03.2007";24;"21.2";8063;50026;41963
429;"05.03.2007";1;"12.7";8801;47239;38438
429;"05.03.2007";2;15;9345;45669;36324
429;"05.03.2007";3;12;9577;45043;35466
429;"05.03.2007";4;"7.1";9939;45829;35890
429;"05.03.2007";5;8;10271;47572;37301
429;"05.03.2007";6;"15.8";11347;51301;39954
429;"05.03.2007";7;"22.5";11361;59508;48147
429;"05.03.2007";8;"27.1";10917;65691;54774
429;"05.03.2007";9;"27.1";10127;68435;58308
429;"05.03.2007";10;"29.1";9788;69163;59375
429;"05.03.2007";11;"30.1";8959;69705;60746
429;"05.03.2007";12;"30.7";8761;71111;62350
429;"05.03.2007";13;"33.3";9398;70151;60753
429;"05.03.2007";14;32;9671;69900;60229
429;"05.03.2007";15;"29.9";9033;68728;59695
429;"05.03.2007";16;"29.9";8605;67972;59367
429;"05.03.2007";17;"26.6";7835;65848;58013
429;"05.03.2007";18;"27.2";7009;65929;58920
429;"05.03.2007";19;"35.6";6642;70078;63436
429;"05.03.2007";20;"34.1";6789;71105;64316
429;"05.03.2007";21;"29.6";6633;66436;59803
429;"05.03.2007";22;"25.6";6832;63361;56529
429;"05.03.2007";23;"26.3";6657;61047;54390
429;"05.03.2007";24;"22.5";6605;55748;49143
430;"06.03.2007";1;"21.3";6643;52003;45360
430;"06.03.2007";2;"17.4";6739;49912;43173
430;"06.03.2007";3;"17.9";6911;49234;42323
430;"06.03.2007";4;"16.8";6994;49915;42921
430;"06.03.2007";5;17;7367;51178;43811
430;"06.03.2007";6;"19.9";8305;54175;45870
430;"06.03.2007";7;22;9294;60828;51534
430;"06.03.2007";8;26;9838;65889;56051
430;"06.03.2007";9;"28.3";9893;68109;58216
430;"06.03.2007";10;29;10390;68301;57911
430;"06.03.2007";11;"29.2";10656;68134;57478
430;"06.03.2007";12;30;11107;70140;59033
430;"06.03.2007";13;"26.1";11488;69626;58138
430;"06.03.2007";14;"25.1";11244;69341;58097
430;"06.03.2007";15;"24.5";10653;68288;57635
430;"06.03.2007";16;"24.1";9235;66923;57688
430;"06.03.2007";17;25;8301;65761;57460
430;"06.03.2007";18;"24.1";7891;66656;58765
430;"06.03.2007";19;31;7889;70966;63077
430;"06.03.2007";20;"37.6";8279;70858;62579
430;"06.03.2007";21;"28.4";7850;66466;58616
430;"06.03.2007";22;"24.3";7480;62846;55366
430;"06.03.2007";23;"23.8";7208;60402;53194
430;"06.03.2007";24;"20.8";7249;55356;48107
431;"07.03.2007";1;"22.4";7062;51163;44101
431;"07.03.2007";2;21;6662;48786;42124
431;"07.03.2007";3;20;5815;47458;41643
431;"07.03.2007";4;"16.1";5121;47987;42866
431;"07.03.2007";5;"18.4";4764;49590;44826
431;"07.03.2007";6;"22.4";4718;52499;47781
431;"07.03.2007";7;"22.6";4478;59787;55309
431;"07.03.2007";8;27;4295;65032;60737
431;"07.03.2007";9;30;3802;67364;63562
431;"07.03.2007";10;"35.4";3329;67564;64235
431;"07.03.2007";11;"37.4";2997;68362;65365
431;"07.03.2007";12;"40.8";3020;69700;66680
431;"07.03.2007";13;"40.1";2978;68876;65898
431;"07.03.2007";14;"40.8";2628;68123;65495
431;"07.03.2007";15;40;2377;66872;64495
431;"07.03.2007";16;36;1950;65885;63935
431;"07.03.2007";17;"35.4";2104;64401;62297
431;"07.03.2007";18;"34.9";2216;65049;62833
431;"07.03.2007";19;50;1972;69288;67316
431;"07.03.2007";20;"51.1";2016;70251;68235
431;"07.03.2007";21;"34.5";2303;66057;63754
431;"07.03.2007";22;"33.9";2528;62787;60259
431;"07.03.2007";23;32;2878;60729;57851
431;"07.03.2007";24;"25.1";2989;55401;52412
432;"08.03.2007";1;"25.6";2841;51375;48534
432;"08.03.2007";2;"23.6";2555;48785;46230
432;"08.03.2007";3;"22.6";2558;48124;45566
432;"08.03.2007";4;"21.6";2487;48953;46466
432;"08.03.2007";5;"23.1";2617;50389;47772
432;"08.03.2007";6;"24.5";2681;52813;50132
432;"08.03.2007";7;"25.1";2905;59354;56449
432;"08.03.2007";8;"34.1";2906;64382;61476
432;"08.03.2007";9;38;2742;66717;63975
432;"08.03.2007";10;40;2375;66557;64182
432;"08.03.2007";11;38;2228;67017;64789
432;"08.03.2007";12;"35.6";2313;68091;65778
432;"08.03.2007";13;"30.1";2690;67537;64847
432;"08.03.2007";14;"30.1";2934;67201;64267
432;"08.03.2007";15;"30.1";3099;66420;63321
432;"08.03.2007";16;28;3314;65787;62473
432;"08.03.2007";17;"25.3";2834;64324;61490
432;"08.03.2007";18;"25.9";2021;64444;62423
432;"08.03.2007";19;"35.6";1620;68506;66886
432;"08.03.2007";20;"35.4";1414;69756;68342
432;"08.03.2007";21;"32.1";1608;65422;63814
432;"08.03.2007";22;"24.1";1839;62118;60279
432;"08.03.2007";23;"24.3";2086;59918;57832
432;"08.03.2007";24;"22.6";2350;54851;52501
433;"09.03.2007";1;"23.1";2460;50891;48431
433;"09.03.2007";2;"22.9";2496;48834;46338
433;"09.03.2007";3;"21.1";2624;48306;45682
433;"09.03.2007";4;"20.3";2764;49158;46394
433;"09.03.2007";5;"19.9";2977;50383;47406
433;"09.03.2007";6;23;3411;52961;49550
433;"09.03.2007";7;"24.1";3828;59450;55622
433;"09.03.2007";8;"28.1";4071;64102;60031
433;"09.03.2007";9;31;3851;66313;62462
433;"09.03.2007";10;"33.5";3474;66321;62847
433;"09.03.2007";11;"33.6";3703;66975;63272
433;"09.03.2007";12;"35.1";4597;67769;63172
433;"09.03.2007";13;32;5603;67198;61595
433;"09.03.2007";14;"26.4";6028;66230;60202
433;"09.03.2007";15;"23.4";5401;65133;59732
433;"09.03.2007";16;"23.1";4180;64518;60338
433;"09.03.2007";17;24;3139;63509;60370
433;"09.03.2007";18;24;3036;64499;61463
433;"09.03.2007";19;32;3048;68027;64979
433;"09.03.2007";20;34;3437;67602;64165
433;"09.03.2007";21;"29.1";3674;63085;59411
433;"09.03.2007";22;"26.1";3613;60245;56632
433;"09.03.2007";23;26;3341;58533;55192
433;"09.03.2007";24;23;3286;54293;51007
434;"10.03.2007";1;26;3251;50491;47240
434;"10.03.2007";2;"22.6";3339;48068;44729
434;"10.03.2007";3;"21.9";3547;47004;43457
434;"10.03.2007";4;"20.1";3815;47102;43287
434;"10.03.2007";5;"18.4";3715;47487;43772
434;"10.03.2007";6;"21.1";3577;47365;43788
434;"10.03.2007";7;21;3608;46758;43150
434;"10.03.2007";8;22;3414;49447;46033
434;"10.03.2007";9;"25.1";3053;53526;50473
434;"10.03.2007";10;"28.9";2772;55981;53209
434;"10.03.2007";11;30;3059;57490;54431
434;"10.03.2007";12;"31.6";4073;58489;54416
434;"10.03.2007";13;30;4656;56785;52129
434;"10.03.2007";14;"25.1";5118;54480;49362
434;"10.03.2007";15;"23.8";5258;52176;46918
434;"10.03.2007";16;23;5271;51596;46325
434;"10.03.2007";17;"22.1";4847;51375;46528
434;"10.03.2007";18;"23.1";4128;53076;48948
434;"10.03.2007";19;"27.1";3627;57921;54294
434;"10.03.2007";20;"31.1";4189;59448;55259
434;"10.03.2007";21;28;4943;55712;50769
434;"10.03.2007";22;"23.4";5644;53682;48038
434;"10.03.2007";23;"25.1";6106;53812;47706
434;"10.03.2007";24;"22.3";6210;50381;44171
435;"11.03.2007";1;16;5993;47013;41020
435;"11.03.2007";2;"12.4";5889;44585;38696
435;"11.03.2007";3;"9.4";5949;43574;37625
435;"11.03.2007";4;"9.8";5996;43541;37545
435;"11.03.2007";5;"11.1";5803;43665;37862
435;"11.03.2007";6;10;5608;42819;37211
435;"11.03.2007";7;"3.5";5541;40359;34818
435;"11.03.2007";8;2;5274;41313;36039
435;"11.03.2007";9;"9.3";4751;44570;39819
435;"11.03.2007";10;"19.1";4272;47155;42883
435;"11.03.2007";11;"21.2";4554;48805;44251
435;"11.03.2007";12;"22.3";5096;51004;45908
435;"11.03.2007";13;"21.9";5314;49534;44220
435;"11.03.2007";14;"17.1";5176;46978;41802
435;"11.03.2007";15;"11.1";4826;44839;40013
435;"11.03.2007";16;"9.4";4164;43832;39668
435;"11.03.2007";17;5;3301;43861;40560
435;"11.03.2007";18;11;2620;46390;43770
435;"11.03.2007";19;"23.6";2438;52904;50466
435;"11.03.2007";20;"26.1";2851;56461;53610
435;"11.03.2007";21;"24.3";3137;53633;50496
435;"11.03.2007";22;24;3167;52229;49062
435;"11.03.2007";23;"24.3";2986;52440;49454
435;"11.03.2007";24;"22.2";2935;48584;45649
436;"12.03.2007";1;"18.5";2949;45426;42477
436;"12.03.2007";2;17;3042;43702;40660
436;"12.03.2007";3;"14.6";2902;43129;40227
436;"12.03.2007";4;12;2723;44034;41311
436;"12.03.2007";5;"18.1";2458;46060;43602
436;"12.03.2007";6;"21.7";2376;50008;47632
436;"12.03.2007";7;"25.1";2562;57541;54979
436;"12.03.2007";8;"36.5";2422;62410;59988
436;"12.03.2007";9;30;1930;64612;62682
436;"12.03.2007";10;"32.1";1267;64614;63347
436;"12.03.2007";11;"33.5";1019;65418;64399
436;"12.03.2007";12;35;904;66435;65531
436;"12.03.2007";13;33;926;65677;64751
436;"12.03.2007";14;"33.1";970;65176;64206
436;"12.03.2007";15;"32.1";904;63882;62978
436;"12.03.2007";16;"29.8";947;62891;61944
436;"12.03.2007";17;27;951;61624;60673
436;"12.03.2007";18;"28.1";1030;61979;60949
436;"12.03.2007";19;36;1267;66610;65343
436;"12.03.2007";20;39;1582;69342;67760
436;"12.03.2007";21;"36.1";2055;65353;63298
436;"12.03.2007";22;29;2185;61507;59322
436;"12.03.2007";23;"27.8";2144;58357;56213
436;"12.03.2007";24;"22.7";1941;53207;51266
437;"13.03.2007";1;"22.2";1785;49502;47717
437;"13.03.2007";2;"22.1";1814;47190;45376
437;"13.03.2007";3;"22.2";1657;46733;45076
437;"13.03.2007";4;"21.1";1477;47411;45934
437;"13.03.2007";5;"23.1";1239;49408;48169
437;"13.03.2007";6;"24.1";1110;52676;51566
437;"13.03.2007";7;27;1034;59153;58119
437;"13.03.2007";8;"36.8";1111;63936;62825
437;"13.03.2007";9;"36.3";1045;65755;64710
437;"13.03.2007";10;"40.1";665;65350;64685
437;"13.03.2007";11;"40.1";483;65813;65330
437;"13.03.2007";12;"41.6";557;66589;66032
437;"13.03.2007";13;"36.8";694;66033;65339
437;"13.03.2007";14;"40.1";941;65329;64388
437;"13.03.2007";15;"38.1";1216;64195;62979
437;"13.03.2007";16;"30.3";1385;63536;62151
437;"13.03.2007";17;"27.6";1652;62272;60620
437;"13.03.2007";18;"27.7";1849;62886;61037
437;"13.03.2007";19;36;2201;67429;65228
437;"13.03.2007";20;42;2426;69746;67320
437;"13.03.2007";21;"35.1";2700;65558;62858
437;"13.03.2007";22;"28.1";2823;61576;58753
437;"13.03.2007";23;"27.1";2606;58153;55547
437;"13.03.2007";24;"23.1";2553;52927;50374
438;"14.03.2007";1;"23.5";2451;49223;46772
438;"14.03.2007";2;"22.2";2477;47337;44860
438;"14.03.2007";3;"21.3";2456;46565;44109
438;"14.03.2007";4;"20.4";2439;47395;44956
438;"14.03.2007";5;"21.8";2506;49570;47064
438;"14.03.2007";6;26;2381;52792;50411
438;"14.03.2007";7;"26.9";2414;58713;56299
438;"14.03.2007";8;32;2376;63522;61146
438;"14.03.2007";9;34;1749;65787;64038
438;"14.03.2007";10;"33.7";1313;65456;64143
438;"14.03.2007";11;"33.7";1327;65883;64556
438;"14.03.2007";12;"36.4";1565;66704;65139
438;"14.03.2007";13;"33.6";1797;66005;64208
438;"14.03.2007";14;31;1919;65496;63577
438;"14.03.2007";15;"29.9";2047;64388;62341
438;"14.03.2007";16;"30.2";2174;63507;61333
438;"14.03.2007";17;"26.3";2118;62228;60110
438;"14.03.2007";18;"28.1";1604;62699;61095
438;"14.03.2007";19;"33.9";1425;66925;65500
438;"14.03.2007";20;"40.2";1550;69324;67774
438;"14.03.2007";21;"35.2";1615;65350;63735
438;"14.03.2007";22;"29.1";1605;61773;60168
438;"14.03.2007";23;29;1605;58663;57058
438;"14.03.2007";24;"23.6";1725;53435;51710
439;"15.03.2007";1;"21.1";1645;49987;48342
439;"15.03.2007";2;"21.2";1480;47905;46425
439;"15.03.2007";3;"21.8";1429;47163;45734
439;"15.03.2007";4;"18.9";1283;48173;46890
439;"15.03.2007";5;"21.8";1201;49739;48538
439;"15.03.2007";6;22;1188;52508;51320
439;"15.03.2007";7;"25.1";1256;58825;57569
439;"15.03.2007";8;"32.4";1178;63549;62371
439;"15.03.2007";9;"34.4";962;65304;64342
439;"15.03.2007";10;"34.7";795;65087;64292
439;"15.03.2007";11;"35.1";836;65618;64782
439;"15.03.2007";12;"35.3";960;66492;65532
439;"15.03.2007";13;35;1144;65641;64497
439;"15.03.2007";14;"33.6";1240;65007;63767
439;"15.03.2007";15;"30.1";1293;64105;62812
439;"15.03.2007";16;"29.6";1247;63194;61947
439;"15.03.2007";17;26;1138;61620;60482
439;"15.03.2007";18;"26.1";966;62284;61318
439;"15.03.2007";19;"36.5";917;66400;65483
439;"15.03.2007";20;"40.1";1052;69422;68370
439;"15.03.2007";21;"31.5";1326;65168;63842
439;"15.03.2007";22;"27.1";1650;61333;59683
439;"15.03.2007";23;"26.1";2064;58410;56346
439;"15.03.2007";24;"23.5";2329;53527;51198
440;"16.03.2007";1;"27.5";2503;49660;47157
440;"16.03.2007";2;"23.1";2647;47750;45103
440;"16.03.2007";3;"22.2";2704;47169;44465
440;"16.03.2007";4;"22.3";2610;47965;45355
440;"16.03.2007";5;"23.4";2645;49725;47080
440;"16.03.2007";6;"24.7";2722;52978;50256
440;"16.03.2007";7;"30.2";2604;59035;56431
440;"16.03.2007";8;"34.3";2475;63804;61329
440;"16.03.2007";9;"38.1";2356;66166;63810
440;"16.03.2007";10;38;1905;66070;64165
440;"16.03.2007";11;38;2130;66387;64257
440;"16.03.2007";12;"39.9";2511;67177;64666
440;"16.03.2007";13;"36.9";3204;66325;63121
440;"16.03.2007";14;"33.4";3826;65047;61221
440;"16.03.2007";15;"32.9";4391;63834;59443
440;"16.03.2007";16;"29.1";4536;62713;58177
440;"16.03.2007";17;"25.8";4564;62040;57476
440;"16.03.2007";18;27;4539;62813;58274
440;"16.03.2007";19;33;4795;66160;61365
440;"16.03.2007";20;"36.2";5732;67813;62081
440;"16.03.2007";21;34;6641;63649;57008
440;"16.03.2007";22;"25.2";8078;60821;52743
440;"16.03.2007";23;"25.1";9862;59698;49836
440;"16.03.2007";24;"22.1";11514;55793;44279
441;"17.03.2007";1;"22.3";12633;52724;40091
441;"17.03.2007";2;"16.6";13716;50537;36821
441;"17.03.2007";3;7;13993;49166;35173
441;"17.03.2007";4;"10.4";14449;49363;34914
441;"17.03.2007";5;"5.4";13778;49661;35883
441;"17.03.2007";6;"5.1";13300;49257;35957
441;"17.03.2007";7;"6.9";12764;49347;36583
441;"17.03.2007";8;"2.3";12703;52324;39621
441;"17.03.2007";9;"18.4";13143;56444;43301
441;"17.03.2007";10;"23.3";13319;59710;46391
441;"17.03.2007";11;"25.3";13615;61244;47629
441;"17.03.2007";12;"25.5";13380;62143;48763
441;"17.03.2007";13;"24.7";13420;61447;48027
441;"17.03.2007";14;"23.7";13863;59910;46047
441;"17.03.2007";15;21;13903;58089;44186
441;"17.03.2007";16;"19.2";13131;57357;44226
441;"17.03.2007";17;"18.1";12524;56727;44203
441;"17.03.2007";18;"23.2";11082;57375;46293
441;"17.03.2007";19;"27.9";10053;60000;49947
441;"17.03.2007";20;33;9507;60072;50565
441;"17.03.2007";21;"26.7";9737;56097;46360
441;"17.03.2007";22;"20.1";10071;53930;43859
441;"17.03.2007";23;"19.2";10828;53922;43094
441;"17.03.2007";24;"1.6";12032;50739;38707
442;"18.03.2007";1;"12.6";13887;47888;34001
442;"18.03.2007";2;"6.9";15222;45997;30775
442;"18.03.2007";3;0;16147;45248;29101
442;"18.03.2007";4;0;16913;45496;28583
442;"18.03.2007";5;0;17564;46466;28902
442;"18.03.2007";6;0;17869;46128;28259
442;"18.03.2007";7;0;18195;44571;26376
442;"18.03.2007";8;0;18311;46059;27748
442;"18.03.2007";9;0;18293;49598;31305
442;"18.03.2007";10;"5.5";18024;52655;34631
442;"18.03.2007";11;"11.6";17600;54855;37255
442;"18.03.2007";12;"17.8";17368;57752;40384
442;"18.03.2007";13;"14.1";17045;56586;39541
442;"18.03.2007";14;11;16991;54289;37298
442;"18.03.2007";15;"5.5";16583;52641;36058
442;"18.03.2007";16;"3.7";15664;51619;35955
442;"18.03.2007";17;"3.9";14686;51300;36614
442;"18.03.2007";18;11;13778;52563;38785
442;"18.03.2007";19;"22.3";13333;56496;43163
442;"18.03.2007";20;26;13608;59379;45771
442;"18.03.2007";21;"23.2";13045;56995;43950
442;"18.03.2007";22;"21.7";12756;56259;43503
442;"18.03.2007";23;"22.7";12550;56985;44435
442;"18.03.2007";24;19;12458;53874;41416
443;"19.03.2007";1;"10.1";12144;51454;39310
443;"19.03.2007";2;"8.1";12189;50061;37872
443;"19.03.2007";3;"8.1";11644;49659;38015
443;"19.03.2007";4;7;10121;49678;39557
443;"19.03.2007";5;"7.4";8973;50372;41399
443;"19.03.2007";6;"15.9";8103;52836;44733
443;"19.03.2007";7;23;7238;59170;51932
443;"19.03.2007";8;26;6597;64232;57635
443;"19.03.2007";9;"29.5";5784;67299;61515
443;"19.03.2007";10;"30.5";5814;68069;62255
443;"19.03.2007";11;31;5400;69022;63622
443;"19.03.2007";12;31;4447;70178;65731
443;"19.03.2007";13;"32.3";3903;69325;65422
443;"19.03.2007";14;"32.5";3685;68856;65171
443;"19.03.2007";15;"32.2";3850;67858;64008
443;"19.03.2007";16;"30.8";3603;66843;63240
443;"19.03.2007";17;29;3104;65173;62069
443;"19.03.2007";18;"28.3";2689;64830;62141
443;"19.03.2007";19;"32.7";2244;67480;65236
443;"19.03.2007";20;"41.2";2034;69991;67957
443;"19.03.2007";21;32;2372;66255;63883
443;"19.03.2007";22;"26.9";3103;63135;60032
443;"19.03.2007";23;"27.1";3323;60995;57672
443;"19.03.2007";24;"23.2";3369;55966;52597
444;"20.03.2007";1;"22.5";3555;52512;48957
444;"20.03.2007";2;"23.4";3879;50326;46447
444;"20.03.2007";3;23;3571;49424;45853
444;"20.03.2007";4;"20.6";3060;50041;46981
444;"20.03.2007";5;"20.9";2716;51136;48420
444;"20.03.2007";6;23;2444;53609;51165
444;"20.03.2007";7;24;2220;58961;56741
444;"20.03.2007";8;31;1994;63908;61914
444;"20.03.2007";9;"33.8";1446;66468;65022
444;"20.03.2007";10;34;1257;66829;65572
444;"20.03.2007";11;35;1505;67894;66389
444;"20.03.2007";12;"35.1";2151;69387;67236
444;"20.03.2007";13;35;2544;68646;66102
444;"20.03.2007";14;"34.1";2814;68028;65214
444;"20.03.2007";15;"33.4";3123;67317;64194
444;"20.03.2007";16;"32.1";3635;66490;62855
444;"20.03.2007";17;"31.2";4234;65036;60802
444;"20.03.2007";18;"30.1";3804;64854;61050
444;"20.03.2007";19;"34.1";3406;67754;64348
444;"20.03.2007";20;"44.7";3372;70498;67126
444;"20.03.2007";21;"35.1";3735;66764;63029
444;"20.03.2007";22;"28.1";3875;63385;59510
444;"20.03.2007";23;"24.3";3789;61110;57321
444;"20.03.2007";24;"22.4";3611;56247;52636
445;"21.03.2007";1;"24.4";3745;52840;49095
445;"21.03.2007";2;"25.1";3948;50591;46643
445;"21.03.2007";3;"24.5";4288;49849;45561
445;"21.03.2007";4;"23.6";4470;50243;45773
445;"21.03.2007";5;"23.9";4745;51842;47097
445;"21.03.2007";6;"27.6";5253;54718;49465
445;"21.03.2007";7;"26.1";5557;60424;54867
445;"21.03.2007";8;"29.1";5613;65228;59615
445;"21.03.2007";9;33;5710;67778;62068
445;"21.03.2007";10;"34.1";6154;68116;61962
445;"21.03.2007";11;"34.1";6760;69245;62485
445;"21.03.2007";12;"34.7";6755;70506;63751
445;"21.03.2007";13;"35.1";6464;69708;63244
445;"21.03.2007";14;"34.9";6181;69293;63112
445;"21.03.2007";15;"32.1";6009;68569;62560
445;"21.03.2007";16;"29.9";5805;67445;61640
445;"21.03.2007";17;"28.9";5570;66287;60717
445;"21.03.2007";18;"27.1";5200;66849;61649
445;"21.03.2007";19;"33.1";4815;69179;64364
445;"21.03.2007";20;"41.7";4389;70616;66227
445;"21.03.2007";21;34;4183;66951;62768
445;"21.03.2007";22;"28.7";4181;64011;59830
445;"21.03.2007";23;29;4261;61797;57536
445;"21.03.2007";24;24;4484;57210;52726
446;"22.03.2007";1;"23.7";4930;53924;48994
446;"22.03.2007";2;"22.1";4869;51658;46789
446;"22.03.2007";3;"19.9";4933;50942;46009
446;"22.03.2007";4;"22.2";5060;51081;46021
446;"22.03.2007";5;"23.3";5029;52043;47014
446;"22.03.2007";6;"24.2";4850;54061;49211
446;"22.03.2007";7;"24.4";4788;60036;55248
446;"22.03.2007";8;"29.9";4682;65888;61206
446;"22.03.2007";9;"31.6";4745;68895;64150
446;"22.03.2007";10;"32.5";5098;69733;64635
446;"22.03.2007";11;"33.1";5547;71069;65522
446;"22.03.2007";12;"40.3";6122;72367;66245
446;"22.03.2007";13;"37.1";6600;71997;65397
446;"22.03.2007";14;38;7458;71654;64196
446;"22.03.2007";15;"32.5";8050;70804;62754
446;"22.03.2007";16;"31.8";8841;70142;61301
446;"22.03.2007";17;"31.2";9341;68493;59152
446;"22.03.2007";18;"31.1";9911;68879;58968
446;"22.03.2007";19;"39.9";10106;71030;60924
446;"22.03.2007";20;"54.5";10099;71854;61755
446;"22.03.2007";21;"37.5";10471;67797;57326
446;"22.03.2007";22;"32.1";10229;64818;54589
446;"22.03.2007";23;"31.5";9963;63159;53196
446;"22.03.2007";24;"26.9";9547;58484;48937
447;"23.03.2007";1;"25.4";9729;55225;45496
447;"23.03.2007";2;"23.7";9428;53155;43727
447;"23.03.2007";3;"22.7";8886;52416;43530
447;"23.03.2007";4;"22.6";8569;52559;43990
447;"23.03.2007";5;23;8926;53843;44917
447;"23.03.2007";6;"25.9";8460;55841;47381
447;"23.03.2007";7;"29.1";8123;60922;52799
447;"23.03.2007";8;34;8204;66092;57888
447;"23.03.2007";9;35;8578;68667;60089
447;"23.03.2007";10;36;8626;69331;60705
447;"23.03.2007";11;"36.6";8958;70144;61186
447;"23.03.2007";12;"39.9";9493;70829;61336
447;"23.03.2007";13;"37.4";9816;70018;60202
447;"23.03.2007";14;35;10067;68847;58780
447;"23.03.2007";15;"30.7";9708;67687;57979
447;"23.03.2007";16;"28.1";9155;66651;57496
447;"23.03.2007";17;"25.8";8892;65869;56977
447;"23.03.2007";18;27;8589;66158;57569
447;"23.03.2007";19;33;8502;68503;60001
447;"23.03.2007";20;"39.1";8441;70043;61602
447;"23.03.2007";21;"32.3";7804;65775;57971
447;"23.03.2007";22;"29.3";7039;62428;55389
447;"23.03.2007";23;"29.3";6911;61089;54178
447;"23.03.2007";24;"24.8";7437;57091;49654
448;"24.03.2007";1;"25.1";7434;53571;46137
448;"24.03.2007";2;22;7468;51484;44016
448;"24.03.2007";3;22;7476;50412;42936
448;"24.03.2007";4;"21.4";8008;50200;42192
448;"24.03.2007";5;"21.7";8169;50526;42357
448;"24.03.2007";6;"19.3";8472;50137;41665
448;"24.03.2007";7;"17.5";8849;49426;40577
448;"24.03.2007";8;"21.3";9001;52484;43483
448;"24.03.2007";9;"24.1";9364;56607;47243
448;"24.03.2007";10;30;9597;60342;50745
448;"24.03.2007";11;33;9981;61774;51793
448;"24.03.2007";12;"33.9";10099;62213;52114
448;"24.03.2007";13;"26.2";10653;61412;50759
448;"24.03.2007";14;"23.4";11478;59642;48164
448;"24.03.2007";15;"24.1";11750;58005;46255
448;"24.03.2007";16;"22.2";11759;57520;45761
448;"24.03.2007";17;22;11292;56485;45193
448;"24.03.2007";18;"23.1";10385;57540;47155
448;"24.03.2007";19;"23.4";9647;59468;49821
448;"24.03.2007";20;"30.6";9483;61432;51949
448;"24.03.2007";21;"21.4";9766;58316;48550
448;"24.03.2007";22;"21.9";9565;55996;46431
448;"24.03.2007";23;"23.3";8832;55141;46309
448;"24.03.2007";24;"20.2";8936;51583;42647
449;"25.03.2007";1;"21.5";8492;47744;39252
449;"25.03.2007";2;"18.9";8045;45539;37494
449;"25.03.2007";3;"18.9";8045;45539;37494
449;"25.03.2007";4;"12.1";7869;44362;36493
449;"25.03.2007";5;"20.1";7757;44596;36839
449;"25.03.2007";6;"17.2";7509;44049;36540
449;"25.03.2007";7;"4.6";7553;41836;34283
449;"25.03.2007";8;"5.3";7233;41396;34163
449;"25.03.2007";9;"20.8";6676;43921;37245
449;"25.03.2007";10;"23.3";6102;46869;40767
449;"25.03.2007";11;"24.7";6824;49636;42812
449;"25.03.2007";12;"25.6";8414;52486;44072
449;"25.03.2007";13;"25.9";10233;52615;42382
449;"25.03.2007";14;"23.3";11891;50761;38870
449;"25.03.2007";15;"20.2";12372;48687;36315
449;"25.03.2007";16;16;11949;47383;35434
449;"25.03.2007";17;"15.4";11452;46598;35146
449;"25.03.2007";18;"11.7";10176;47238;37062
449;"25.03.2007";19;"18.1";8404;49056;40652
449;"25.03.2007";20;"25.2";7182;51375;44193
449;"25.03.2007";21;"27.3";7044;55196;48152
449;"25.03.2007";22;"26.3";7650;54772;47122
449;"25.03.2007";23;"26.3";7446;55019;47573
449;"25.03.2007";24;"22.9";6808;51267;44459
450;"26.03.2007";1;"24.2";6247;47547;41300
450;"26.03.2007";2;"23.1";6084;45308;39224
450;"26.03.2007";3;"23.2";6090;44952;38862
450;"26.03.2007";4;21;5917;45567;39650
450;"26.03.2007";5;"19.1";5782;47318;41536
450;"26.03.2007";6;25;5728;51005;45277
450;"26.03.2007";7;"26.4";5604;58851;53247
450;"26.03.2007";8;"35.1";5642;63989;58347
450;"26.03.2007";9;"32.1";4801;66512;61711
450;"26.03.2007";10;"37.2";3847;66648;62801
450;"26.03.2007";11;"36.2";3293;66754;63461
450;"26.03.2007";12;"36.1";3975;67536;63561
450;"26.03.2007";13;"32.1";6719;67506;60787
450;"26.03.2007";14;32;8473;67122;58649
450;"26.03.2007";15;"31.4";9397;66020;56623
450;"26.03.2007";16;"28.5";9694;64706;55012
450;"26.03.2007";17;"26.8";9807;62864;53057
450;"26.03.2007";18;26;9447;62289;52842
450;"26.03.2007";19;"24.7";8345;62147;53802
450;"26.03.2007";20;28;7504;63528;56024
450;"26.03.2007";21;"30.8";7514;66002;58488
450;"26.03.2007";22;"27.4";7729;63344;55615
450;"26.03.2007";23;"26.1";7645;60395;52750
450;"26.03.2007";24;"23.3";6718;54806;48088
451;"27.03.2007";1;"24.1";6499;50831;44332
451;"27.03.2007";2;"23.2";6193;48363;42170
451;"27.03.2007";3;23;5753;47247;41494
451;"27.03.2007";4;"21.5";5459;47840;42381
451;"27.03.2007";5;"22.9";5162;49608;44446
451;"27.03.2007";6;"26.7";5138;52785;47647
451;"27.03.2007";7;29;5094;59991;54897
451;"27.03.2007";8;34;5060;64621;59561
451;"27.03.2007";9;"37.7";4282;66443;62161
451;"27.03.2007";10;"38.9";3008;66466;63458
451;"27.03.2007";11;40;2675;66360;63685
451;"27.03.2007";12;"41.4";3607;67321;63714
451;"27.03.2007";13;"38.4";5022;66415;61393
451;"27.03.2007";14;"33.1";6376;66126;59750
451;"27.03.2007";15;"28.9";7374;65080;57706
451;"27.03.2007";16;"27.3";7952;63859;55907
451;"27.03.2007";17;"23.9";8594;62127;53533
451;"27.03.2007";18;"22.9";8491;61665;53174
451;"27.03.2007";19;"23.6";7564;61990;54426
451;"27.03.2007";20;25;6854;63508;56654
451;"27.03.2007";21;"32.1";6896;65953;59057
451;"27.03.2007";22;"27.7";6927;63121;56194
451;"27.03.2007";23;"28.1";6892;60082;53190
451;"27.03.2007";24;"24.7";6386;54455;48069
452;"28.03.2007";1;"22.6";5876;50803;44927
452;"28.03.2007";2;"19.2";5466;48185;42719
452;"28.03.2007";3;17;4978;47280;42302
452;"28.03.2007";4;"18.4";4538;47935;43397
452;"28.03.2007";5;"17.1";3937;50038;46101
452;"28.03.2007";6;"22.1";3645;53552;49907
452;"28.03.2007";7;"23.6";3611;60242;56631
452;"28.03.2007";8;32;3346;64432;61086
452;"28.03.2007";9;"32.1";2956;66712;63756
452;"28.03.2007";10;"35.1";1807;66323;64516
452;"28.03.2007";11;37;1051;66390;65339
452;"28.03.2007";12;37;1247;67299;66052
452;"28.03.2007";13;"34.1";2188;66450;64262
452;"28.03.2007";14;"33.1";3274;65911;62637
452;"28.03.2007";15;32;3721;64863;61142
452;"28.03.2007";16;"28.5";3824;63768;59944
452;"28.03.2007";17;26;3852;62311;58459
452;"28.03.2007";18;"25.1";3939;61924;57985
452;"28.03.2007";19;"24.8";3931;62170;58239
452;"28.03.2007";20;"27.5";3782;63488;59706
452;"28.03.2007";21;"36.5";4195;65487;61292
452;"28.03.2007";22;"29.1";4570;62582;58012
452;"28.03.2007";23;"24.9";4761;59534;54773
452;"28.03.2007";24;"22.6";4784;54520;49736
453;"29.03.2007";1;"23.4";4840;50648;45808
453;"29.03.2007";2;"22.2";4765;48664;43899
453;"29.03.2007";3;"21.9";4939;47592;42653
453;"29.03.2007";4;"20.4";4714;47719;43005
453;"29.03.2007";5;"17.9";4799;49208;44409
453;"29.03.2007";6;"23.8";5224;52769;47545
453;"29.03.2007";7;"25.1";5367;60206;54839
453;"29.03.2007";8;"29.9";5517;64862;59345
453;"29.03.2007";9;33;4949;66775;61826
453;"29.03.2007";10;"33.2";4152;66812;62660
453;"29.03.2007";11;"34.1";4245;67261;63016
453;"29.03.2007";12;"34.1";4730;68370;63640
453;"29.03.2007";13;"32.4";4929;67486;62557
453;"29.03.2007";14;32;4932;66797;61865
453;"29.03.2007";15;"27.5";4939;66002;61063
453;"29.03.2007";16;"28.2";4884;65199;60315
453;"29.03.2007";17;"24.9";4700;63645;58945
453;"29.03.2007";18;"24.8";4486;63386;58900
453;"29.03.2007";19;"27.5";3532;63363;59831
453;"29.03.2007";20;30;3170;64497;61327
453;"29.03.2007";21;"33.3";3337;65875;62538
453;"29.03.2007";22;"28.6";3123;62809;59686
453;"29.03.2007";23;"28.6";2884;59600;56716
453;"29.03.2007";24;"24.6";2726;54565;51839
454;"30.03.2007";1;"25.9";2337;50662;48325
454;"30.03.2007";2;"24.1";2257;48289;46032
454;"30.03.2007";3;"23.5";2037;47307;45270
454;"30.03.2007";4;"22.1";1921;48176;46255
454;"30.03.2007";5;"22.4";1790;49828;48038
454;"30.03.2007";6;"25.1";1738;52890;51152
454;"30.03.2007";7;29;1608;59468;57860
454;"30.03.2007";8;"43.5";1537;64223;62686
454;"30.03.2007";9;"47.1";1331;66210;64879
454;"30.03.2007";10;"47.9";872;66274;65402
454;"30.03.2007";11;51;780;66505;65725
454;"30.03.2007";12;"50.4";1159;66846;65687
454;"30.03.2007";13;"49.2";1594;65757;64163
454;"30.03.2007";14;39;1516;64252;62736
454;"30.03.2007";15;34;1716;62493;60777
454;"30.03.2007";16;32;1945;61322;59377
454;"30.03.2007";17;"28.9";2383;60470;58087
454;"30.03.2007";18;"27.5";2994;60678;57684
454;"30.03.2007";19;"27.8";2917;60795;57878
454;"30.03.2007";20;"28.2";3167;61616;58449
454;"30.03.2007";21;"32.6";3703;62640;58937
454;"30.03.2007";22;"31.1";4345;59716;55371
454;"30.03.2007";23;"28.9";4688;57713;53025
454;"30.03.2007";24;"23.4";4621;53769;49148
455;"31.03.2007";1;"28.6";4274;49401;45127
455;"31.03.2007";2;27;3821;46639;42818
455;"31.03.2007";3;"25.5";3382;45084;41702
455;"31.03.2007";4;"24.9";3237;45068;41831
455;"31.03.2007";5;"24.4";3443;45952;42509
455;"31.03.2007";6;"25.1";3571;46332;42761
455;"31.03.2007";7;"26.2";3664;47010;43346
455;"31.03.2007";8;"27.3";3685;49300;45615
455;"31.03.2007";9;"30.9";3325;53188;49863
455;"31.03.2007";10;34;2441;55766;53325
455;"31.03.2007";11;"37.8";2256;56791;54535
455;"31.03.2007";12;38;3229;57294;54065
455;"31.03.2007";13;"35.9";4922;56321;51399
455;"31.03.2007";14;"30.1";5644;54423;48779
455;"31.03.2007";15;"25.2";5960;52552;46592
455;"31.03.2007";16;"23.9";6298;52050;45752
455;"31.03.2007";17;"23.3";6585;51774;45189
455;"31.03.2007";18;"23.6";7034;52923;45889
455;"31.03.2007";19;"24.9";6939;54299;47360
455;"31.03.2007";20;"24.3";6563;55186;48623
455;"31.03.2007";21;31;6662;56089;49427
455;"31.03.2007";22;"28.9";7150;54076;46926
455;"31.03.2007";23;"29.6";6867;53072;46205
455;"31.03.2007";24;"23.7";6327;49116;42789
456;"01.04.2007";1;"23.8";5961;45716;39755
456;"01.04.2007";2;"20.1";5514;43013;37499
456;"01.04.2007";3;"18.1";5150;41700;36550
456;"01.04.2007";4;"17.4";4894;41592;36698
456;"01.04.2007";5;"18.2";4901;42117;37216
456;"01.04.2007";6;"18.2";4723;41881;37158
456;"01.04.2007";7;8;4754;40750;35996
456;"01.04.2007";8;"15.9";4692;41348;36656
456;"01.04.2007";9;"21.6";3956;44424;40468
456;"01.04.2007";10;"23.4";2561;47100;44539
456;"01.04.2007";11;26;2358;48579;46221
456;"01.04.2007";12;"26.5";3689;50600;46911
456;"01.04.2007";13;"27.1";5785;50239;44454
456;"01.04.2007";14;"23.9";7557;48369;40812
456;"01.04.2007";15;21;7947;46238;38291
456;"01.04.2007";16;"19.3";7640;44797;37157
456;"01.04.2007";17;20;7521;44642;37121
456;"01.04.2007";18;"18.7";7009;45846;38837
456;"01.04.2007";19;"22.4";5867;48019;42152
456;"01.04.2007";20;"25.9";5040;49955;44915
456;"01.04.2007";21;"27.1";5259;53396;48137
456;"01.04.2007";22;"25.7";5567;52996;47429
456;"01.04.2007";23;"27.7";5550;53148;47598
456;"01.04.2007";24;24;5051;49354;44303
457;"02.04.2007";1;"23.2";4413;45980;41567
457;"02.04.2007";2;"21.4";3610;43615;40005
457;"02.04.2007";3;"20.7";3113;42830;39717
457;"02.04.2007";4;18;2729;43371;40642
457;"02.04.2007";5;"19.8";2592;45822;43230
457;"02.04.2007";6;24;2342;49757;47415
457;"02.04.2007";7;"27.1";2198;56475;54277
457;"02.04.2007";8;34;1980;61248;59268
457;"02.04.2007";9;"41.4";1730;64519;62789
457;"02.04.2007";10;"44.6";973;65292;64319
457;"02.04.2007";11;48;500;65902;65402
457;"02.04.2007";12;"51.1";531;66849;66318
457;"02.04.2007";13;"44.5";797;65727;64930
457;"02.04.2007";14;41;1294;64969;63675
457;"02.04.2007";15;"34.3";1319;63916;62597
457;"02.04.2007";16;"32.6";1172;62720;61548
457;"02.04.2007";17;"29.8";1204;60985;59781
457;"02.04.2007";18;"28.6";1362;60846;59484
457;"02.04.2007";19;"28.6";1628;61225;59597
457;"02.04.2007";20;"33.9";1870;62055;60185
457;"02.04.2007";21;"35.4";2252;63833;61581
457;"02.04.2007";22;29;2661;61385;58724
457;"02.04.2007";23;29;2305;57715;55410
457;"02.04.2007";24;25;2418;52437;50019
458;"03.04.2007";1;"24.6";2301;48526;46225
458;"03.04.2007";2;"23.4";2176;46327;44151
458;"03.04.2007";3;"23.1";2282;45537;43255
458;"03.04.2007";4;22;2293;46229;43936
458;"03.04.2007";5;"20.1";2412;48302;45890
458;"03.04.2007";6;"24.8";2629;51552;48923
458;"03.04.2007";7;"27.8";3087;57858;54771
458;"03.04.2007";8;"44.8";3367;62374;59007
458;"03.04.2007";9;"43.8";3139;64698;61559
458;"03.04.2007";10;"44.6";3267;65763;62496
458;"03.04.2007";11;"43.2";3481;66800;63319
458;"03.04.2007";12;"45.5";3862;67983;64121
458;"03.04.2007";13;40;4355;67015;62660
458;"03.04.2007";14;35;5327;66540;61213
458;"03.04.2007";15;35;6143;65822;59679
458;"03.04.2007";16;"34.9";6903;65696;58793
458;"03.04.2007";17;"28.5";7534;64729;57195
458;"03.04.2007";18;"25.4";7485;64401;56916
458;"03.04.2007";19;"25.7";7443;64797;57354
458;"03.04.2007";20;"25.3";6294;65179;58885
458;"03.04.2007";21;"39.9";6065;65892;59827
458;"03.04.2007";22;"29.4";6067;62943;56876
458;"03.04.2007";23;"24.9";6034;60305;54271
458;"03.04.2007";24;"23.7";5862;55656;49794
459;"04.04.2007";1;27;5784;51932;46148
459;"04.04.2007";2;24;5355;49287;43932
459;"04.04.2007";3;"23.6";4852;48267;43415
459;"04.04.2007";4;"23.6";4265;48550;44285
459;"04.04.2007";5;"23.8";3842;49845;46003
459;"04.04.2007";6;"28.9";3473;52637;49164
459;"04.04.2007";7;"29.9";3146;58118;54972
459;"04.04.2007";8;39;2939;63002;60063
459;"04.04.2007";9;"45.3";2694;65393;62699
459;"04.04.2007";10;"51.7";2690;65872;63182
459;"04.04.2007";11;"52.9";2771;66763;63992
459;"04.04.2007";12;"53.6";2658;67922;65264
459;"04.04.2007";13;"50.1";2230;66619;64389
459;"04.04.2007";14;"49.7";1995;65445;63450
459;"04.04.2007";15;39;1967;64825;62858
459;"04.04.2007";16;"38.9";1888;63767;61879
459;"04.04.2007";17;"36.9";1967;62339;60372
459;"04.04.2007";18;"34.1";2026;61487;59461
459;"04.04.2007";19;34;1953;61684;59731
459;"04.04.2007";20;36;1793;62098;60305
459;"04.04.2007";21;"46.7";1853;63894;62041
459;"04.04.2007";22;"40.5";2154;61880;59726
459;"04.04.2007";23;37;2274;59228;56954
459;"04.04.2007";24;"31.3";2548;54427;51879
460;"05.04.2007";1;"28.9";3166;51077;47911
460;"05.04.2007";2;"24.9";3742;49316;45574
460;"05.04.2007";3;24;4269;48597;44328
460;"05.04.2007";4;"23.6";4818;49173;44355
460;"05.04.2007";5;"23.7";5551;50622;45071
460;"05.04.2007";6;"26.3";6052;53338;47286
460;"05.04.2007";7;"24.8";6397;58744;52347
460;"05.04.2007";8;32;6155;63377;57222
460;"05.04.2007";9;"41.5";6079;65775;59696
460;"05.04.2007";10;42;6430;66667;60237
460;"05.04.2007";11;"45.5";7046;67643;60597
460;"05.04.2007";12;44;7184;68594;61410
460;"05.04.2007";13;"41.9";7929;67619;59690
460;"05.04.2007";14;"38.1";8109;66723;58614
460;"05.04.2007";15;"33.4";8572;65144;56572
460;"05.04.2007";16;"30.5";9162;64013;54851
460;"05.04.2007";17;"27.1";9528;62817;53289
460;"05.04.2007";18;"26.9";9002;62290;53288
460;"05.04.2007";19;"27.1";7977;62253;54276
460;"05.04.2007";20;"28.9";6905;62115;55210
460;"05.04.2007";21;"32.7";6438;63302;56864
460;"05.04.2007";22;"24.6";6493;61157;54664
460;"05.04.2007";23;"26.4";6495;58353;51858
460;"05.04.2007";24;"22.2";6110;53676;47566
461;"06.04.2007";1;"34.4";5857;49439;43582
461;"06.04.2007";2;"29.4";5721;46616;40895
461;"06.04.2007";3;25;5545;45039;39494
461;"06.04.2007";4;"24.4";5192;44738;39546
461;"06.04.2007";5;"25.1";4673;44844;40171
461;"06.04.2007";6;29;3882;43695;39813
461;"06.04.2007";7;8;3374;41275;37901
461;"06.04.2007";8;"1.6";2881;42062;39181
461;"06.04.2007";9;10;2773;44954;42181
461;"06.04.2007";10;"24.1";3088;47559;44471
461;"06.04.2007";11;"26.1";3225;49288;46063
461;"06.04.2007";12;"34.1";3347;51392;48045
461;"06.04.2007";13;"31.9";3471;50751;47280
461;"06.04.2007";14;"27.1";3694;48307;44613
461;"06.04.2007";15;"23.1";3768;46349;42581
461;"06.04.2007";16;"17.8";3677;45259;41582
461;"06.04.2007";17;"14.4";3303;44823;41520
461;"06.04.2007";18;"18.5";3038;45788;42750
461;"06.04.2007";19;"23.2";2581;47573;44992
461;"06.04.2007";20;"23.4";2087;48470;46383
461;"06.04.2007";21;"30.2";2010;50532;48522
461;"06.04.2007";22;"29.5";2031;50033;48002
461;"06.04.2007";23;31;2094;49163;47069
461;"06.04.2007";24;28;2023;45482;43459
462;"07.04.2007";1;"25.4";1878;41850;39972
462;"07.04.2007";2;"23.1";1741;39704;37963
462;"07.04.2007";3;"20.4";1828;38876;37048
462;"07.04.2007";4;"20.8";1761;38943;37182
462;"07.04.2007";5;"20.1";1832;40042;38210
462;"07.04.2007";6;"21.1";1867;40919;39052
462;"07.04.2007";7;"20.7";1914;41338;39424
462;"07.04.2007";8;"23.2";1689;43509;41820
462;"07.04.2007";9;"27.4";1505;47053;45548
462;"07.04.2007";10;29;1877;49815;47938
462;"07.04.2007";11;29;1978;51216;49238
462;"07.04.2007";12;"28.5";2016;52254;50238
462;"07.04.2007";13;"29.9";2223;51650;49427
462;"07.04.2007";14;"27.9";2577;50307;47730
462;"07.04.2007";15;25;3059;48987;45928
462;"07.04.2007";16;"23.9";3391;48473;45082
462;"07.04.2007";17;"22.9";3824;48018;44194
462;"07.04.2007";18;"22.1";3900;49112;45212
462;"07.04.2007";19;25;4108;50110;46002
462;"07.04.2007";20;26;3509;49958;46449
462;"07.04.2007";21;28;3464;50711;47247
462;"07.04.2007";22;"25.9";3911;49850;45939
462;"07.04.2007";23;26;4627;49281;44654
462;"07.04.2007";24;"23.5";5316;46039;40723
463;"08.04.2007";1;"22.4";5623;42623;37000
463;"08.04.2007";2;"19.9";5423;40214;34791
463;"08.04.2007";3;18;5456;38898;33442
463;"08.04.2007";4;"16.7";4996;38937;33941
463;"08.04.2007";5;15;4398;39349;34951
463;"08.04.2007";6;16;3902;38975;35073
463;"08.04.2007";7;"12.9";3485;37249;33764
463;"08.04.2007";8;"12.7";3087;38200;35113
463;"08.04.2007";9;"21.1";3015;41667;38652
463;"08.04.2007";10;"23.1";3245;44197;40952
463;"08.04.2007";11;24;3156;45267;42111
463;"08.04.2007";12;"25.9";3384;47138;43754
463;"08.04.2007";13;"24.1";3871;45198;41327
463;"08.04.2007";14;22;4489;42010;37521
463;"08.04.2007";15;19;5064;40316;35252
463;"08.04.2007";16;"17.3";5747;39356;33609
463;"08.04.2007";17;"13.7";6186;38999;32813
463;"08.04.2007";18;"13.9";6158;40273;34115
463;"08.04.2007";19;"18.5";5754;42133;36379
463;"08.04.2007";20;"22.2";5196;43616;38420
463;"08.04.2007";21;24;5081;46239;41158
463;"08.04.2007";22;"24.2";5302;46737;41435
463;"08.04.2007";23;26;6031;46693;40662
463;"08.04.2007";24;"23.2";6676;43852;37176
464;"09.04.2007";1;"24.2";7066;40821;33755
464;"09.04.2007";2;"22.1";7572;38942;31370
464;"09.04.2007";3;"20.3";7726;38089;30363
464;"09.04.2007";4;20;7720;38372;30652
464;"09.04.2007";5;16;7737;39243;31506
464;"09.04.2007";6;"20.1";7837;39655;31818
464;"09.04.2007";7;"11.9";7867;38633;30766
464;"09.04.2007";8;"12.1";7868;39432;31564
464;"09.04.2007";9;"21.1";7506;42049;34543
464;"09.04.2007";10;"23.1";7682;44753;37071
464;"09.04.2007";11;25;8670;47020;38350
464;"09.04.2007";12;26;9951;49335;39384
464;"09.04.2007";13;"25.3";10637;48376;37739
464;"09.04.2007";14;"22.8";10810;46417;35607
464;"09.04.2007";15;"20.5";10299;44598;34299
464;"09.04.2007";16;18;9475;43457;33982
464;"09.04.2007";17;"17.7";8577;42656;34079
464;"09.04.2007";18;"11.6";7750;43865;36115
464;"09.04.2007";19;"21.7";6470;45650;39180
464;"09.04.2007";20;"23.5";4882;46730;41848
464;"09.04.2007";21;25;4105;48898;44793
464;"09.04.2007";22;"25.6";4060;49000;44940
464;"09.04.2007";23;28;4014;48583;44569
464;"09.04.2007";24;"23.2";3916;45108;41192
465;"10.04.2007";1;"22.6";3745;41709;37964
465;"10.04.2007";2;"18.9";3762;39781;36019
465;"10.04.2007";3;"12.6";4084;39260;35176
465;"10.04.2007";4;11;4366;39483;35117
465;"10.04.2007";5;"19.1";4758;41685;36927
465;"10.04.2007";6;"23.4";5239;46269;41030
465;"10.04.2007";7;24;5785;54469;48684
465;"10.04.2007";8;32;6055;60740;54685
465;"10.04.2007";9;35;6469;64227;57758
465;"10.04.2007";10;"36.9";6866;65544;58678
465;"10.04.2007";11;37;6680;66812;60132
465;"10.04.2007";12;"38.1";7105;68089;60984
465;"10.04.2007";13;"36.7";7760;67261;59501
465;"10.04.2007";14;35;8429;67263;58834
465;"10.04.2007";15;34;8576;66281;57705
465;"10.04.2007";16;32;8360;65165;56805
465;"10.04.2007";17;30;7915;63575;55660
465;"10.04.2007";18;28;6973;63126;56153
465;"10.04.2007";19;"29.9";6274;62505;56231
465;"10.04.2007";20;"29.9";4595;62256;57661
465;"10.04.2007";21;"32.6";3831;62991;59160
465;"10.04.2007";22;"30.3";3607;60983;57376
465;"10.04.2007";23;"30.5";3407;57563;54156
465;"10.04.2007";24;"26.4";3277;52429;49152
466;"11.04.2007";1;26;3105;48586;45481
466;"11.04.2007";2;"23.6";2955;46293;43338
466;"11.04.2007";3;"23.4";2982;45230;42248
466;"11.04.2007";4;"23.3";3087;45819;42732
466;"11.04.2007";5;"22.6";3203;47730;44527
466;"11.04.2007";6;"25.1";3322;51402;48080
466;"11.04.2007";7;30;3252;57341;54089
466;"11.04.2007";8;"39.4";3030;62304;59274
466;"11.04.2007";9;"48.1";2601;64778;62177
466;"11.04.2007";10;"50.3";2363;65457;63094
466;"11.04.2007";11;"51.7";2422;66142;63720
466;"11.04.2007";12;"56.6";2889;67479;64590
466;"11.04.2007";13;"50.1";2863;66449;63586
466;"11.04.2007";14;"47.7";2797;65692;62895
466;"11.04.2007";15;"46.1";2637;64304;61667
466;"11.04.2007";16;"43.4";2422;63229;60807
466;"11.04.2007";17;41;2372;61840;59468
466;"11.04.2007";18;38;2277;61430;59153
466;"11.04.2007";19;"39.8";1844;61477;59633
466;"11.04.2007";20;"40.3";1629;61369;59740
466;"11.04.2007";21;"52.6";1618;62332;60714
466;"11.04.2007";22;49;1701;61155;59454
466;"11.04.2007";23;"42.1";1620;57600;55980
466;"11.04.2007";24;"30.9";1589;52156;50567
467;"12.04.2007";1;"28.6";1545;48003;46458
467;"12.04.2007";2;26;1474;45758;44284
467;"12.04.2007";3;"24.1";1539;44662;43123
467;"12.04.2007";4;"21.1";1337;45071;43734
467;"12.04.2007";5;24;1215;46783;45568
467;"12.04.2007";6;"29.2";1127;50542;49415
467;"12.04.2007";7;31;1115;56282;55167
467;"12.04.2007";8;45;1108;61374;60266
467;"12.04.2007";9;"52.8";983;64192;63209
467;"12.04.2007";10;"57.2";714;64752;64038
467;"12.04.2007";11;"62.6";637;65425;64788
467;"12.04.2007";12;110;700;66501;65801
467;"12.04.2007";13;59;784;65534;64750
467;"12.04.2007";14;"54.9";845;64467;63622
467;"12.04.2007";15;"46.4";1089;63301;62212
467;"12.04.2007";16;"48.8";1421;62188;60767
467;"12.04.2007";17;"40.8";1785;60777;58992
467;"12.04.2007";18;"39.5";2127;60657;58530
467;"12.04.2007";19;37;2355;60854;58499
467;"12.04.2007";20;"35.7";2510;61073;58563
467;"12.04.2007";21;"34.1";3152;62324;59172
467;"12.04.2007";22;"32.2";4021;61115;57094
467;"12.04.2007";23;25;4347;57277;52930
467;"12.04.2007";24;"23.2";4244;51777;47533
468;"13.04.2007";1;26;4121;47741;43620
468;"13.04.2007";2;"22.5";3992;45450;41458
468;"13.04.2007";3;"20.3";3806;44144;40338
468;"13.04.2007";4;"19.1";3671;44432;40761
468;"13.04.2007";5;"16.9";3431;45882;42451
468;"13.04.2007";6;"23.6";3417;49703;46286
468;"13.04.2007";7;"24.2";3311;55982;52671
468;"13.04.2007";8;"35.4";3166;61600;58434
468;"13.04.2007";9;45;2490;64474;61984
468;"13.04.2007";10;"53.6";1637;64916;63279
468;"13.04.2007";11;"64.9";1684;65746;64062
468;"13.04.2007";12;65;2128;66874;64746
468;"13.04.2007";13;52;2759;65590;62831
468;"13.04.2007";14;"38.5";3427;64031;60604
468;"13.04.2007";15;"40.1";3536;62139;58603
468;"13.04.2007";16;"34.1";3866;60954;57088
468;"13.04.2007";17;30;4270;59913;55643
468;"13.04.2007";18;"27.2";4580;60012;55432
468;"13.04.2007";19;"27.3";4725;60215;55490
468;"13.04.2007";20;"28.1";4761;59742;54981
468;"13.04.2007";21;42;5308;60536;55228
468;"13.04.2007";22;"38.1";5708;59465;53757
468;"13.04.2007";23;"29.9";5525;55826;50301
468;"13.04.2007";24;"24.1";5254;50800;45546
469;"14.04.2007";1;28;5000;47233;42233
469;"14.04.2007";2;"24.7";4787;44774;39987
469;"14.04.2007";3;"23.1";4690;43018;38328
469;"14.04.2007";4;"21.6";4513;42491;37978
469;"14.04.2007";5;"19.6";4326;43033;38707
469;"14.04.2007";6;"20.9";4279;44154;39875
469;"14.04.2007";7;"18.1";4300;45408;41108
469;"14.04.2007";8;21;3961;49012;45051
469;"14.04.2007";9;28;2798;52886;50088
469;"14.04.2007";10;"30.1";1711;54843;53132
469;"14.04.2007";11;33;1555;55779;54224
469;"14.04.2007";12;"33.8";2137;56094;53957
469;"14.04.2007";13;36;2584;54355;51771
469;"14.04.2007";14;"31.9";3027;51807;48780
469;"14.04.2007";15;31;3132;50009;46877
469;"14.04.2007";16;"28.1";3159;49137;45978
469;"14.04.2007";17;"27.4";3200;48779;45579
469;"14.04.2007";18;26;3381;49740;46359
469;"14.04.2007";19;"27.6";3578;51048;47470
469;"14.04.2007";20;29;3686;50758;47072
469;"14.04.2007";21;"28.1";4516;52005;47489
469;"14.04.2007";22;"28.1";5477;51898;46421
469;"14.04.2007";23;"29.9";5625;49668;44043
469;"14.04.2007";24;"21.1";5464;45427;39963
470;"15.04.2007";1;"24.9";5193;41860;36667
470;"15.04.2007";2;"23.2";4776;38971;34195
470;"15.04.2007";3;20;4335;37630;33295
470;"15.04.2007";4;"13.1";4040;36852;32812
470;"15.04.2007";5;"14.1";3572;36837;33265
470;"15.04.2007";6;"18.8";3443;37571;34128
470;"15.04.2007";7;"17.6";3470;37198;33728
470;"15.04.2007";8;"13.7";3176;39137;35961
470;"15.04.2007";9;20;2191;42175;39984
470;"15.04.2007";10;"24.1";1189;45032;43843
470;"15.04.2007";11;26;1086;46828;45742
470;"15.04.2007";12;28;1496;49005;47509
470;"15.04.2007";13;"27.7";2213;47711;45498
470;"15.04.2007";14;25;2564;45142;42578
470;"15.04.2007";15;"22.5";2590;43470;40880
470;"15.04.2007";16;22;2525;42404;39879
470;"15.04.2007";17;"18.2";2500;42223;39723
470;"15.04.2007";18;"20.1";2545;43905;41360
470;"15.04.2007";19;"24.1";2590;46250;43660
470;"15.04.2007";20;27;2691;47556;44865
470;"15.04.2007";21;"28.1";3456;50334;46878
470;"15.04.2007";22;"29.1";4468;51607;47139
470;"15.04.2007";23;"30.1";4713;49736;45023
470;"15.04.2007";24;25;4696;45632;40936
471;"16.04.2007";1;23;4463;42071;37608
471;"16.04.2007";2;20;4346;40396;36050
471;"16.04.2007";3;"19.6";3995;39546;35551
471;"16.04.2007";4;"18.1";3538;39627;36089
471;"16.04.2007";5;"20.5";3147;41132;37985
471;"16.04.2007";6;"25.8";2938;46025;43087
471;"16.04.2007";7;"27.9";2757;55348;52591
471;"16.04.2007";8;"41.6";2424;61218;58794
471;"16.04.2007";9;"47.1";1446;63897;62451
471;"16.04.2007";10;"49.1";696;64086;63390
471;"16.04.2007";11;"53.8";425;64900;64475
471;"16.04.2007";12;72;424;66240;65816
471;"16.04.2007";13;"50.6";484;65550;65066
471;"16.04.2007";14;49;517;64833;64316
471;"16.04.2007";15;"42.2";619;63802;63183
471;"16.04.2007";16;"38.5";644;62649;62005
471;"16.04.2007";17;"35.6";752;61289;60537
471;"16.04.2007";18;"34.1";868;61337;60469
471;"16.04.2007";19;"35.1";1021;61456;60435
471;"16.04.2007";20;33;1223;61063;59840
471;"16.04.2007";21;"42.6";1594;61727;60133
471;"16.04.2007";22;40;2260;60691;58431
471;"16.04.2007";23;"31.5";2586;55953;53367
471;"16.04.2007";24;28;2548;50071;47523
472;"17.04.2007";1;"22.8";2576;46245;43669
472;"17.04.2007";2;"22.5";2498;44436;41938
472;"17.04.2007";3;"20.8";2317;43276;40959
472;"17.04.2007";4;20;2240;43439;41199
472;"17.04.2007";5;"19.8";2338;45050;42712
472;"17.04.2007";6;"24.1";2413;49621;47208
472;"17.04.2007";7;"24.1";2518;57085;54567
472;"17.04.2007";8;"41.6";2350;62139;59789
472;"17.04.2007";9;"45.4";1935;64540;62605
472;"17.04.2007";10;"49.2";1658;64271;62613
472;"17.04.2007";11;62;1425;65114;63689
472;"17.04.2007";12;95;1436;66294;64858
472;"17.04.2007";13;"67.9";1600;65462;63862
472;"17.04.2007";14;"50.4";1872;64579;62707
472;"17.04.2007";15;"46.5";2364;63593;61229
472;"17.04.2007";16;"41.8";2924;62773;59849
472;"17.04.2007";17;"32.8";3658;61680;58022
472;"17.04.2007";18;"28.1";4402;61622;57220
472;"17.04.2007";19;28;4682;61947;57265
472;"17.04.2007";20;28;4569;61645;57076
472;"17.04.2007";21;"35.9";3786;62044;58258
472;"17.04.2007";22;"33.4";3563;60542;56979
472;"17.04.2007";23;"28.1";3867;55866;51999
472;"17.04.2007";24;"23.6";3875;50483;46608
473;"18.04.2007";1;"23.2";4236;47185;42949
473;"18.04.2007";2;22;4189;45065;40876
473;"18.04.2007";3;"18.3";4289;43910;39621
473;"18.04.2007";4;"17.1";4626;44500;39874
473;"18.04.2007";5;"13.1";4452;45786;41334
473;"18.04.2007";6;"23.7";4423;49898;45475
473;"18.04.2007";7;"25.1";4483;57195;52712
473;"18.04.2007";8;35;4567;62467;57900
473;"18.04.2007";9;35;4799;65028;60229
473;"18.04.2007";10;"38.1";6312;65500;59188
473;"18.04.2007";11;"40.1";7216;66770;59554
473;"18.04.2007";12;"41.1";7357;68154;60797
473;"18.04.2007";13;"40.1";7764;67381;59617
473;"18.04.2007";14;"40.1";7796;66760;58964
473;"18.04.2007";15;37;7757;65619;57862
473;"18.04.2007";16;"35.1";7505;64561;57056
473;"18.04.2007";17;32;7439;63295;55856
473;"18.04.2007";18;30;6845;62950;56105
473;"18.04.2007";19;"30.1";5807;62736;56929
473;"18.04.2007";20;"29.1";4228;61786;57558
473;"18.04.2007";21;"39.4";2960;61914;58954
473;"18.04.2007";22;"35.8";2551;61187;58636
473;"18.04.2007";23;"32.6";2329;57085;54756
473;"18.04.2007";24;"27.5";2410;51620;49210
474;"19.04.2007";1;26;2406;48154;45748
474;"19.04.2007";2;"22.1";2239;46195;43956
474;"19.04.2007";3;"21.4";2352;45363;43011
474;"19.04.2007";4;"19.9";2885;46013;43128
474;"19.04.2007";5;"19.9";3329;46992;43663
474;"19.04.2007";6;"23.3";3730;50765;47035
474;"19.04.2007";7;"28.5";4192;57703;53511
474;"19.04.2007";8;43;4300;62687;58387
474;"19.04.2007";9;46;3963;64602;60639
474;"19.04.2007";10;"45.4";4813;64496;59683
474;"19.04.2007";11;"45.1";6837;65599;58762
474;"19.04.2007";12;"45.3";9043;67495;58452
474;"19.04.2007";13;"35.6";10040;66851;56811
474;"19.04.2007";14;35;10707;66234;55527
474;"19.04.2007";15;"33.1";11482;65523;54041
474;"19.04.2007";16;31;11950;65111;53161
474;"19.04.2007";17;"26.1";12397;64067;51670
474;"19.04.2007";18;"24.9";12561;64220;51659
474;"19.04.2007";19;26;11986;64217;52231
474;"19.04.2007";20;"25.4";10561;63789;53228
474;"19.04.2007";21;32;9863;63941;54078
474;"19.04.2007";22;31;10016;62987;52971
474;"19.04.2007";23;"25.1";9881;59152;49271
474;"19.04.2007";24;"22.1";9442;53877;44435
475;"20.04.2007";1;"20.9";8562;49654;41092
475;"20.04.2007";2;"19.7";7822;47413;39591
475;"20.04.2007";3;"18.8";7250;46051;38801
475;"20.04.2007";4;"18.8";6899;46073;39174
475;"20.04.2007";5;"19.8";6425;47145;40720
475;"20.04.2007";6;"24.1";5678;50764;45086
475;"20.04.2007";7;"24.1";5169;57633;52464
475;"20.04.2007";8;33;4608;62963;58355
475;"20.04.2007";9;"43.9";5024;65487;60463
475;"20.04.2007";10;"45.9";5467;65909;60442
475;"20.04.2007";11;"46.8";5594;66748;61154
475;"20.04.2007";12;"57.5";5516;67619;62103
475;"20.04.2007";13;"44.4";5674;66367;60693
475;"20.04.2007";14;"38.1";6213;65055;58842
475;"20.04.2007";15;"30.1";6592;63634;57042
475;"20.04.2007";16;"28.6";6722;62373;55651
475;"20.04.2007";17;"27.5";6525;61261;54736
475;"20.04.2007";18;"27.1";6073;61067;54994
475;"20.04.2007";19;"27.6";5140;60901;55761
475;"20.04.2007";20;29;3958;59993;56035
475;"20.04.2007";21;"33.9";2821;59265;56444
475;"20.04.2007";22;"34.9";2414;58496;56082
475;"20.04.2007";23;"29.7";2167;55014;52847
475;"20.04.2007";24;"26.1";1931;50367;48436
476;"21.04.2007";1;"26.1";1814;46879;45065
476;"21.04.2007";2;"24.4";1629;44885;43256
476;"21.04.2007";3;23;1327;43748;42421
476;"21.04.2007";4;"22.7";1135;43559;42424
476;"21.04.2007";5;"20.4";992;44086;43094
476;"21.04.2007";6;"23.9";901;44540;43639
476;"21.04.2007";7;"26.1";797;45041;44244
476;"21.04.2007";8;"27.7";672;48155;47483
476;"21.04.2007";9;"30.1";375;51857;51482
476;"21.04.2007";10;"40.1";339;54305;53966
476;"21.04.2007";11;"40.7";412;55370;54958
476;"21.04.2007";12;46;419;55903;55484
476;"21.04.2007";13;"39.1";444;54189;53745
476;"21.04.2007";14;"33.9";465;51663;51198
476;"21.04.2007";15;"29.1";461;49445;48984
476;"21.04.2007";16;"29.1";467;48592;48125
476;"21.04.2007";17;"27.2";439;48165;47726
476;"21.04.2007";18;"26.2";395;49240;48845
476;"21.04.2007";19;"25.8";411;50498;50087
476;"21.04.2007";20;"24.4";467;50560;50093
476;"21.04.2007";21;"28.5";657;50507;49850
476;"21.04.2007";22;29;1161;50719;49558
476;"21.04.2007";23;27;1655;48901;47246
476;"21.04.2007";24;"23.4";1965;45042;43077
477;"22.04.2007";1;"23.1";2138;41246;39108
477;"22.04.2007";2;"21.1";2226;38822;36596
477;"22.04.2007";3;"19.9";2348;37971;35623
477;"22.04.2007";4;17;2450;37667;35217
477;"22.04.2007";5;"15.8";2477;38034;35557
477;"22.04.2007";6;"17.7";2641;38172;35531
477;"22.04.2007";7;"18.9";2627;37302;34675
477;"22.04.2007";8;"17.1";2449;39462;37013
477;"22.04.2007";9;"20.9";1614;42709;41095
477;"22.04.2007";10;"23.7";1087;45197;44110
477;"22.04.2007";11;"25.1";1259;47082;45823
477;"22.04.2007";12;"28.7";1513;49058;47545
477;"22.04.2007";13;"26.2";1485;47647;46162
477;"22.04.2007";14;"23.7";1442;45080;43638
477;"22.04.2007";15;"22.1";1447;43082;41635
477;"22.04.2007";16;"20.5";1357;41917;40560
477;"22.04.2007";17;"18.9";1248;41736;40488
477;"22.04.2007";18;"20.1";1180;43443;42263
477;"22.04.2007";19;23;1102;45733;44631
477;"22.04.2007";20;"24.8";1076;46857;45781
477;"22.04.2007";21;27;1400;48798;47398
477;"22.04.2007";22;30;2051;50543;48492
477;"22.04.2007";23;"27.9";2293;49067;46774
477;"22.04.2007";24;"22.7";2419;44956;42537
478;"23.04.2007";1;"23.6";2216;42073;39857
478;"23.04.2007";2;"20.1";2006;40412;38406
478;"23.04.2007";3;"18.9";1742;39495;37753
478;"23.04.2007";4;"17.9";1657;40095;38438
478;"23.04.2007";5;20;1655;41755;40100
478;"23.04.2007";6;"25.1";1666;46632;44966
478;"23.04.2007";7;"28.1";1843;54940;53097
478;"23.04.2007";8;"38.9";1825;61092;59267
478;"23.04.2007";9;"42.4";1359;63809;62450
478;"23.04.2007";10;"46.9";705;64039;63334
478;"23.04.2007";11;55;602;65017;64415
478;"23.04.2007";12;"70.7";814;66370;65556
478;"23.04.2007";13;"52.5";1259;65567;64308
478;"23.04.2007";14;"53.3";1840;65388;63548
478;"23.04.2007";15;"45.5";2189;64301;62112
478;"23.04.2007";16;"44.3";2299;63237;60938
478;"23.04.2007";17;"38.9";2265;61602;59337
478;"23.04.2007";18;"32.8";1921;61607;59686
478;"23.04.2007";19;"31.2";1397;61779;60382
478;"23.04.2007";20;"30.8";913;61669;60756
478;"23.04.2007";21;"39.9";776;61540;60764
478;"23.04.2007";22;"39.4";591;60469;59878
478;"23.04.2007";23;"29.2";490;55785;55295
478;"23.04.2007";24;"26.8";503;50279;49776
479;"24.04.2007";1;"23.1";538;46314;45776
479;"24.04.2007";2;"21.1";674;44386;43712
479;"24.04.2007";3;"21.3";719;43423;42704
479;"24.04.2007";4;21;897;43508;42611
479;"24.04.2007";5;"21.8";1038;44834;43796
479;"24.04.2007";6;"28.1";1027;49077;48050
479;"24.04.2007";7;"37.5";833;56534;55701
479;"24.04.2007";8;99;642;62529;61887
479;"24.04.2007";9;"95.1";494;64944;64450
479;"24.04.2007";10;"109.8";358;65349;64991
479;"24.04.2007";11;"129.1";328;66414;66086
479;"24.04.2007";12;300;368;67556;67188
479;"24.04.2007";13;"151.2";341;66742;66401
479;"24.04.2007";14;"110.1";353;66167;65814
479;"24.04.2007";15;"79.9";372;64877;64505
479;"24.04.2007";16;"49.8";343;63968;63625
479;"24.04.2007";17;"42.7";314;62364;62050
479;"24.04.2007";18;"45.3";358;62085;61727
479;"24.04.2007";19;"42.1";399;61985;61586
479;"24.04.2007";20;"38.1";485;61030;60545
479;"24.04.2007";21;"53.2";739;60751;60012
479;"24.04.2007";22;"46.8";1018;60519;59501
479;"24.04.2007";23;"38.8";1267;56172;54905
479;"24.04.2007";24;25;1638;50543;48905
480;"25.04.2007";1;"28.5";1772;46589;44817
480;"25.04.2007";2;"22.7";1922;44686;42764
480;"25.04.2007";3;"19.8";1809;43335;41526
480;"25.04.2007";4;"19.8";1935;43805;41870
480;"25.04.2007";5;"18.3";1931;45119;43188
480;"25.04.2007";6;"19.6";1832;48985;47153
480;"25.04.2007";7;"24.1";1891;56196;54305
480;"25.04.2007";8;"34.9";1861;62286;60425
480;"25.04.2007";9;"43.2";1437;64719;63282
480;"25.04.2007";10;"46.3";1009;64777;63768
480;"25.04.2007";11;49;1034;65625;64591
480;"25.04.2007";12;68;1282;66782;65500
480;"25.04.2007";13;"49.5";1528;65716;64188
480;"25.04.2007";14;"43.2";1603;65309;63706
480;"25.04.2007";15;42;1625;64385;62760
480;"25.04.2007";16;"40.6";1648;63317;61669
480;"25.04.2007";17;"34.6";1668;61878;60210
480;"25.04.2007";18;"34.2";1681;61850;60169
480;"25.04.2007";19;"33.8";1822;61872;60050
480;"25.04.2007";20;"33.1";2055;61251;59196
480;"25.04.2007";21;"36.1";2796;60694;57898
480;"25.04.2007";22;"35.1";3953;60732;56779
480;"25.04.2007";23;"28.1";4500;56663;52163
480;"25.04.2007";24;"22.1";4595;51110;46515
481;"26.04.2007";1;23;4283;47357;43074
481;"26.04.2007";2;20;3893;45259;41366
481;"26.04.2007";3;20;3607;44202;40595
481;"26.04.2007";4;"21.9";3338;44052;40714
481;"26.04.2007";5;"18.9";2978;45072;42094
481;"26.04.2007";6;"24.9";2739;48627;45888
481;"26.04.2007";7;"29.9";2386;55602;53216
481;"26.04.2007";8;"46.1";1891;61728;59837
481;"26.04.2007";9;"53.4";1056;64157;63101
481;"26.04.2007";10;"57.4";535;64273;63738
481;"26.04.2007";11;"64.8";509;65159;64650
481;"26.04.2007";12;80;737;66387;65650
481;"26.04.2007";13;"60.1";1200;65506;64306
481;"26.04.2007";14;"53.3";1296;64834;63538
481;"26.04.2007";15;"41.7";1341;63878;62537
481;"26.04.2007";16;"40.5";1453;62876;61423
481;"26.04.2007";17;40;1470;61578;60108
481;"26.04.2007";18;"35.1";1594;61569;59975
481;"26.04.2007";19;"33.8";1651;61566;59915
481;"26.04.2007";20;"30.8";1679;61218;59539
481;"26.04.2007";21;"35.3";2023;60687;58664
481;"26.04.2007";22;"36.2";2438;60583;58145
481;"26.04.2007";23;29;2426;56136;53710
481;"26.04.2007";24;25;2304;50739;48435
482;"27.04.2007";1;"25.1";1974;46715;44741
482;"27.04.2007";2;20;1680;44597;42917
482;"27.04.2007";3;17;1420;43546;42126
482;"27.04.2007";4;"15.1";1121;43588;42467
482;"27.04.2007";5;"19.9";921;44857;43936
482;"27.04.2007";6;25;885;48561;47676
482;"27.04.2007";7;"25.5";937;55669;54732
482;"27.04.2007";8;45;938;61457;60519
482;"27.04.2007";9;"60.1";689;64089;63400
482;"27.04.2007";10;62;417;64256;63839
482;"27.04.2007";11;70;512;64973;64461
482;"27.04.2007";12;90;830;65569;64739
482;"27.04.2007";13;"71.4";985;64838;63853
482;"27.04.2007";14;"49.7";929;63489;62560
482;"27.04.2007";15;"43.1";978;62553;61575
482;"27.04.2007";16;"36.3";983;61517;60534
482;"27.04.2007";17;"29.9";1027;60679;59652
482;"27.04.2007";18;"28.9";1175;60901;59726
482;"27.04.2007";19;29;1411;60653;59242
482;"27.04.2007";20;"26.1";1726;59622;57896
482;"27.04.2007";21;"31.1";2188;58691;56503
482;"27.04.2007";22;"31.1";2468;58484;56016
482;"27.04.2007";23;28;2587;54674;52087
482;"27.04.2007";24;"23.3";2497;49889;47392
483;"28.04.2007";1;"27.1";2219;46373;44154
483;"28.04.2007";2;"22.7";1799;44035;42236
483;"28.04.2007";3;"20.7";1440;42743;41303
483;"28.04.2007";4;18;1119;41794;40675
483;"28.04.2007";5;"17.1";1083;41994;40911
483;"28.04.2007";6;"18.1";1082;42890;41808
483;"28.04.2007";7;16;1049;44428;43379
483;"28.04.2007";8;"21.1";949;48420;47471
483;"28.04.2007";9;"27.3";537;52191;51654
483;"28.04.2007";10;"35.1";273;54425;54152
483;"28.04.2007";11;"42.9";273;55239;54966
483;"28.04.2007";12;"43.2";424;55696;55272
483;"28.04.2007";13;"36.6";592;54122;53530
483;"28.04.2007";14;"26.7";790;51910;51120
483;"28.04.2007";15;"25.1";1188;50224;49036
483;"28.04.2007";16;"23.1";1894;49591;47697
483;"28.04.2007";17;"22.9";2555;49403;46848
483;"28.04.2007";18;"23.1";3198;50478;47280
483;"28.04.2007";19;"24.1";3725;51431;47706
483;"28.04.2007";20;"23.7";4461;51321;46860
483;"28.04.2007";21;23;4763;50593;45830
483;"28.04.2007";22;"22.9";4650;51200;46550
483;"28.04.2007";23;"23.5";4792;49062;44270
483;"28.04.2007";24;"14.8";4772;45119;40347
484;"29.04.2007";1;15;4763;41663;36900
484;"29.04.2007";2;10;4953;39554;34601
484;"29.04.2007";3;"5.4";5036;38199;33163
484;"29.04.2007";4;"4.1";4983;37610;32627
484;"29.04.2007";5;"4.1";4633;37308;32675
484;"29.04.2007";6;5;4469;37250;32781
484;"29.04.2007";7;"2.1";4563;37306;32743
484;"29.04.2007";8;"1.2";4514;39948;35434
484;"29.04.2007";9;"16.4";4891;43005;38114
484;"29.04.2007";10;21;4643;45367;40724
484;"29.04.2007";11;"22.2";4790;46788;41998
484;"29.04.2007";12;24;5376;48695;43319
484;"29.04.2007";13;24;5436;47493;42057
484;"29.04.2007";14;20;4886;44948;40062
484;"29.04.2007";15;18;4587;43233;38646
484;"29.04.2007";16;"16.5";4314;42313;37999
484;"29.04.2007";17;"14.9";4360;42369;38009
484;"29.04.2007";18;"14.9";4641;43834;39193
484;"29.04.2007";19;"21.9";5066;46041;40975
484;"29.04.2007";20;"22.9";5106;46760;41654
484;"29.04.2007";21;"22.2";4911;47475;42564
484;"29.04.2007";22;"23.4";5154;49166;44012
484;"29.04.2007";23;"22.7";4909;47722;42813
484;"29.04.2007";24;"18.2";4530;43882;39352
485;"30.04.2007";1;"13.6";3877;40518;36641
485;"30.04.2007";2;"11.1";3380;39041;35661
485;"30.04.2007";3;"6.9";3263;38402;35139
485;"30.04.2007";4;"6.5";2964;38574;35610
485;"30.04.2007";5;"5.1";2719;39874;37155
485;"30.04.2007";6;"16.9";2774;42499;39725
485;"30.04.2007";7;"20.1";2817;47455;44638
485;"30.04.2007";8;24;2334;53029;50695
485;"30.04.2007";9;"25.9";1538;56677;55139
485;"30.04.2007";10;"32.7";1757;57735;55978
485;"30.04.2007";11;"35.6";2230;58375;56145
485;"30.04.2007";12;"43.7";2347;59811;57464
485;"30.04.2007";13;"38.6";2665;59170;56505
485;"30.04.2007";14;"34.7";3104;58094;54990
485;"30.04.2007";15;"29.7";3436;56762;53326
485;"30.04.2007";16;"26.7";3610;55724;52114
485;"30.04.2007";17;"24.9";3766;54891;51125
485;"30.04.2007";18;"24.9";4035;55092;51057
485;"30.04.2007";19;"25.5";4060;55202;51142
485;"30.04.2007";20;25;3782;54173;50391
485;"30.04.2007";21;"25.5";3625;52564;48939
485;"30.04.2007";22;"24.1";4026;52511;48485
485;"30.04.2007";23;"23.6";4443;49631;45188
485;"30.04.2007";24;"19.7";4272;45203;40931
486;"01.05.2007";1;"26.3";3687;41211;37524
486;"01.05.2007";2;"24.9";3333;39075;35742
486;"01.05.2007";3;"25.2";3087;37861;34774
486;"01.05.2007";4;24;2858;37391;34533
486;"01.05.2007";5;20;2953;37400;34447
486;"01.05.2007";6;24;2810;36662;33852
486;"01.05.2007";7;"8.1";2536;35415;32879
486;"01.05.2007";8;"8.1";1943;37404;35461
486;"01.05.2007";9;"18.6";1247;40158;38911
486;"01.05.2007";10;"22.7";1145;42333;41188
486;"01.05.2007";11;"22.7";1614;43598;41984
486;"01.05.2007";12;"24.2";2333;45125;42792
486;"01.05.2007";13;"22.4";2642;44008;41366
486;"01.05.2007";14;"17.7";2631;41923;39292
486;"01.05.2007";15;"17.2";2462;40322;37860
486;"01.05.2007";16;"19.9";2238;39616;37378
486;"01.05.2007";17;20;2146;39774;37628
486;"01.05.2007";18;"19.7";2254;41520;39266
486;"01.05.2007";19;16;2285;43629;41344
486;"01.05.2007";20;18;2131;44428;42297
486;"01.05.2007";21;18;2187;45107;42920
486;"01.05.2007";22;"22.4";2499;46832;44333
486;"01.05.2007";23;"22.7";2632;45098;42466
486;"01.05.2007";24;20;2541;41181;38640
487;"02.05.2007";1;"18.7";2250;37939;35689
487;"02.05.2007";2;16;2251;36455;34204
487;"02.05.2007";3;16;2164;35998;33834
487;"02.05.2007";4;"17.1";2052;36273;34221
487;"02.05.2007";5;12;1902;38255;36353
487;"02.05.2007";6;"21.9";1872;42995;41123
487;"02.05.2007";7;"26.2";1741;52297;50556
487;"02.05.2007";8;"38.3";1407;59263;57856
487;"02.05.2007";9;"49.7";920;62106;61186
487;"02.05.2007";10;"51.7";875;62541;61666
487;"02.05.2007";11;"58.1";1135;63574;62439
487;"02.05.2007";12;"69.9";1521;64763;63242
487;"02.05.2007";13;55;1876;64230;62354
487;"02.05.2007";14;"55.1";1869;63514;61645
487;"02.05.2007";15;"52.7";1925;62578;60653
487;"02.05.2007";16;"45.5";1783;61625;59842
487;"02.05.2007";17;37;1697;60318;58621
487;"02.05.2007";18;"35.1";1711;60248;58537
487;"02.05.2007";19;"34.9";1745;60567;58822
487;"02.05.2007";20;"33.1";1748;60407;58659
487;"02.05.2007";21;"41.2";1611;59153;57542
487;"02.05.2007";22;"38.4";1855;59381;57526
487;"02.05.2007";23;"31.9";1802;54803;53001
487;"02.05.2007";24;25;1661;49409;47748
488;"03.05.2007";1;"27.3";1515;45751;44236
488;"03.05.2007";2;"24.2";1338;43891;42553
488;"03.05.2007";3;"22.9";1072;43008;41936
488;"03.05.2007";4;"22.9";962;43296;42334
488;"03.05.2007";5;"22.1";974;44725;43751
488;"03.05.2007";6;"28.5";1020;48029;47009
488;"03.05.2007";7;35;1036;55333;54297
488;"03.05.2007";8;"43.4";997;61475;60478
488;"03.05.2007";9;"47.3";599;64112;63513
488;"03.05.2007";10;"49.6";514;64084;63570
488;"03.05.2007";11;"55.5";719;64906;64187
488;"03.05.2007";12;70;1058;66110;65052
488;"03.05.2007";13;"51.9";1343;65141;63798
488;"03.05.2007";14;"48.9";1514;64646;63132
488;"03.05.2007";15;"46.1";1729;63937;62208
488;"03.05.2007";16;"42.4";1946;62845;60899
488;"03.05.2007";17;"36.3";2180;61694;59514
488;"03.05.2007";18;34;2495;61721;59226
488;"03.05.2007";19;"33.1";2600;61784;59184
488;"03.05.2007";20;"31.2";2545;61280;58735
488;"03.05.2007";21;"31.9";2555;60045;57490
488;"03.05.2007";22;"32.8";3280;59975;56695
488;"03.05.2007";23;"30.8";3685;55972;52287
488;"03.05.2007";24;25;3710;50178;46468
489;"04.05.2007";1;24;3246;46171;42925
489;"04.05.2007";2;"21.1";2925;44259;41334
489;"04.05.2007";3;"20.5";2520;42964;40444
489;"04.05.2007";4;"20.1";2271;43195;40924
489;"04.05.2007";5;"19.6";2147;44677;42530
489;"04.05.2007";6;"22.9";2003;47958;45955
489;"04.05.2007";7;27;1939;55688;53749
489;"04.05.2007";8;"46.9";1393;61546;60153
489;"04.05.2007";9;47;640;64163;63523
489;"04.05.2007";10;"53.3";447;64311;63864
489;"04.05.2007";11;"59.9";782;65098;64316
489;"04.05.2007";12;"60.1";1395;66350;64955
489;"04.05.2007";13;"49.8";1891;65522;63631
489;"04.05.2007";14;"40.6";1916;63959;62043
489;"04.05.2007";15;"36.4";2058;62627;60569
489;"04.05.2007";16;32;2267;61537;59270
489;"04.05.2007";17;"30.7";2713;60605;57892
489;"04.05.2007";18;"31.3";3332;60653;57321
489;"04.05.2007";19;"30.3";3932;60690;56758
489;"04.05.2007";20;"26.1";4067;60186;56119
489;"04.05.2007";21;"29.5";3945;58265;54320
489;"04.05.2007";22;"29.1";4532;58244;53712
489;"04.05.2007";23;30;4702;54956;50254
489;"04.05.2007";24;"25.1";4555;50233;45678
490;"05.05.2007";1;25;4143;45898;41755
490;"05.05.2007";2;25;3677;43856;40179
490;"05.05.2007";3;"24.5";3193;42181;38988
490;"05.05.2007";4;"23.9";2933;41792;38859
490;"05.05.2007";5;"22.7";2909;42112;39203
490;"05.05.2007";6;"26.9";2697;42163;39466
490;"05.05.2007";7;"25.3";2576;43462;40886
490;"05.05.2007";8;"26.9";2001;47912;45911
490;"05.05.2007";9;"35.2";1198;51764;50566
490;"05.05.2007";10;"40.1";1048;54417;53369
490;"05.05.2007";11;"40.1";1311;55831;54520
490;"05.05.2007";12;"40.1";2104;56421;54317
490;"05.05.2007";13;"36.3";2579;54893;52314
490;"05.05.2007";14;32;2858;52465;49607
490;"05.05.2007";15;"27.4";3026;50609;47583
490;"05.05.2007";16;"24.1";2940;49777;46837
490;"05.05.2007";17;"22.9";3082;49454;46372
490;"05.05.2007";18;23;3164;50526;47362
490;"05.05.2007";19;"23.1";3132;51253;48121
490;"05.05.2007";20;"23.8";2846;50665;47819
490;"05.05.2007";21;"24.2";2682;49225;46543
490;"05.05.2007";22;"28.5";3022;49716;46694
490;"05.05.2007";23;"28.6";3247;48170;44923
490;"05.05.2007";24;24;2915;44108;41193
491;"06.05.2007";1;23;2537;40531;37994
491;"06.05.2007";2;"20.3";2141;38132;35991
491;"06.05.2007";3;"18.5";1866;37031;35165
491;"06.05.2007";4;16;1609;36529;34920
491;"06.05.2007";5;14;1485;36601;35116
491;"06.05.2007";6;17;1316;36473;35157
491;"06.05.2007";7;"12.1";1066;35935;34869
491;"06.05.2007";8;"17.7";670;38240;37570
491;"06.05.2007";9;"21.1";394;41756;41362
491;"06.05.2007";10;23;410;44450;44040
491;"06.05.2007";11;"25.3";502;46607;46105
491;"06.05.2007";12;"30.1";726;49042;48316
491;"06.05.2007";13;"29.9";873;47779;46906
491;"06.05.2007";14;23;1109;45300;44191
491;"06.05.2007";15;22;1290;43529;42239
491;"06.05.2007";16;"21.1";1519;42510;40991
491;"06.05.2007";17;"20.4";1797;42437;40640
491;"06.05.2007";18;"21.7";2013;44053;42040
491;"06.05.2007";19;"22.9";2090;46421;44331
491;"06.05.2007";20;"23.2";2038;47207;45169
491;"06.05.2007";21;"26.9";2075;47583;45508
491;"06.05.2007";22;31;2254;49464;47210
491;"06.05.2007";23;"29.4";2789;48565;45776
491;"06.05.2007";24;"23.1";3034;44867;41833
492;"07.05.2007";1;"21.5";3107;41361;38254
492;"07.05.2007";2;"16.7";3079;39665;36586
492;"07.05.2007";3;"15.7";3191;38880;35689
492;"07.05.2007";4;"15.3";3365;39406;36041
492;"07.05.2007";5;"13.6";3455;41143;37688
492;"07.05.2007";6;"21.9";3208;45388;42180
492;"07.05.2007";7;25;3178;54607;51429
492;"07.05.2007";8;"42.4";3089;60859;57770
492;"07.05.2007";9;"40.5";3251;64477;61226
492;"07.05.2007";10;"44.4";3584;64945;61361
492;"07.05.2007";11;"48.4";4266;66456;62190
492;"07.05.2007";12;"59.6";4686;68483;63797
492;"07.05.2007";13;48;4941;67855;62914
492;"07.05.2007";14;"46.5";4808;67175;62367
492;"07.05.2007";15;40;5007;66359;61352
492;"07.05.2007";16;36;5512;65643;60131
492;"07.05.2007";17;"33.1";5408;64162;58754
492;"07.05.2007";18;"30.2";5515;64158;58643
492;"07.05.2007";19;"29.9";5653;64135;58482
492;"07.05.2007";20;"27.5";5959;63246;57287
492;"07.05.2007";21;"30.2";6119;61844;55725
492;"07.05.2007";22;"29.4";6472;60626;54154
492;"07.05.2007";23;"26.2";6364;56333;49969
492;"07.05.2007";24;"22.1";6141;50788;44647
493;"08.05.2007";1;22;5343;47307;41964
493;"08.05.2007";2;20;5206;45121;39915
493;"08.05.2007";3;17;5150;44213;39063
493;"08.05.2007";4;"15.4";5318;44365;39047
493;"08.05.2007";5;14;5645;45801;40156
493;"08.05.2007";6;"16.1";6061;48950;42889
493;"08.05.2007";7;"22.7";5938;55960;50022
493;"08.05.2007";8;24;6494;61865;55371
493;"08.05.2007";9;"29.3";7852;65196;57344
493;"08.05.2007";10;"31.1";9290;66091;56801
493;"08.05.2007";11;"38.4";10780;67874;57094
493;"08.05.2007";12;"45.7";11017;69211;58194
493;"08.05.2007";13;"38.5";11882;68651;56769
493;"08.05.2007";14;"35.6";12413;68438;56025
493;"08.05.2007";15;"30.3";12774;67745;54971
493;"08.05.2007";16;35;12564;66695;54131
493;"08.05.2007";17;"26.8";11437;65037;53600
493;"08.05.2007";18;"26.8";9949;64307;54358
493;"08.05.2007";19;"36.2";9314;64181;54867
493;"08.05.2007";20;"37.9";7734;62886;55152
493;"08.05.2007";21;"34.9";7414;60910;53496
493;"08.05.2007";22;"33.8";8070;60277;52207
493;"08.05.2007";23;28;7997;56538;48541
493;"08.05.2007";24;22;9188;51947;42759
494;"09.05.2007";1;"19.1";9925;48273;38348
494;"09.05.2007";2;"14.1";9909;46620;36711
494;"09.05.2007";3;"12.9";10215;45852;35637
494;"09.05.2007";4;15;9946;46064;36118
494;"09.05.2007";5;"5.1";9313;47396;38083
494;"09.05.2007";6;"22.5";8757;50116;41359
494;"09.05.2007";7;"26.1";8581;57349;48768
494;"09.05.2007";8;"40.4";8460;63809;55349
494;"09.05.2007";9;"39.2";8594;67240;58646
494;"09.05.2007";10;42;9434;68362;58928
494;"09.05.2007";11;"45.1";9983;70011;60028
494;"09.05.2007";12;"53.2";10230;71539;61309
494;"09.05.2007";13;55;10337;70494;60157
494;"09.05.2007";14;"49.1";9864;69475;59611
494;"09.05.2007";15;"43.1";9285;67963;58678
494;"09.05.2007";16;"43.1";8267;66429;58162
494;"09.05.2007";17;"40.3";7845;64931;57086
494;"09.05.2007";18;"37.4";6743;64078;57335
494;"09.05.2007";19;"35.1";5506;63513;58007
494;"09.05.2007";20;"32.9";4233;62309;58076
494;"09.05.2007";21;"35.1";3231;60452;57221
494;"09.05.2007";22;"38.9";2979;59539;56560
494;"09.05.2007";23;"32.9";2877;55694;52817
494;"09.05.2007";24;"25.1";2920;50529;47609
495;"10.05.2007";1;"24.9";3294;46853;43559
495;"10.05.2007";2;"22.5";3806;44627;40821
495;"10.05.2007";3;"19.7";4481;43473;38992
495;"10.05.2007";4;"11.1";5134;43979;38845
495;"10.05.2007";5;11;6014;45414;39400
495;"10.05.2007";6;19;6936;48826;41890
495;"10.05.2007";7;"20.6";8093;56402;48309
495;"10.05.2007";8;"33.1";8952;62776;53824
495;"10.05.2007";9;"38.1";10304;66273;55969
495;"10.05.2007";10;"39.1";11437;66561;55124
495;"10.05.2007";11;"41.6";12443;67799;55356
495;"10.05.2007";12;"41.1";13057;69482;56425
495;"10.05.2007";13;"40.1";13549;69063;55514
495;"10.05.2007";14;"39.1";14015;68360;54345
495;"10.05.2007";15;"37.5";14168;67540;53372
495;"10.05.2007";16;"35.1";13642;66262;52620
495;"10.05.2007";17;"33.1";12422;64619;52197
495;"10.05.2007";18;29;11321;64092;52771
495;"10.05.2007";19;34;8898;63075;54177
495;"10.05.2007";20;29;6827;61770;54943
495;"10.05.2007";21;32;4796;59763;54967
495;"10.05.2007";22;"33.1";4205;59776;55571
495;"10.05.2007";23;30;3828;56221;52393
495;"10.05.2007";24;23;3932;50536;46604
496;"11.05.2007";1;22;4005;46720;42715
496;"11.05.2007";2;"19.1";4085;44602;40517
496;"11.05.2007";3;"18.6";3943;43453;39510
496;"11.05.2007";4;"18.9";4397;43793;39396
496;"11.05.2007";5;"19.9";4835;45043;40208
496;"11.05.2007";6;"21.1";5312;48635;43323
496;"11.05.2007";7;"25.1";6276;56517;50241
496;"11.05.2007";8;"36.1";7077;62764;55687
496;"11.05.2007";9;"39.1";7864;65818;57954
496;"11.05.2007";10;"42.6";9077;66619;57542
496;"11.05.2007";11;"43.3";10762;68341;57579
496;"11.05.2007";12;"46.5";11385;69712;58327
496;"11.05.2007";13;"41.6";11735;68843;57108
496;"11.05.2007";14;"35.1";12956;67789;54833
496;"11.05.2007";15;"33.1";13770;66642;52872
496;"11.05.2007";16;"29.6";13992;65391;51399
496;"11.05.2007";17;"25.5";13784;64659;50875
496;"11.05.2007";18;"23.1";13318;65141;51823
496;"11.05.2007";19;25;11808;64221;52413
496;"11.05.2007";20;24;10093;62717;52624
496;"11.05.2007";21;"24.9";7667;59661;51994
496;"11.05.2007";22;"27.6";6085;58867;52782
496;"11.05.2007";23;"28.1";5292;56393;51101
496;"11.05.2007";24;24;4440;51454;47014
497;"12.05.2007";1;"26.4";3713;47165;43452
497;"12.05.2007";2;24;3408;44587;41179
497;"12.05.2007";3;"22.7";3143;42992;39849
497;"12.05.2007";4;"22.3";2948;42859;39911
497;"12.05.2007";5;"20.6";3223;43314;40091
497;"12.05.2007";6;"18.9";3739;43554;39815
497;"12.05.2007";7;"17.6";4025;45205;41180
497;"12.05.2007";8;20;3730;48500;44770
497;"12.05.2007";9;24;4087;52424;48337
497;"12.05.2007";10;"28.1";4553;55037;50484
497;"12.05.2007";11;30;5928;56938;51010
497;"12.05.2007";12;"29.4";6823;58005;51182
497;"12.05.2007";13;29;7647;56229;48582
497;"12.05.2007";14;26;8444;53753;45309
497;"12.05.2007";15;"23.4";8695;51792;43097
497;"12.05.2007";16;"22.8";8751;50976;42225
497;"12.05.2007";17;23;8229;50114;41885
497;"12.05.2007";18;"23.4";7461;50808;43347
497;"12.05.2007";19;"24.1";7119;51832;44713
497;"12.05.2007";20;"25.1";5704;51360;45656
497;"12.05.2007";21;23;4879;50457;45578
497;"12.05.2007";22;"22.8";4446;50674;46228
497;"12.05.2007";23;"25.6";4932;49550;44618
497;"12.05.2007";24;"22.2";4590;45789;41199
498;"13.05.2007";1;23;4561;42138;37577
498;"13.05.2007";2;"20.8";4758;39449;34691
498;"13.05.2007";3;"18.1";4639;38090;33451
498;"13.05.2007";4;"14.1";4302;37839;33537
498;"13.05.2007";5;12;4047;38206;34159
498;"13.05.2007";6;"12.6";3920;37605;33685
498;"13.05.2007";7;10;3607;37341;33734
498;"13.05.2007";8;14;2714;39370;36656
498;"13.05.2007";9;"20.3";1854;42437;40583
498;"13.05.2007";10;"22.1";1570;44961;43391
498;"13.05.2007";11;"25.1";1808;47017;45209
498;"13.05.2007";12;"28.9";2301;49535;47234
498;"13.05.2007";13;"28.1";2304;48520;46216
498;"13.05.2007";14;"24.6";2066;46255;44189
498;"13.05.2007";15;"23.1";2183;44792;42609
498;"13.05.2007";16;22;2059;43674;41615
498;"13.05.2007";17;21;2255;43265;41010
498;"13.05.2007";18;"22.2";2115;44498;42383
498;"13.05.2007";19;25;2303;46733;44430
498;"13.05.2007";20;"25.1";2693;47888;45195
498;"13.05.2007";21;"26.9";3471;48668;45197
498;"13.05.2007";22;"28.2";5037;50547;45510
498;"13.05.2007";23;"29.1";5892;50210;44318
498;"13.05.2007";24;"24.8";7185;46556;39371
499;"14.05.2007";1;23;7216;43347;36131
499;"14.05.2007";2;"21.7";6762;41286;34524
499;"14.05.2007";3;20;6523;40602;34079
499;"14.05.2007";4;"19.6";5929;40895;34966
499;"14.05.2007";5;"19.3";5227;42064;36837
499;"14.05.2007";6;"23.6";5983;46056;40073
499;"14.05.2007";7;29;6298;54967;48669
499;"14.05.2007";8;46;6170;61784;55614
499;"14.05.2007";9;"47.5";6798;65097;58299
499;"14.05.2007";10;"49.9";8449;66056;57607
499;"14.05.2007";11;"54.3";9418;67561;58143
499;"14.05.2007";12;75;10042;69038;58996
499;"14.05.2007";13;"55.1";9802;68494;58692
499;"14.05.2007";14;"54.1";9078;67503;58425
499;"14.05.2007";15;52;8513;66431;57918
499;"14.05.2007";16;"48.1";7830;65401;57571
499;"14.05.2007";17;"41.9";6900;64134;57234
499;"14.05.2007";18;"39.9";5039;63583;58544
499;"14.05.2007";19;40;3629;63444;59815
499;"14.05.2007";20;"38.4";3049;62763;59714
499;"14.05.2007";21;"39.7";2859;60944;58085
499;"14.05.2007";22;"37.9";2387;59705;57318
499;"14.05.2007";23;"33.1";2630;55658;53028
499;"14.05.2007";24;"25.6";3390;50418;47028
500;"15.05.2007";1;"22.8";3213;46499;43286
500;"15.05.2007";2;"21.1";2905;44522;41617
500;"15.05.2007";3;"19.9";2712;43668;40956
500;"15.05.2007";4;"15.1";2647;43838;41191
500;"15.05.2007";5;"13.6";2997;45372;42375
500;"15.05.2007";6;"21.6";3090;48624;45534
500;"15.05.2007";7;24;2996;56133;53137
500;"15.05.2007";8;"43.6";2773;62493;59720
500;"15.05.2007";9;"53.2";2663;65595;62932
500;"15.05.2007";10;60;2548;65967;63419
500;"15.05.2007";11;80;2144;67730;65586
500;"15.05.2007";12;"133.5";2052;68824;66772
500;"15.05.2007";13;95;1964;67967;66003
500;"15.05.2007";14;"63.3";2272;66981;64709
500;"15.05.2007";15;55;2636;65690;63054
500;"15.05.2007";16;"49.5";2738;64299;61561
500;"15.05.2007";17;"43.4";2917;62526;59609
500;"15.05.2007";18;"43.9";2679;62045;59366
500;"15.05.2007";19;"42.4";2259;61567;59308
500;"15.05.2007";20;"40.3";1536;60666;59130
500;"15.05.2007";21;45;1068;58746;57678
500;"15.05.2007";22;"43.5";941;58387;57446
500;"15.05.2007";23;"40.5";971;55764;54793
500;"15.05.2007";24;30;1282;50344;49062
501;"16.05.2007";1;"23.3";1436;46572;45136
501;"16.05.2007";2;20;1682;44697;43015
501;"16.05.2007";3;"19.1";1697;43513;41816
501;"16.05.2007";4;17;1688;43736;42048
501;"16.05.2007";5;"21.6";1950;45308;43358
501;"16.05.2007";6;"24.1";2225;48014;45789
501;"16.05.2007";7;"27.5";2340;55218;52878
501;"16.05.2007";8;"49.5";2051;61408;59357
501;"16.05.2007";9;"52.1";1851;64189;62338
501;"16.05.2007";10;55;2209;64363;62154
501;"16.05.2007";11;"64.6";2818;65309;62491
501;"16.05.2007";12;64;3591;66800;63209
501;"16.05.2007";13;"48.9";4370;66348;61978
501;"16.05.2007";14;"58.6";4613;65845;61232
501;"16.05.2007";15;"54.8";4885;65084;60199
501;"16.05.2007";16;"46.6";4957;64188;59231
501;"16.05.2007";17;"43.9";5632;62754;57122
501;"16.05.2007";18;"40.1";6111;62125;56014
501;"16.05.2007";19;"38.5";6385;61799;55414
501;"16.05.2007";20;"30.3";6521;60854;54333
501;"16.05.2007";21;"29.1";6503;58965;52462
501;"16.05.2007";22;29;6409;58452;52043
501;"16.05.2007";23;"27.1";6248;55501;49253
501;"16.05.2007";24;"22.1";5842;50228;44386
502;"17.05.2007";1;"22.6";5858;46586;40728
502;"17.05.2007";2;"20.4";5543;44255;38712
502;"17.05.2007";3;"18.1";5359;43239;37880
502;"17.05.2007";4;"18.9";5065;42920;37855
502;"17.05.2007";5;"14.1";4644;42601;37957
502;"17.05.2007";6;"11.9";4220;40699;36479
502;"17.05.2007";7;"1.7";3732;38982;35250
502;"17.05.2007";8;"12.1";3416;41286;37870
502;"17.05.2007";9;15;3324;44282;40958
502;"17.05.2007";10;"18.7";3826;47089;43263
502;"17.05.2007";11;"21.1";4163;49438;45275
502;"17.05.2007";12;"23.7";4261;51557;47296
502;"17.05.2007";13;26;4527;50921;46394
502;"17.05.2007";14;"22.1";4679;48489;43810
502;"17.05.2007";15;"21.1";4852;46767;41915
502;"17.05.2007";16;"19.2";5309;45923;40614
502;"17.05.2007";17;"19.1";5584;45321;39737
502;"17.05.2007";18;21;5535;46141;40606
502;"17.05.2007";19;"21.4";5285;47022;41737
502;"17.05.2007";20;"21.1";4571;47382;42811
502;"17.05.2007";21;"20.1";3410;46444;43034
502;"17.05.2007";22;"21.1";2782;47631;44849
502;"17.05.2007";23;"22.5";2804;48093;45289
502;"17.05.2007";24;"18.7";2874;44519;41645
503;"18.05.2007";1;19;2619;40911;38292
503;"18.05.2007";2;"17.1";2391;38952;36561
503;"18.05.2007";3;16;2301;38178;35877
503;"18.05.2007";4;"12.1";2233;38436;36203
503;"18.05.2007";5;11;2543;40056;37513
503;"18.05.2007";6;"16.8";2700;41947;39247
503;"18.05.2007";7;"20.1";2538;46285;43747
503;"18.05.2007";8;"24.1";1899;51559;49660
503;"18.05.2007";9;"29.6";1328;55342;54014
503;"18.05.2007";10;"33.2";1365;56713;55348
503;"18.05.2007";11;"35.9";1372;57372;56000
503;"18.05.2007";12;42;1531;58683;57152
503;"18.05.2007";13;"39.1";1812;58218;56406
503;"18.05.2007";14;"33.9";2331;56406;54075
503;"18.05.2007";15;30;2804;55003;52199
503;"18.05.2007";16;"28.1";3111;54200;51089
503;"18.05.2007";17;"27.2";3409;53380;49971
503;"18.05.2007";18;28;3595;53665;50070
503;"18.05.2007";19;"28.9";3544;54076;50532
503;"18.05.2007";20;"27.1";3125;53648;50523
503;"18.05.2007";21;"23.6";2615;51628;49013
503;"18.05.2007";22;"24.9";3183;52426;49243
503;"18.05.2007";23;"25.1";3970;51268;47298
503;"18.05.2007";24;"22.3";4897;47025;42128
504;"19.05.2007";1;"20.8";5222;43405;38183
504;"19.05.2007";2;"13.8";5366;41107;35741
504;"19.05.2007";3;11;5116;40010;34894
504;"19.05.2007";4;"9.4";4867;39761;34894
504;"19.05.2007";5;"10.9";4820;39993;35173
504;"19.05.2007";6;11;4561;40108;35547
504;"19.05.2007";7;"9.9";4072;41389;37317
504;"19.05.2007";8;20;3169;44728;41559
504;"19.05.2007";9;"24.1";2515;48407;45892
504;"19.05.2007";10;32;2665;51418;48753
504;"19.05.2007";11;"32.2";2939;52875;49936
504;"19.05.2007";12;40;3277;53860;50583
504;"19.05.2007";13;"33.3";3555;52813;49258
504;"19.05.2007";14;"25.2";3419;50444;47025
504;"19.05.2007";15;"27.5";3118;48553;45435
504;"19.05.2007";16;"25.7";2945;47599;44654
504;"19.05.2007";17;"23.1";2688;46710;44022
504;"19.05.2007";18;23;2280;47465;45185
504;"19.05.2007";19;"24.7";1833;48758;46925
504;"19.05.2007";20;"23.9";1422;48204;46782
504;"19.05.2007";21;"27.8";883;46654;45771
504;"19.05.2007";22;"32.2";637;47394;46757
504;"19.05.2007";23;"34.6";634;47228;46594
504;"19.05.2007";24;"22.7";711;43646;42935
505;"20.05.2007";1;"24.2";696;39831;39135
505;"20.05.2007";2;"22.8";736;37357;36621
505;"20.05.2007";3;"20.1";784;36151;35367
505;"20.05.2007";4;17;758;35659;34901
505;"20.05.2007";5;"14.7";779;35713;34934
505;"20.05.2007";6;15;803;35092;34289
505;"20.05.2007";7;"12.7";748;35272;34524
505;"20.05.2007";8;"17.8";624;37618;36994
505;"20.05.2007";9;"21.1";394;40985;40591
505;"20.05.2007";10;"24.1";285;43521;43236
505;"20.05.2007";11;"26.1";328;45673;45345
505;"20.05.2007";12;"30.2";456;48094;47638
505;"20.05.2007";13;"28.8";649;46980;46331
505;"20.05.2007";14;24;909;44675;43766
505;"20.05.2007";15;"23.2";1237;43020;41783
505;"20.05.2007";16;"22.6";1689;42242;40553
505;"20.05.2007";17;"22.4";1951;42196;40245
505;"20.05.2007";18;23;2236;43962;41726
505;"20.05.2007";19;"24.3";2379;46044;43665
505;"20.05.2007";20;"25.2";2454;46801;44347
505;"20.05.2007";21;"25.6";2796;46682;43886
505;"20.05.2007";22;"29.7";3190;48384;45194
505;"20.05.2007";23;"31.2";3221;48539;45318
505;"20.05.2007";24;25;3412;44984;41572
506;"21.05.2007";1;"22.7";3437;41975;38538
506;"21.05.2007";2;"20.8";3275;40270;36995
506;"21.05.2007";3;"18.1";3147;39360;36213
506;"21.05.2007";4;"15.8";2962;39542;36580
506;"21.05.2007";5;17;2441;40499;38058
506;"21.05.2007";6;"22.7";2344;44112;41768
506;"21.05.2007";7;"24.9";2152;53224;51072
506;"21.05.2007";8;"40.1";1520;60657;59137
506;"21.05.2007";9;"51.4";868;64068;63200
506;"21.05.2007";10;57;532;64922;64390
506;"21.05.2007";11;65;489;66011;65522
506;"21.05.2007";12;"96.8";577;67368;66791
506;"21.05.2007";13;82;817;66794;65977
506;"21.05.2007";14;68;881;66134;65253
506;"21.05.2007";15;"57.6";889;65013;64124
506;"21.05.2007";16;56;835;64256;63421
506;"21.05.2007";17;"44.8";764;62591;61827
506;"21.05.2007";18;"43.7";675;62252;61577
506;"21.05.2007";19;"44.2";608;61978;61370
506;"21.05.2007";20;42;670;61038;60368
506;"21.05.2007";21;"41.5";746;58993;58247
506;"21.05.2007";22;"39.2";836;58405;57569
506;"21.05.2007";23;"37.1";976;56113;55137
506;"21.05.2007";24;"27.2";1030;50604;49574
507;"22.05.2007";1;27;858;47090;46232
507;"22.05.2007";2;"22.5";757;44699;43942
507;"22.05.2007";3;"21.6";698;43356;42658
507;"22.05.2007";4;20;613;43350;42737
507;"22.05.2007";5;"21.6";540;44255;43715
507;"22.05.2007";6;"23.5";538;46992;46454
507;"22.05.2007";7;"33.1";582;54999;54417
507;"22.05.2007";8;"65.1";441;61920;61479
507;"22.05.2007";9;"83.1";275;64648;64373
507;"22.05.2007";10;110;303;65312;65009
507;"22.05.2007";11;103;405;66562;66157
507;"22.05.2007";12;"168.8";449;67919;67470
507;"22.05.2007";13;"94.4";510;67200;66690
507;"22.05.2007";14;110;784;66586;65802
507;"22.05.2007";15;83;1112;65531;64419
507;"22.05.2007";16;"72.1";1439;64555;63116
507;"22.05.2007";17;"52.5";1643;63078;61435
507;"22.05.2007";18;47;1775;63032;61257
507;"22.05.2007";19;45;1653;62593;60940
507;"22.05.2007";20;"40.1";1607;61409;59802
507;"22.05.2007";21;"45.6";1380;59484;58104
507;"22.05.2007";22;"41.6";1298;58308;57010
507;"22.05.2007";23;"35.7";1120;55406;54286
507;"22.05.2007";24;"25.7";1006;50328;49322
508;"23.05.2007";1;"26.1";874;46206;45332
508;"23.05.2007";2;"22.4";794;44143;43349
508;"23.05.2007";3;"19.1";815;42920;42105
508;"23.05.2007";4;19;834;42947;42113
508;"23.05.2007";5;"19.8";874;44014;43140
508;"23.05.2007";6;"23.8";804;47255;46451
508;"23.05.2007";7;"30.9";670;55078;54408
508;"23.05.2007";8;"53.2";446;61623;61177
508;"23.05.2007";9;"155.5";317;64363;64046
508;"23.05.2007";10;130;325;64744;64419
508;"23.05.2007";11;149;371;65462;65091
508;"23.05.2007";12;"200.1";481;67133;66652
508;"23.05.2007";13;103;449;66410;65961
508;"23.05.2007";14;110;462;65846;65384
508;"23.05.2007";15;"188.5";456;64520;64064
508;"23.05.2007";16;110;492;63497;63005
508;"23.05.2007";17;"102.9";681;62217;61536
508;"23.05.2007";18;79;620;61698;61078
508;"23.05.2007";19;"60.1";562;61482;60920
508;"23.05.2007";20;"48.3";596;60701;60105
508;"23.05.2007";21;41;686;58383;57697
508;"23.05.2007";22;"39.1";863;57660;56797
508;"23.05.2007";23;"35.5";1014;55731;54717
508;"23.05.2007";24;"25.9";1069;50286;49217
509;"24.05.2007";1;25;1044;46303;45259
509;"24.05.2007";2;"21.8";988;44251;43263
509;"24.05.2007";3;"19.8";928;43163;42235
509;"24.05.2007";4;"19.6";1045;43271;42226
509;"24.05.2007";5;"19.8";1087;44192;43105
509;"24.05.2007";6;"22.7";1095;46737;45642
509;"24.05.2007";7;"26.4";1057;54605;53548
509;"24.05.2007";8;50;758;61098;60340
509;"24.05.2007";9;"50.5";345;63940;63595
509;"24.05.2007";10;"53.1";273;64597;64324
509;"24.05.2007";11;60;321;65798;65477
509;"24.05.2007";12;"55.9";314;67264;66950
509;"24.05.2007";13;"57.7";279;66473;66194
509;"24.05.2007";14;"53.1";289;65753;65464
509;"24.05.2007";15;49;267;64983;64716
509;"24.05.2007";16;"51.2";300;63918;63618
509;"24.05.2007";17;46;347;62646;62299
509;"24.05.2007";18;"44.1";352;62322;61970
509;"24.05.2007";19;41;430;62111;61681
509;"24.05.2007";20;"37.4";539;61136;60597
509;"24.05.2007";21;"38.1";758;58860;58102
509;"24.05.2007";22;"32.8";1094;58132;57038
509;"24.05.2007";23;32;1364;56720;55356
509;"24.05.2007";24;"24.7";1732;51296;49564
510;"25.05.2007";1;"24.3";2010;47409;45399
510;"25.05.2007";2;"22.6";1932;45026;43094
510;"25.05.2007";3;"20.6";1843;43909;42066
510;"25.05.2007";4;17;1792;43856;42064
510;"25.05.2007";5;"14.5";1673;44600;42927
510;"25.05.2007";6;24;1610;47193;45583
510;"25.05.2007";7;"27.2";1522;55338;53816
510;"25.05.2007";8;"45.1";1275;61867;60592
510;"25.05.2007";9;"46.6";715;64801;64086
510;"25.05.2007";10;"51.1";563;65434;64871
510;"25.05.2007";11;"62.1";677;67064;66387
510;"25.05.2007";12;"81.2";857;67996;67139
510;"25.05.2007";13;"69.5";1215;67083;65868
510;"25.05.2007";14;"49.5";1621;65702;64081
510;"25.05.2007";15;45;1917;64274;62357
510;"25.05.2007";16;"41.5";1937;62871;60934
510;"25.05.2007";17;"38.6";2378;62001;59623
510;"25.05.2007";18;"35.9";2391;61778;59387
510;"25.05.2007";19;"34.2";2301;61255;58954
510;"25.05.2007";20;"32.5";2036;59960;57924
510;"25.05.2007";21;32;1733;57349;55616
510;"25.05.2007";22;"31.9";1160;56042;54882
510;"25.05.2007";23;"33.6";940;54571;53631
510;"25.05.2007";24;"24.8";1062;50016;48954
511;"26.05.2007";1;"28.1";1498;46275;44777
511;"26.05.2007";2;"23.7";1175;43840;42665
511;"26.05.2007";3;23;974;42292;41318
511;"26.05.2007";4;"21.5";1153;41453;40300
511;"26.05.2007";5;22;1193;41325;40132
511;"26.05.2007";6;"21.4";1016;41067;40051
511;"26.05.2007";7;"20.1";892;43295;42403
511;"26.05.2007";8;"20.8";812;47416;46604
511;"26.05.2007";9;"24.3";753;51465;50712
511;"26.05.2007";10;"29.9";714;53923;53209
511;"26.05.2007";11;33;688;55708;55020
511;"26.05.2007";12;"37.3";620;56493;55873
511;"26.05.2007";13;"35.9";587;54790;54203
511;"26.05.2007";14;"31.9";652;52302;51650
511;"26.05.2007";15;"28.4";960;50335;49375
511;"26.05.2007";16;"26.1";1258;49534;48276
511;"26.05.2007";17;"23.8";1363;49135;47772
511;"26.05.2007";18;"23.1";1844;50015;48171
511;"26.05.2007";19;"23.1";1826;50755;48929
511;"26.05.2007";20;"21.1";1547;49797;48250
511;"26.05.2007";21;"18.7";2142;48338;46196
511;"26.05.2007";22;"15.5";1721;47584;45863
511;"26.05.2007";23;"15.2";1637;46258;44621
511;"26.05.2007";24;"17.5";1725;42887;41162
512;"27.05.2007";1;21;1845;39805;37960
512;"27.05.2007";2;"18.7";1679;37364;35685
512;"27.05.2007";3;16;2424;36320;33896
512;"27.05.2007";4;14;1969;35480;33511
512;"27.05.2007";5;"12.1";2173;35162;32989
512;"27.05.2007";6;13;2265;34201;31936
512;"27.05.2007";7;"9.4";2590;34712;32122
512;"27.05.2007";8;14;2704;36846;34142
512;"27.05.2007";9;"15.3";2370;40033;37663
512;"27.05.2007";10;"19.2";2008;42478;40470
512;"27.05.2007";11;22;1932;44664;42732
512;"27.05.2007";12;"22.7";1982;47211;45229
512;"27.05.2007";13;"21.8";1881;46427;44546
512;"27.05.2007";14;"19.1";1705;44087;42382
512;"27.05.2007";15;"18.1";2076;42772;40696
512;"27.05.2007";16;"18.7";1930;41488;39558
512;"27.05.2007";17;"18.1";1893;41251;39358
512;"27.05.2007";18;"19.1";2045;42158;40113
512;"27.05.2007";19;"21.1";1993;43322;41329
512;"27.05.2007";20;22;1245;43375;42130
512;"27.05.2007";21;"22.5";1221;42628;41407
512;"27.05.2007";22;"23.5";1161;43151;41990
512;"27.05.2007";23;"26.4";1105;43067;41962
512;"27.05.2007";24;"22.1";938;40161;39223
513;"28.05.2007";1;"22.7";747;37004;36257
513;"28.05.2007";2;20;757;34976;34219
513;"28.05.2007";3;"18.7";778;34135;33357
513;"28.05.2007";4;"15.3";709;33943;33234
513;"28.05.2007";5;"12.7";593;34061;33468
513;"28.05.2007";6;"14.5";405;33651;33246
513;"28.05.2007";7;"12.6";402;34250;33848
513;"28.05.2007";8;"17.3";427;36612;36185
513;"28.05.2007";9;"20.1";477;39892;39415
513;"28.05.2007";10;"23.1";587;42938;42351
513;"28.05.2007";11;"26.8";705;45528;44823
513;"28.05.2007";12;"30.1";662;48809;48147
513;"28.05.2007";13;"29.3";608;48187;47579
513;"28.05.2007";14;25;728;45990;45262
513;"28.05.2007";15;"22.6";762;44668;43906
513;"28.05.2007";16;"21.7";973;43888;42915
513;"28.05.2007";17;"21.6";1095;43816;42721
513;"28.05.2007";18;"22.5";1117;45177;44060
513;"28.05.2007";19;24;1437;46775;45338
513;"28.05.2007";20;"25.1";1666;47101;45435
513;"28.05.2007";21;"24.1";1882;46339;44457
513;"28.05.2007";22;"26.1";1841;46621;44780
513;"28.05.2007";23;"31.8";1898;46829;44931
513;"28.05.2007";24;"22.7";1995;43297;41302
514;"29.05.2007";1;"20.4";1960;39773;37813
514;"29.05.2007";2;"15.8";2091;37976;35885
514;"29.05.2007";3;"13.6";2328;37139;34811
514;"29.05.2007";4;"10.1";2502;37534;35032
514;"29.05.2007";5;"12.1";2732;39039;36307
514;"29.05.2007";6;19;3119;42606;39487
514;"29.05.2007";7;"25.1";3307;51167;47860
514;"29.05.2007";8;"40.7";3451;58594;55143
514;"29.05.2007";9;47;3921;63001;59080
514;"29.05.2007";10;"53.3";4181;64906;60725
514;"29.05.2007";11;"62.5";4189;66801;62612
514;"29.05.2007";12;85;4386;68834;64448
514;"29.05.2007";13;"72.9";4960;67666;62706
514;"29.05.2007";14;"58.8";5576;67175;61599
514;"29.05.2007";15;"55.1";6320;66326;60006
514;"29.05.2007";16;"51.2";6963;65677;58714
514;"29.05.2007";17;"45.8";7720;64512;56792
514;"29.05.2007";18;42;8328;63836;55508
514;"29.05.2007";19;"41.9";8206;63004;54798
514;"29.05.2007";20;"37.5";7938;62013;54075
514;"29.05.2007";21;"33.1";7632;59612;51980
514;"29.05.2007";22;"30.7";7556;58276;50720
514;"29.05.2007";23;"31.3";7484;55909;48425
514;"29.05.2007";24;"23.9";7889;51164;43275
515;"30.05.2007";1;"15.1";8030;47596;39566
515;"30.05.2007";2;14;7890;45679;37789
515;"30.05.2007";3;"13.1";7712;44591;36879
515;"30.05.2007";4;"10.1";7348;45022;37675
515;"30.05.2007";5;9;6713;45966;39253
515;"30.05.2007";6;17;6054;48173;42119
515;"30.05.2007";7;"20.6";5107;54893;49786
515;"30.05.2007";8;"30.8";4467;60729;56262
515;"30.05.2007";9;"37.5";4048;63446;59398
515;"30.05.2007";10;"39.7";3794;63696;59902
515;"30.05.2007";11;"44.1";3332;64729;61397
515;"30.05.2007";12;54;2716;66051;63335
515;"30.05.2007";13;"48.7";2224;65141;62917
515;"30.05.2007";14;"53.1";1606;64092;62486
515;"30.05.2007";15;"51.5";1269;62928;61659
515;"30.05.2007";16;46;932;61752;60820
515;"30.05.2007";17;"44.6";750;60091;59341
515;"30.05.2007";18;"41.6";679;59833;59154
515;"30.05.2007";19;"38.3";646;59566;58920
515;"30.05.2007";20;"34.2";668;59096;58428
515;"30.05.2007";21;"34.1";714;57067;56353
515;"30.05.2007";22;31;883;56353;55470
515;"30.05.2007";23;"29.1";1331;54753;53422
515;"30.05.2007";24;"24.1";1766;49539;47773
516;"31.05.2007";1;"25.8";1967;45598;43631
516;"31.05.2007";2;22;1921;43451;41530
516;"31.05.2007";3;"20.5";1801;42410;40609
516;"31.05.2007";4;"19.9";1729;42640;40911
516;"31.05.2007";5;"21.1";1592;43827;42235
516;"31.05.2007";6;"22.6";1516;46514;44998
516;"31.05.2007";7;"28.2";1319;53805;52486
516;"31.05.2007";8;"42.4";817;60028;59211
516;"31.05.2007";9;"48.6";471;63024;62553
516;"31.05.2007";10;"54.7";424;63762;63338
516;"31.05.2007";11;"60.3";541;64855;64314
516;"31.05.2007";12;"74.9";637;66384;65747
516;"31.05.2007";13;"62.5";713;65331;64618
516;"31.05.2007";14;"55.8";764;64634;63870
516;"31.05.2007";15;56;751;63501;62750
516;"31.05.2007";16;"50.5";742;62528;61786
516;"31.05.2007";17;"41.1";833;61013;60180
516;"31.05.2007";18;"38.3";850;60567;59717
516;"31.05.2007";19;"36.4";799;60160;59361
516;"31.05.2007";20;"32.8";658;59305;58647
516;"31.05.2007";21;35;738;57037;56299
516;"31.05.2007";22;"35.1";1038;56239;55201
516;"31.05.2007";23;"33.1";1388;54577;53189
516;"31.05.2007";24;"25.5";1701;49611;47910
517;"01.06.2007";1;"26.8";1786;46251;44465
517;"01.06.2007";2;"22.3";1715;43994;42279
517;"01.06.2007";3;"21.5";1715;43002;41287
517;"01.06.2007";4;19;1684;43084;41400
517;"01.06.2007";5;"19.8";1468;44192;42724
517;"01.06.2007";6;24;1382;46595;45213
517;"01.06.2007";7;"35.2";1412;54293;52881
517;"01.06.2007";8;50;773;60438;59665
517;"01.06.2007";9;"53.1";387;63623;63236
517;"01.06.2007";10;"57.6";523;64319;63796
517;"01.06.2007";11;62;826;65449;64623
517;"01.06.2007";12;"70.1";1164;66898;65734
517;"01.06.2007";13;"55.9";1271;65791;64520
517;"01.06.2007";14;54;1411;64214;62803
517;"01.06.2007";15;"53.2";1586;62798;61212
517;"01.06.2007";16;"45.9";1940;61252;59312
517;"01.06.2007";17;"42.6";2226;60431;58205
517;"01.06.2007";18;"42.7";2170;60246;58076
517;"01.06.2007";19;"40.4";2393;59799;57406
517;"01.06.2007";20;"35.1";2356;58640;56284
517;"01.06.2007";21;32;2282;56419;54137
517;"01.06.2007";22;28;2518;55047;52529
517;"01.06.2007";23;"33.6";2693;53623;50930
517;"01.06.2007";24;"23.6";2908;49731;46823
518;"02.06.2007";1;"23.9";2711;45947;43236
518;"02.06.2007";2;"22.7";2287;43642;41355
518;"02.06.2007";3;"20.2";1781;42299;40518
518;"02.06.2007";4;"21.2";1455;41742;40287
518;"02.06.2007";5;"21.4";1403;41521;40118
518;"02.06.2007";6;"21.1";1356;41163;39807
518;"02.06.2007";7;24;1170;43595;42425
518;"02.06.2007";8;"28.7";847;47467;46620
518;"02.06.2007";9;"40.7";608;51515;50907
518;"02.06.2007";10;"56.1";672;54237;53565
518;"02.06.2007";11;"54.9";1027;55799;54772
518;"02.06.2007";12;50;1296;56845;55549
518;"02.06.2007";13;45;1487;55520;54033
518;"02.06.2007";14;35;1555;53042;51487
518;"02.06.2007";15;"31.9";1592;50824;49232
518;"02.06.2007";16;"26.5";1740;50078;48338
518;"02.06.2007";17;"25.6";1664;49457;47793
518;"02.06.2007";18;"25.8";1754;50177;48423
518;"02.06.2007";19;26;1819;50734;48915
518;"02.06.2007";20;"25.6";1856;49920;48064
518;"02.06.2007";21;"24.3";1862;47836;45974
518;"02.06.2007";22;"24.1";1787;47391;45604
518;"02.06.2007";23;"25.6";1660;46950;45290
518;"02.06.2007";24;"20.1";1469;43468;41999
519;"03.06.2007";1;"16.7";1382;40111;38729
519;"03.06.2007";2;"14.6";1298;37899;36601
519;"03.06.2007";3;"13.1";1141;36743;35602
519;"03.06.2007";4;"10.5";1086;36074;34988
519;"03.06.2007";5;"9.8";1008;36099;35091
519;"03.06.2007";6;"9.9";930;35348;34418
519;"03.06.2007";7;"8.1";831;35992;35161
519;"03.06.2007";8;13;786;38142;37356
519;"03.06.2007";9;16;999;41355;40356
519;"03.06.2007";10;22;1038;44422;43384
519;"03.06.2007";11;"22.1";1160;46679;45519
519;"03.06.2007";12;"24.2";1258;49125;47867
519;"03.06.2007";13;"22.6";1314;48075;46761
519;"03.06.2007";14;22;1440;45762;44322
519;"03.06.2007";15;"20.1";1535;43999;42464
519;"03.06.2007";16;"19.2";1473;43159;41686
519;"03.06.2007";17;20;1566;42982;41416
519;"03.06.2007";18;21;1646;44384;42738
519;"03.06.2007";19;"22.6";1628;46179;44551
519;"03.06.2007";20;23;1539;46471;44932
519;"03.06.2007";21;"22.7";1299;46290;44991
519;"03.06.2007";22;24;1093;47183;46090
519;"03.06.2007";23;"24.5";1040;48534;47494
519;"03.06.2007";24;"20.3";1035;44827;43792
520;"04.06.2007";1;"21.9";903;41581;40678
520;"04.06.2007";2;"19.8";804;39834;39030
520;"04.06.2007";3;"17.3";746;38985;38239
520;"04.06.2007";4;"13.6";734;39520;38786
520;"04.06.2007";5;"17.2";668;40872;40204
520;"04.06.2007";6;"20.8";610;43651;43041
520;"04.06.2007";7;"26.2";582;53168;52586
520;"04.06.2007";8;"35.6";555;60184;59629
520;"04.06.2007";9;47;491;63795;63304
520;"04.06.2007";10;"52.9";428;64721;64293
520;"04.06.2007";11;"55.2";455;65889;65434
520;"04.06.2007";12;"71.2";521;67573;67052
520;"04.06.2007";13;"58.1";602;66448;65846
520;"04.06.2007";14;"57.5";666;65733;65067
520;"04.06.2007";15;"55.1";712;64839;64127
520;"04.06.2007";16;52;794;63692;62898
520;"04.06.2007";17;43;929;62219;61290
520;"04.06.2007";18;"40.5";1199;61930;60731
520;"04.06.2007";19;"39.4";1189;61360;60171
520;"04.06.2007";20;36;1179;60005;58826
520;"04.06.2007";21;"32.8";1064;57654;56590
520;"04.06.2007";22;"32.7";1207;56172;54965
520;"04.06.2007";23;33;1270;54991;53721
520;"04.06.2007";24;"24.3";1190;49437;48247
521;"05.06.2007";1;"31.9";1035;45945;44910
521;"05.06.2007";2;"23.8";862;43737;42875
521;"05.06.2007";3;"21.4";688;42528;41840
521;"05.06.2007";4;"21.3";709;42538;41829
521;"05.06.2007";5;"22.9";606;43712;43106
521;"05.06.2007";6;"25.7";602;46321;45719
521;"05.06.2007";7;"35.3";498;54117;53619
521;"05.06.2007";8;"53.2";413;60708;60295
521;"05.06.2007";9;60;382;63799;63417
521;"05.06.2007";10;"63.1";394;64328;63934
521;"05.06.2007";11;"64.6";400;65815;65415
521;"05.06.2007";12;"80.1";552;67681;67129
521;"05.06.2007";13;"57.2";673;66633;65960
521;"05.06.2007";14;"57.6";662;66106;65444
521;"05.06.2007";15;"55.1";768;65040;64272
521;"05.06.2007";16;50;828;63931;63103
521;"05.06.2007";17;"45.9";887;62532;61645
521;"05.06.2007";18;"45.3";963;61909;60946
521;"05.06.2007";19;"42.4";1003;61430;60427
521;"05.06.2007";20;"37.8";1029;60205;59176
521;"05.06.2007";21;"40.1";942;57715;56773
521;"05.06.2007";22;"40.3";1058;56382;55324
521;"05.06.2007";23;"35.2";1215;55113;53898
521;"05.06.2007";24;"24.9";1186;49931;48745
522;"06.06.2007";1;32;1062;46227;45165
522;"06.06.2007";2;"23.6";868;44101;43233
522;"06.06.2007";3;21;696;42950;42254
522;"06.06.2007";4;"20.8";640;42888;42248
522;"06.06.2007";5;"20.5";567;43746;43179
522;"06.06.2007";6;"24.5";601;46303;45702
522;"06.06.2007";7;"35.3";557;54044;53487
522;"06.06.2007";8;"50.1";304;60758;60454
522;"06.06.2007";9;"56.6";269;64049;63780
522;"06.06.2007";10;"60.3";326;64771;64445
522;"06.06.2007";11;65;428;65758;65330
522;"06.06.2007";12;100;520;66825;66305
522;"06.06.2007";13;"61.9";635;66279;65644
522;"06.06.2007";14;"57.8";701;65702;65001
522;"06.06.2007";15;"54.4";726;64600;63874
522;"06.06.2007";16;"50.1";789;63644;62855
522;"06.06.2007";17;"46.1";901;62234;61333
522;"06.06.2007";18;"43.5";1010;61527;60517
522;"06.06.2007";19;"42.1";1168;60835;59667
522;"06.06.2007";20;"34.3";1344;59788;58444
522;"06.06.2007";21;"32.9";1591;57432;55841
522;"06.06.2007";22;"32.8";1998;55635;53637
522;"06.06.2007";23;"35.3";2446;54634;52188
522;"06.06.2007";24;"26.2";2410;50002;47592
523;"07.06.2007";1;28;2120;46188;44068
523;"07.06.2007";2;24;1756;43939;42183
523;"07.06.2007";3;"22.7";1536;42083;40547
523;"07.06.2007";4;22;1526;41932;40406
523;"07.06.2007";5;"20.4";1588;42113;40525
523;"07.06.2007";6;"20.7";1651;41338;39687
523;"07.06.2007";7;"19.2";1432;43462;42030
523;"07.06.2007";8;"21.1";911;47245;46334
523;"07.06.2007";9;"24.4";512;49824;49312
523;"07.06.2007";10;"32.7";505;51846;51341
523;"07.06.2007";11;"35.1";743;52957;52214
523;"07.06.2007";12;"44.7";1145;54761;53616
523;"07.06.2007";13;"37.3";1552;54263;52711
523;"07.06.2007";14;"32.9";1739;52892;51153
523;"07.06.2007";15;30;1712;51482;49770
523;"07.06.2007";16;28;1875;50667;48792
523;"07.06.2007";17;"29.1";2310;50117;47807
523;"07.06.2007";18;"31.9";2974;51357;48383
523;"07.06.2007";19;"35.2";2791;52348;49557
523;"07.06.2007";20;"33.2";2804;51952;49148
523;"07.06.2007";21;"23.4";2650;50532;47882
523;"07.06.2007";22;"22.5";2607;49785;47178
523;"07.06.2007";23;"24.9";2924;50539;47615
523;"07.06.2007";24;20;2929;46630;43701
524;"08.06.2007";1;"22.9";2575;42922;40347
524;"08.06.2007";2;20;2529;40907;38378
524;"08.06.2007";3;"17.1";2447;40045;37598
524;"08.06.2007";4;18;2363;40038;37675
524;"08.06.2007";5;"21.2";2227;40651;38424
524;"08.06.2007";6;"22.8";1957;42810;40853
524;"08.06.2007";7;"24.1";1619;50149;48530
524;"08.06.2007";8;"35.8";968;56444;55476
524;"08.06.2007";9;"44.1";510;60157;59647
524;"08.06.2007";10;54;440;61394;60954
524;"08.06.2007";11;57;651;62610;61959
524;"08.06.2007";12;"71.2";1204;63742;62538
524;"08.06.2007";13;"56.1";1746;62946;61200
524;"08.06.2007";14;"48.4";1873;61531;59658
524;"08.06.2007";15;"49.8";1797;60109;58312
524;"08.06.2007";16;46;1654;59077;57423
524;"08.06.2007";17;"40.9";1643;58554;56911
524;"08.06.2007";18;42;1827;58412;56585
524;"08.06.2007";19;37;2023;57953;55930
524;"08.06.2007";20;"33.9";1958;56977;55019
524;"08.06.2007";21;"28.5";2002;54488;52486
524;"08.06.2007";22;"26.6";2284;53377;51093
524;"08.06.2007";23;"34.9";2577;52679;50102
524;"08.06.2007";24;"24.9";2643;48866;46223
525;"09.06.2007";1;"25.9";2476;45435;42959
525;"09.06.2007";2;"22.1";2271;43140;40869
525;"09.06.2007";3;"19.2";2046;41830;39784
525;"09.06.2007";4;"17.1";1889;41085;39196
525;"09.06.2007";5;17;1807;40736;38929
525;"09.06.2007";6;"13.4";1780;40445;38665
525;"09.06.2007";7;"11.1";1507;43248;41741
525;"09.06.2007";8;"17.6";845;46909;46064
525;"09.06.2007";9;"23.1";566;50676;50110
525;"09.06.2007";10;"28.4";491;53462;52971
525;"09.06.2007";11;30;545;54786;54241
525;"09.06.2007";12;36;733;55920;55187
525;"09.06.2007";13;34;949;54685;53736
525;"09.06.2007";14;"28.7";1064;52668;51604
525;"09.06.2007";15;27;1169;51157;49988
525;"09.06.2007";16;"25.6";1545;50421;48876
525;"09.06.2007";17;"25.5";1937;49902;47965
525;"09.06.2007";18;26;2081;50556;48475
525;"09.06.2007";19;"25.9";2293;50846;48553
525;"09.06.2007";20;"23.3";2310;49908;47598
525;"09.06.2007";21;24;2231;47776;45545
525;"09.06.2007";22;"22.7";2185;46605;44420
525;"09.06.2007";23;26;2282;47283;45001
525;"09.06.2007";24;"22.6";1742;44511;42769
526;"10.06.2007";1;"20.1";1331;41164;39833
526;"10.06.2007";2;"15.1";1039;38853;37814
526;"10.06.2007";3;"14.2";939;37261;36322
526;"10.06.2007";4;"11.3";1109;36803;35694
526;"10.06.2007";5;"10.5";1081;36471;35390
526;"10.06.2007";6;"10.4";1071;35625;34554
526;"10.06.2007";7;"10.5";904;36519;35615
526;"10.06.2007";8;"14.1";491;38868;38377
526;"10.06.2007";9;"16.1";301;42200;41899
526;"10.06.2007";10;"20.1";236;44531;44295
526;"10.06.2007";11;"22.1";264;46499;46235
526;"10.06.2007";12;"25.9";342;48980;48638
526;"10.06.2007";13;"24.4";444;48080;47636
526;"10.06.2007";14;"22.7";583;46039;45456
526;"10.06.2007";15;"20.6";621;44542;43921
526;"10.06.2007";16;"19.7";620;44195;43575
526;"10.06.2007";17;"19.8";669;44127;43458
526;"10.06.2007";18;21;762;45416;44654
526;"10.06.2007";19;"22.8";1027;47293;46266
526;"10.06.2007";20;"23.9";1145;47786;46641
526;"10.06.2007";21;"22.8";1521;47500;45979
526;"10.06.2007";22;"24.1";1707;47797;46090
526;"10.06.2007";23;"27.1";1851;48720;46869
526;"10.06.2007";24;"22.6";1674;45364;43690
527;"11.06.2007";1;21;1455;42271;40816
527;"11.06.2007";2;"18.7";1193;40356;39163
527;"11.06.2007";3;"16.4";1068;39610;38542
527;"11.06.2007";4;"13.8";894;39919;39025
527;"11.06.2007";5;"16.1";736;40973;40237
527;"11.06.2007";6;20;611;44354;43743
527;"11.06.2007";7;"23.1";496;53753;53257
527;"11.06.2007";8;"39.5";295;60873;60578
527;"11.06.2007";9;"58.4";176;64832;64656
527;"11.06.2007";10;"63.1";204;65738;65534
527;"11.06.2007";11;75;197;67441;67244
527;"11.06.2007";12;100;218;68808;68590
527;"11.06.2007";13;"74.7";227;67887;67660
527;"11.06.2007";14;"67.6";248;67594;67346
527;"11.06.2007";15;"63.4";248;66635;66387
527;"11.06.2007";16;"57.6";403;65648;65245
527;"11.06.2007";17;"51.5";368;64005;63637
527;"11.06.2007";18;"49.7";437;63524;63087
527;"11.06.2007";19;"46.7";525;62920;62395
527;"11.06.2007";20;"42.8";554;61904;61350
527;"11.06.2007";21;"34.9";567;59323;58756
527;"11.06.2007";22;"32.8";670;57395;56725
527;"11.06.2007";23;31;629;56084;55455
527;"11.06.2007";24;"23.5";556;51022;50466
528;"12.06.2007";1;30;594;47150;46556
528;"12.06.2007";2;"22.8";792;45222;44430
528;"12.06.2007";3;"21.7";819;44118;43299
528;"12.06.2007";4;"20.7";887;44137;43250
528;"12.06.2007";5;"21.7";892;44992;44100
528;"12.06.2007";6;"22.6";848;47428;46580
528;"12.06.2007";7;35;746;55971;55225
528;"12.06.2007";8;"66.8";653;62708;62055
528;"12.06.2007";9;"119.9";497;65480;64983
528;"12.06.2007";10;120;573;66132;65559
528;"12.06.2007";11;"161.8";609;67368;66759
528;"12.06.2007";12;"387.1";734;68298;67564
528;"12.06.2007";13;"184.2";948;67762;66814
528;"12.06.2007";14;"250.2";1172;67376;66204
528;"12.06.2007";15;"140.1";1508;66323;64815
528;"12.06.2007";16;100;1992;65294;63302
528;"12.06.2007";17;"65.1";2253;64067;61814
528;"12.06.2007";18;56;2465;63672;61207
528;"12.06.2007";19;"49.7";2565;62902;60337
528;"12.06.2007";20;"38.7";2249;62074;59825
528;"12.06.2007";21;"36.3";2046;59661;57615
528;"12.06.2007";22;"36.2";1696;57729;56033
528;"12.06.2007";23;"35.1";1609;55663;54054
528;"12.06.2007";24;"28.1";1697;50861;49164
529;"13.06.2007";1;"25.2";1822;47317;45495
529;"13.06.2007";2;"22.8";1700;45489;43789
529;"13.06.2007";3;21;1669;43992;42323
529;"13.06.2007";4;"20.1";1532;44112;42580
529;"13.06.2007";5;"20.7";1423;44949;43526
529;"13.06.2007";6;"24.9";1186;47522;46336
529;"13.06.2007";7;29;1031;55615;54584
529;"13.06.2007";8;"45.2";926;62127;61201
529;"13.06.2007";9;"59.9";970;64931;63961
529;"13.06.2007";10;"82.2";1097;65935;64838
529;"13.06.2007";11;"86.1";1177;67188;66011
529;"13.06.2007";12;120;1103;68113;67010
529;"13.06.2007";13;70;1277;66981;65704
529;"13.06.2007";14;70;1497;66301;64804
529;"13.06.2007";15;"61.9";1677;65512;63835
529;"13.06.2007";16;57;1645;64129;62484
529;"13.06.2007";17;"56.2";1545;63238;61693
529;"13.06.2007";18;"55.2";1445;63096;61651
529;"13.06.2007";19;53;1153;62414;61261
529;"13.06.2007";20;"42.7";871;61772;60901
529;"13.06.2007";21;38;658;58898;58240
529;"13.06.2007";22;35;548;57256;56708
529;"13.06.2007";23;"31.9";533;55791;55258
529;"13.06.2007";24;"25.6";552;50971;50419
530;"14.06.2007";1;"26.5";626;46936;46310
530;"14.06.2007";2;"22.2";613;44906;44293
530;"14.06.2007";3;"21.1";546;43638;43092
530;"14.06.2007";4;"20.5";527;43531;43004
530;"14.06.2007";5;"20.7";485;44365;43880
530;"14.06.2007";6;"22.9";481;46845;46364
530;"14.06.2007";7;"29.8";439;55040;54601
530;"14.06.2007";8;46;346;61025;60679
530;"14.06.2007";9;"56.3";379;64009;63630
530;"14.06.2007";10;"58.1";340;64594;64254
530;"14.06.2007";11;80;378;66057;65679
530;"14.06.2007";12;"142.9";559;67672;67113
530;"14.06.2007";13;"75.1";642;67227;66585
530;"14.06.2007";14;"65.1";606;66624;66018
530;"14.06.2007";15;"58.1";726;65913;65187
530;"14.06.2007";16;"55.1";1064;65092;64028
530;"14.06.2007";17;49;1337;64168;62831
530;"14.06.2007";18;"43.4";1751;63765;62014
530;"14.06.2007";19;"41.1";1991;63271;61280
530;"14.06.2007";20;"35.1";2039;62422;60383
530;"14.06.2007";21;34;2203;60036;57833
530;"14.06.2007";22;"32.9";2372;58021;55649
530;"14.06.2007";23;"32.8";2731;55984;53253
530;"14.06.2007";24;"26.2";2856;51276;48420
531;"15.06.2007";1;"25.2";3052;47822;44770
531;"15.06.2007";2;22;3418;45676;42258
531;"15.06.2007";3;"18.2";3379;44537;41158
531;"15.06.2007";4;"13.1";3273;44679;41406
531;"15.06.2007";5;"12.4";3253;45452;42199
531;"15.06.2007";6;"20.7";3274;47705;44431
531;"15.06.2007";7;"22.9";2924;55505;52581
531;"15.06.2007";8;"43.9";2373;62004;59631
531;"15.06.2007";9;"47.4";2223;65356;63133
531;"15.06.2007";10;"47.4";2179;66440;64261
531;"15.06.2007";11;"54.1";2324;67744;65420
531;"15.06.2007";12;"64.6";2387;68700;66313
531;"15.06.2007";13;54;2279;68064;65785
531;"15.06.2007";14;"47.3";2179;66504;64325
531;"15.06.2007";15;"47.1";2076;64949;62873
531;"15.06.2007";16;"39.1";2311;63910;61599
531;"15.06.2007";17;"34.8";2285;63170;60885
531;"15.06.2007";18;"33.3";2341;63159;60818
531;"15.06.2007";19;"30.1";2315;62757;60442
531;"15.06.2007";20;"27.6";1989;61373;59384
531;"15.06.2007";21;"26.2";1972;58256;56284
531;"15.06.2007";22;"25.9";2121;56094;53973
531;"15.06.2007";23;"30.1";2444;54569;52125
531;"15.06.2007";24;"23.2";2813;50469;47656
532;"16.06.2007";1;30;3108;47344;44236
532;"16.06.2007";2;"23.6";3650;45234;41584
532;"16.06.2007";3;"22.7";3652;43819;40167
532;"16.06.2007";4;"26.5";3928;43444;39516
532;"16.06.2007";5;"23.6";4135;43063;38928
532;"16.06.2007";6;"22.7";3755;42780;39025
532;"16.06.2007";7;"23.2";3613;44788;41175
532;"16.06.2007";8;"27.1";3664;48696;45032
532;"16.06.2007";9;"30.1";3746;52489;48743
532;"16.06.2007";10;38;3988;55014;51026
532;"16.06.2007";11;"43.1";4379;56738;52359
532;"16.06.2007";12;"46.1";4452;57616;53164
532;"16.06.2007";13;"34.3";4443;55841;51398
532;"16.06.2007";14;"29.9";4465;53191;48726
532;"16.06.2007";15;"27.4";4679;51191;46512
532;"16.06.2007";16;"26.4";4778;50552;45774
532;"16.06.2007";17;"25.5";4440;50057;45617
532;"16.06.2007";18;"27.6";4124;50716;46592
532;"16.06.2007";19;"31.5";3347;50675;47328
532;"16.06.2007";20;32;2991;50078;47087
532;"16.06.2007";21;"30.9";2383;47763;45380
532;"16.06.2007";22;"31.4";2239;46570;44331
532;"16.06.2007";23;30;2398;47138;44740
532;"16.06.2007";24;"22.3";3006;44316;41310
533;"17.06.2007";1;"18.4";3117;41204;38087
533;"17.06.2007";2;"16.1";3307;38849;35542
533;"17.06.2007";3;"13.1";3474;37567;34093
533;"17.06.2007";4;"11.2";3565;37067;33502
533;"17.06.2007";5;7;3510;36590;33080
533;"17.06.2007";6;"5.9";3295;36046;32751
533;"17.06.2007";7;3;2966;36709;33743
533;"17.06.2007";8;"10.6";2532;39245;36713
533;"17.06.2007";9;"14.7";2745;42509;39764
533;"17.06.2007";10;"17.1";3529;45080;41551
533;"17.06.2007";11;20;4351;46952;42601
533;"17.06.2007";12;"22.5";5134;49537;44403
533;"17.06.2007";13;"20.1";5544;48504;42960
533;"17.06.2007";14;18;5454;46229;40775
533;"17.06.2007";15;18;5322;44814;39492
533;"17.06.2007";16;"17.3";4589;43865;39276
533;"17.06.2007";17;"19.9";3822;43731;39909
533;"17.06.2007";18;"21.9";2837;45050;42213
533;"17.06.2007";19;"24.6";1703;46761;45058
533;"17.06.2007";20;"26.2";977;47347;46370
533;"17.06.2007";21;"26.4";544;46915;46371
533;"17.06.2007";22;"26.6";480;47349;46869
533;"17.06.2007";23;"27.5";500;48659;48159
533;"17.06.2007";24;"24.7";525;45148;44623
534;"18.06.2007";1;"22.8";624;42061;41437
534;"18.06.2007";2;"19.2";763;40631;39868
534;"18.06.2007";3;"14.6";912;39708;38796
534;"18.06.2007";4;"13.9";1170;39993;38823
534;"18.06.2007";5;"17.7";1423;41312;39889
534;"18.06.2007";6;"22.2";1590;44608;43018
534;"18.06.2007";7;"26.6";1942;54016;52074
534;"18.06.2007";8;"41.2";1722;61168;59446
534;"18.06.2007";9;"59.5";1701;64539;62838
534;"18.06.2007";10;"70.2";1941;65203;63262
534;"18.06.2007";11;"93.1";2204;66620;64416
534;"18.06.2007";12;120;2619;68394;65775
534;"18.06.2007";13;"79.1";2849;67363;64514
534;"18.06.2007";14;80;3479;66905;63426
534;"18.06.2007";15;"66.1";3754;65906;62152
534;"18.06.2007";16;"63.8";3673;65317;61644
534;"18.06.2007";17;"55.9";3287;64207;60920
534;"18.06.2007";18;"50.2";3219;63665;60446
534;"18.06.2007";19;"47.3";2636;63196;60560
534;"18.06.2007";20;43;2037;62123;60086
534;"18.06.2007";21;"39.5";1796;59654;57858
534;"18.06.2007";22;"38.3";1297;57541;56244
534;"18.06.2007";23;"36.7";1161;56068;54907
534;"18.06.2007";24;"27.1";1321;50777;49456
535;"19.06.2007";1;"24.7";1100;47213;46113
535;"19.06.2007";2;"21.6";1206;45248;44042
535;"19.06.2007";3;"18.6";1118;44312;43194
535;"19.06.2007";4;"17.1";908;44133;43225
535;"19.06.2007";5;"18.5";896;44769;43873
535;"19.06.2007";6;"23.8";677;47136;46459
535;"19.06.2007";7;"29.4";615;55205;54590
535;"19.06.2007";8;"47.4";414;61831;61417
535;"19.06.2007";9;"55.6";166;64749;64583
535;"19.06.2007";10;60;145;65273;65128
535;"19.06.2007";11;74;168;66627;66459
535;"19.06.2007";12;"119.2";253;67972;67719
535;"19.06.2007";13;"74.8";263;67083;66820
535;"19.06.2007";14;73;264;66642;66378
535;"19.06.2007";15;66;280;65924;65644
535;"19.06.2007";16;"56.2";219;65134;64915
535;"19.06.2007";17;50;202;63643;63441
535;"19.06.2007";18;"46.5";213;63301;63088
535;"19.06.2007";19;43;228;62674;62446
535;"19.06.2007";20;40;365;61551;61186
535;"19.06.2007";21;"32.4";628;59136;58508
535;"19.06.2007";22;"31.9";1178;57210;56032
535;"19.06.2007";23;"27.6";2089;56484;54395
535;"19.06.2007";24;"23.6";2729;51730;49001
536;"20.06.2007";1;25;3144;47493;44349
536;"20.06.2007";2;"23.5";3452;45679;42227
536;"20.06.2007";3;"18.9";3461;44517;41056
536;"20.06.2007";4;"18.1";3366;44562;41196
536;"20.06.2007";5;"17.9";3162;45448;42286
536;"20.06.2007";6;"22.6";2749;47957;45208
536;"20.06.2007";7;"27.1";2203;56107;53904
536;"20.06.2007";8;"40.1";1385;62658;61273
536;"20.06.2007";9;"49.9";1045;66031;64986
536;"20.06.2007";10;"53.7";1122;66640;65518
536;"20.06.2007";11;"60.1";1374;67956;66582
536;"20.06.2007";12;"74.1";1657;69403;67746
536;"20.06.2007";13;67;2118;68788;66670
536;"20.06.2007";14;"59.8";2173;68135;65962
536;"20.06.2007";15;65;1970;67279;65309
536;"20.06.2007";16;"55.9";2244;66370;64126
536;"20.06.2007";17;"50.8";2212;65050;62838
536;"20.06.2007";18;"49.7";2339;64288;61949
536;"20.06.2007";19;"46.5";2377;63709;61332
536;"20.06.2007";20;"40.3";2093;62546;60453
536;"20.06.2007";21;"35.6";1538;59697;58159
536;"20.06.2007";22;"31.6";1498;58208;56710
536;"20.06.2007";23;"32.1";1265;56594;55329
536;"20.06.2007";24;27;927;51596;50669
537;"21.06.2007";1;"26.9";774;47467;46693
537;"21.06.2007";2;"20.9";764;45312;44548
537;"21.06.2007";3;"19.7";930;44235;43305
537;"21.06.2007";4;"19.7";827;44039;43212
537;"21.06.2007";5;"19.6";948;44955;44007
537;"21.06.2007";6;"23.6";897;47209;46312
537;"21.06.2007";7;"34.9";765;54944;54179
537;"21.06.2007";8;58;756;61564;60808
537;"21.06.2007";9;"110.1";703;65203;64500
537;"21.06.2007";10;108;910;66149;65239
537;"21.06.2007";11;110;1434;68030;66596
537;"21.06.2007";12;"250.1";1201;69910;68709
537;"21.06.2007";13;"105.2";1053;69559;68506
537;"21.06.2007";14;110;1049;68584;67535
537;"21.06.2007";15;175;1074;67074;66000
537;"21.06.2007";16;110;1142;65931;64789
537;"21.06.2007";17;66;1169;64499;63330
537;"21.06.2007";18;"52.1";1449;64074;62625
537;"21.06.2007";19;"43.1";1566;62848;61282
537;"21.06.2007";20;"39.6";1711;61536;59825
537;"21.06.2007";21;29;2115;59081;56966
537;"21.06.2007";22;"25.8";2329;56987;54658
537;"21.06.2007";23;"24.1";2279;55410;53131
537;"21.06.2007";24;22;2138;50734;48596
538;"22.06.2007";1;"20.2";2338;47171;44833
538;"22.06.2007";2;17;2422;45382;42960
538;"22.06.2007";3;"16.3";2572;44487;41915
538;"22.06.2007";4;"16.3";2629;44590;41961
538;"22.06.2007";5;"15.8";2475;45301;42826
538;"22.06.2007";6;"23.4";2297;47393;45096
538;"22.06.2007";7;"24.9";1811;54974;53163
538;"22.06.2007";8;37;1477;61030;59553
538;"22.06.2007";9;"45.5";1350;64345;62995
538;"22.06.2007";10;"52.9";1301;65551;64250
538;"22.06.2007";11;50;1368;67342;65974
538;"22.06.2007";12;66;1519;68422;66903
538;"22.06.2007";13;"51.6";1666;67436;65770
538;"22.06.2007";14;50;1900;65745;63845
538;"22.06.2007";15;"46.6";1990;63822;61832
538;"22.06.2007";16;"46.1";2133;62322;60189
538;"22.06.2007";17;"38.6";2003;61149;59146
538;"22.06.2007";18;"37.5";1881;61052;59171
538;"22.06.2007";19;"34.9";1941;60486;58545
538;"22.06.2007";20;"29.5";1830;59019;57189
538;"22.06.2007";21;"25.3";1520;56275;54755
538;"22.06.2007";22;"25.1";1422;54170;52748
538;"22.06.2007";23;"27.1";1952;53228;51276
538;"22.06.2007";24;"21.1";2361;49510;47149
539;"23.06.2007";1;"32.5";2678;46093;43415
539;"23.06.2007";2;33;2831;44041;41210
539;"23.06.2007";3;"30.5";2656;42182;39526
539;"23.06.2007";4;24;2501;41667;39166
539;"23.06.2007";5;"22.7";2467;41480;39013
539;"23.06.2007";6;"17.9";2268;41194;38926
539;"23.06.2007";7;"19.3";2096;43560;41464
539;"23.06.2007";8;"23.6";2044;47187;45143
539;"23.06.2007";9;29;2360;51350;48990
539;"23.06.2007";10;"36.4";2762;54199;51437
539;"23.06.2007";11;35;2889;55954;53065
539;"23.06.2007";12;"36.5";3328;56920;53592
539;"23.06.2007";13;"34.4";3427;55499;52072
539;"23.06.2007";14;"34.9";3756;53205;49449
539;"23.06.2007";15;29;4393;51234;46841
539;"23.06.2007";16;"27.6";4499;50199;45700
539;"23.06.2007";17;25;4365;49494;45129
539;"23.06.2007";18;24;3909;49703;45794
539;"23.06.2007";19;"24.1";3266;50034;46768
539;"23.06.2007";20;"23.6";2627;49410;46783
539;"23.06.2007";21;22;2093;47059;44966
539;"23.06.2007";22;21;2243;45872;43629
539;"23.06.2007";23;"25.4";2724;46528;43804
539;"23.06.2007";24;21;3177;44092;40915
540;"24.06.2007";1;19;3490;40886;37396
540;"24.06.2007";2;"13.5";3521;38556;35035
540;"24.06.2007";3;7;3288;37483;34195
540;"24.06.2007";4;"4.8";3088;36937;33849
540;"24.06.2007";5;"4.7";2936;36437;33501
540;"24.06.2007";6;"4.5";2715;35714;32999
540;"24.06.2007";7;"4.4";2384;36508;34124
540;"24.06.2007";8;"5.1";2202;38724;36522
540;"24.06.2007";9;13;2366;41749;39383
540;"24.06.2007";10;"15.7";2487;44464;41977
540;"24.06.2007";11;"19.1";2642;46888;44246
540;"24.06.2007";12;"23.5";2748;49169;46421
540;"24.06.2007";13;"23.1";2783;48642;45859
540;"24.06.2007";14;"19.1";2904;46347;43443
540;"24.06.2007";15;"16.6";2902;44621;41719
540;"24.06.2007";16;15;2596;43882;41286
540;"24.06.2007";17;"15.1";2303;43634;41331
540;"24.06.2007";18;"17.3";1826;44856;43030
540;"24.06.2007";19;"21.7";1232;46455;45223
540;"24.06.2007";20;"23.1";822;46910;46088
540;"24.06.2007";21;"23.2";570;46402;45832
540;"24.06.2007";22;"24.5";554;46640;46086
540;"24.06.2007";23;"28.2";705;48722;48017
540;"24.06.2007";24;"23.6";965;45200;44235
541;"25.06.2007";1;"20.1";1167;41954;40787
541;"25.06.2007";2;"14.5";1368;40289;38921
541;"25.06.2007";3;"12.7";1701;39693;37992
541;"25.06.2007";4;11;2139;40190;38051
541;"25.06.2007";5;"12.1";2175;41301;39126
541;"25.06.2007";6;"22.1";2457;44596;42139
541;"25.06.2007";7;"22.5";2253;53192;50939
541;"25.06.2007";8;"38.5";1955;60376;58421
541;"25.06.2007";9;"50.5";1673;64247;62574
541;"25.06.2007";10;"57.9";1618;65501;63883
541;"25.06.2007";11;"64.5";1768;67117;65349
541;"25.06.2007";12;120;2232;68828;66596
541;"25.06.2007";13;"68.1";2517;68405;65888
541;"25.06.2007";14;64;2642;67602;64960
541;"25.06.2007";15;60;3059;66399;63340
541;"25.06.2007";16;"54.5";3735;65525;61790
541;"25.06.2007";17;"47.4";3576;64333;60757
541;"25.06.2007";18;"44.5";3350;63663;60313
541;"25.06.2007";19;"40.2";3800;62865;59065
541;"25.06.2007";20;"37.1";3891;61493;57602
541;"25.06.2007";21;27;3537;58987;55450
541;"25.06.2007";22;"25.1";3508;56967;53459
541;"25.06.2007";23;"27.1";3575;54858;51283
541;"25.06.2007";24;"23.5";4474;50318;45844
542;"26.06.2007";1;"19.8";5059;46553;41494
542;"26.06.2007";2;14;4951;44460;39509
542;"26.06.2007";3;"12.4";5267;43420;38153
542;"26.06.2007";4;11;5177;43546;38369
542;"26.06.2007";5;"12.1";4996;44370;39374
542;"26.06.2007";6;16;5097;46822;41725
542;"26.06.2007";7;"19.9";5277;54472;49195
542;"26.06.2007";8;"28.8";4969;60650;55681
542;"26.06.2007";9;"51.2";6059;64076;58017
542;"26.06.2007";10;"55.4";7540;65428;57888
542;"26.06.2007";11;"64.6";8542;67567;59025
542;"26.06.2007";12;69;10046;69434;59388
542;"26.06.2007";13;62;10925;68154;57229
542;"26.06.2007";14;52;12051;67149;55098
542;"26.06.2007";15;50;13054;66530;53476
542;"26.06.2007";16;"44.7";14027;66062;52035
542;"26.06.2007";17;40;14621;65069;50448
542;"26.06.2007";18;"32.1";15072;64926;49854
542;"26.06.2007";19;30;15275;64520;49245
542;"26.06.2007";20;"26.1";15074;63470;48396
542;"26.06.2007";21;23;15179;61018;45839
542;"26.06.2007";22;"21.1";15305;59713;44408
542;"26.06.2007";23;"22.3";14786;57958;43172
542;"26.06.2007";24;"15.1";14531;53379;38848
543;"27.06.2007";1;"9.1";14429;50108;35679
543;"27.06.2007";2;"7.1";14234;48176;33942
543;"27.06.2007";3;"4.3";14414;47088;32674
543;"27.06.2007";4;3;14426;47446;33020
543;"27.06.2007";5;"3.1";14331;48384;34053
543;"27.06.2007";6;"8.2";13981;50725;36744
543;"27.06.2007";7;"11.1";13918;57561;43643
543;"27.06.2007";8;"25.4";14092;63878;49786
543;"27.06.2007";9;"26.3";14175;67294;53119
543;"27.06.2007";10;"32.3";14304;68060;53756
543;"27.06.2007";11;"31.1";14351;69635;55284
543;"27.06.2007";12;"32.9";14431;71156;56725
543;"27.06.2007";13;"36.1";14416;70308;55892
543;"27.06.2007";14;37;14480;69319;54839
543;"27.06.2007";15;"37.3";13997;68008;54011
543;"27.06.2007";16;"37.1";13888;66710;52822
543;"27.06.2007";17;"29.2";13562;65422;51860
543;"27.06.2007";18;"28.9";13239;64662;51423
543;"27.06.2007";19;"28.6";11928;63863;51935
543;"27.06.2007";20;"22.9";10029;62500;52471
543;"27.06.2007";21;"23.6";8431;59532;51101
543;"27.06.2007";22;"23.5";7872;57686;49814
543;"27.06.2007";23;"24.6";7437;56240;48803
543;"27.06.2007";24;"20.4";7407;51244;43837
544;"28.06.2007";1;"20.1";7392;47916;40524
544;"28.06.2007";2;"17.4";6736;45263;38527
544;"28.06.2007";3;14;6747;44402;37655
544;"28.06.2007";4;"4.7";6715;44343;37628
544;"28.06.2007";5;7;6463;45114;38651
544;"28.06.2007";6;"20.5";6382;47660;41278
544;"28.06.2007";7;"16.7";6042;54956;48914
544;"28.06.2007";8;"26.6";6358;61549;55191
544;"28.06.2007";9;"29.1";6351;64702;58351
544;"28.06.2007";10;"32.1";6476;65723;59247
544;"28.06.2007";11;"35.2";6786;66695;59909
544;"28.06.2007";12;"38.1";7523;68357;60834
544;"28.06.2007";13;"41.7";7700;66913;59213
544;"28.06.2007";14;"35.1";7462;66045;58583
544;"28.06.2007";15;34;7304;64680;57376
544;"28.06.2007";16;"32.1";6512;63457;56945
544;"28.06.2007";17;30;6633;62189;55556
544;"28.06.2007";18;"29.4";5998;61825;55827
544;"28.06.2007";19;30;5447;61209;55762
544;"28.06.2007";20;"29.8";4308;60233;55925
544;"28.06.2007";21;"27.4";3295;57624;54329
544;"28.06.2007";22;25;2666;55711;53045
544;"28.06.2007";23;"28.4";2460;54769;52309
544;"28.06.2007";24;"23.9";2446;50679;48233
545;"29.06.2007";1;"24.4";2678;47111;44433
545;"29.06.2007";2;"23.4";3137;45035;41898
545;"29.06.2007";3;"18.3";3239;43872;40633
545;"29.06.2007";4;"11.4";3516;44005;40489
545;"29.06.2007";5;"11.4";3773;45179;41406
545;"29.06.2007";6;"19.1";3904;47316;43412
545;"29.06.2007";7;"27.5";3647;54354;50707
545;"29.06.2007";8;"35.4";3096;60635;57539
545;"29.06.2007";9;42;3428;63681;60253
545;"29.06.2007";10;"41.3";4115;64681;60566
545;"29.06.2007";11;42;4978;65709;60731
545;"29.06.2007";12;"44.1";6021;67186;61165
545;"29.06.2007";13;"41.1";6676;66044;59368
545;"29.06.2007";14;"35.6";7146;64913;57767
545;"29.06.2007";15;"32.1";6562;63190;56628
545;"29.06.2007";16;"30.1";6313;62069;55756
545;"29.06.2007";17;29;6370;61194;54824
545;"29.06.2007";18;"27.9";6463;61081;54618
545;"29.06.2007";19;"28.1";6244;61040;54796
545;"29.06.2007";20;"27.1";6150;59287;53137
545;"29.06.2007";21;"25.8";5990;56804;50814
545;"29.06.2007";22;"23.9";5604;55040;49436
545;"29.06.2007";23;25;5654;54053;48399
545;"29.06.2007";24;22;5449;49695;44246
546;"30.06.2007";1;24;5200;46302;41102
546;"30.06.2007";2;"20.6";5086;44066;38980
546;"30.06.2007";3;19;4965;42843;37878
546;"30.06.2007";4;"17.1";4658;42166;37508
546;"30.06.2007";5;14;4342;42090;37748
546;"30.06.2007";6;9;4395;42169;37774
546;"30.06.2007";7;"7.1";4061;44053;39992
546;"30.06.2007";8;"17.1";3872;47995;44123
546;"30.06.2007";9;"22.5";4423;51789;47366
546;"30.06.2007";10;25;5589;54285;48696
546;"30.06.2007";11;30;6615;55992;49377
546;"30.06.2007";12;29;7504;57301;49797
546;"30.06.2007";13;"26.5";8397;56120;47723
546;"30.06.2007";14;"22.7";8752;54080;45328
546;"30.06.2007";15;22;8583;52187;43604
546;"30.06.2007";16;23;8726;51317;42591
546;"30.06.2007";17;23;8326;50731;42405
546;"30.06.2007";18;"24.5";7690;51177;43487
546;"30.06.2007";19;"25.1";6497;50991;44494
546;"30.06.2007";20;27;4503;49758;45255
546;"30.06.2007";21;"25.7";3005;47517;44512
546;"30.06.2007";22;25;1885;46528;44643
546;"30.06.2007";23;"27.1";1437;46961;45524
546;"30.06.2007";24;"24.6";1231;44501;43270
547;"01.07.2007";1;20;1225;40840;39615
547;"01.07.2007";2;16;1178;38483;37305
547;"01.07.2007";3;14;1123;37373;36250
547;"01.07.2007";4;"11.7";1093;36818;35725
547;"01.07.2007";5;"10.1";1095;36550;35455
547;"01.07.2007";6;"9.8";1134;35785;34651
547;"01.07.2007";7;"4.3";1166;36375;35209
547;"01.07.2007";8;"13.1";1179;38669;37490
547;"01.07.2007";9;"14.8";1120;42177;41057
547;"01.07.2007";10;20;924;44840;43916
547;"01.07.2007";11;"22.7";1072;47083;46011
547;"01.07.2007";12;"25.4";1380;49538;48158
547;"01.07.2007";13;"24.5";1909;48520;46611
547;"01.07.2007";14;"21.2";2586;46569;43983
547;"01.07.2007";15;"19.4";2937;45167;42230
547;"01.07.2007";16;"17.6";3170;44389;41219
547;"01.07.2007";17;"17.2";2870;44134;41264
547;"01.07.2007";18;"18.8";2641;45514;42873
547;"01.07.2007";19;"22.9";2546;47041;44495
547;"01.07.2007";20;24;2190;47485;45295
547;"01.07.2007";21;"23.8";2072;47103;45031
547;"01.07.2007";22;"23.5";1987;47242;45255
547;"01.07.2007";23;"26.9";1845;48712;46867
547;"01.07.2007";24;"20.1";2097;45491;43394
548;"02.07.2007";1;"20.1";2107;42325;40218
548;"02.07.2007";2;"14.3";2016;40684;38668
548;"02.07.2007";3;"12.6";2060;39756;37696
548;"02.07.2007";4;"10.4";1881;39879;37998
548;"02.07.2007";5;"13.3";1712;41106;39394
548;"02.07.2007";6;"19.4";1624;44247;42623
548;"02.07.2007";7;"21.6";1558;53076;51518
548;"02.07.2007";8;"37.1";1197;60462;59265
548;"02.07.2007";9;50;1186;65019;63833
548;"02.07.2007";10;"54.3";1229;66293;65064
548;"02.07.2007";11;60;1429;68047;66618
548;"02.07.2007";12;"75.1";1656;69815;68159
548;"02.07.2007";13;62;1831;68518;66687
548;"02.07.2007";14;57;1878;67471;65593
548;"02.07.2007";15;"48.4";2243;66145;63902
548;"02.07.2007";16;"46.7";2027;64924;62897
548;"02.07.2007";17;"39.1";2252;63045;60793
548;"02.07.2007";18;"38.3";2065;62401;60336
548;"02.07.2007";19;"36.6";1997;61823;59826
548;"02.07.2007";20;"33.4";1889;60399;58510
548;"02.07.2007";21;"30.6";1602;57512;55910
548;"02.07.2007";22;29;1744;55657;53913
548;"02.07.2007";23;"29.3";2054;54454;52400
548;"02.07.2007";24;"25.4";2618;49564;46946
549;"03.07.2007";1;"27.5";3001;45883;42882
549;"03.07.2007";2;"23.1";3440;43975;40535
549;"03.07.2007";3;"20.1";3791;43052;39261
549;"03.07.2007";4;"20.8";4014;43106;39092
549;"03.07.2007";5;"11.4";3945;44079;40134
549;"03.07.2007";6;"24.7";4010;46382;42372
549;"03.07.2007";7;28;3610;53597;49987
549;"03.07.2007";8;40;3486;60050;56564
549;"03.07.2007";9;"50.1";3586;63211;59625
549;"03.07.2007";10;"49.7";4244;64356;60112
549;"03.07.2007";11;"58.1";4517;66084;61567
549;"03.07.2007";12;72;4542;68187;63645
549;"03.07.2007";13;"56.6";4377;67737;63360
549;"03.07.2007";14;"54.8";4230;66677;62447
549;"03.07.2007";15;"53.2";3701;65449;61748
549;"03.07.2007";16;"45.5";3492;64540;61048
549;"03.07.2007";17;"42.1";3204;63246;60042
549;"03.07.2007";18;"42.1";3082;63084;60002
549;"03.07.2007";19;"42.3";2975;62625;59650
549;"03.07.2007";20;"36.1";2401;61188;58787
549;"03.07.2007";21;"33.6";1882;58384;56502
549;"03.07.2007";22;"31.2";1943;56471;54528
549;"03.07.2007";23;"29.3";2077;54644;52567
549;"03.07.2007";24;"25.1";2435;49716;47281
550;"04.07.2007";1;20;2274;45783;43509
550;"04.07.2007";2;18;2387;43742;41355
550;"04.07.2007";3;"16.1";2310;42784;40474
550;"04.07.2007";4;12;2236;42946;40710
550;"04.07.2007";5;"12.9";2337;43837;41500
550;"04.07.2007";6;"21.6";2122;46301;44179
550;"04.07.2007";7;"24.5";2060;53767;51707
550;"04.07.2007";8;"35.4";2058;60402;58344
550;"04.07.2007";9;"52.1";2449;64083;61634
550;"04.07.2007";10;"57.7";2882;65077;62195
550;"04.07.2007";11;60;3400;66356;62956
550;"04.07.2007";12;"63.9";3926;67854;63928
550;"04.07.2007";13;"52.9";4368;66642;62274
550;"04.07.2007";14;"53.9";4393;65651;61258
550;"04.07.2007";15;"52.1";4627;64619;59992
550;"04.07.2007";16;"42.1";4308;63473;59165
550;"04.07.2007";17;"36.1";4120;62166;58046
550;"04.07.2007";18;"33.2";3698;61781;58083
550;"04.07.2007";19;"29.4";3191;61140;57949
550;"04.07.2007";20;"26.2";2814;59767;56953
550;"04.07.2007";21;"29.6";2721;57435;54714
550;"04.07.2007";22;"27.7";2698;55890;53192
550;"04.07.2007";23;"28.3";2956;54426;51470
550;"04.07.2007";24;"23.6";3414;49547;46133
551;"05.07.2007";1;"25.7";3964;46010;42046
551;"05.07.2007";2;"22.5";4066;44131;40065
551;"05.07.2007";3;"21.5";4302;43182;38880
551;"05.07.2007";4;21;4551;43280;38729
551;"05.07.2007";5;"11.7";4388;44125;39737
551;"05.07.2007";6;"24.4";4522;46283;41761
551;"05.07.2007";7;"25.4";4638;53733;49095
551;"05.07.2007";8;"31.2";4616;60329;55713
551;"05.07.2007";9;"36.3";4567;64183;59616
551;"05.07.2007";10;"43.3";4440;65439;60999
551;"05.07.2007";11;"46.6";5175;67082;61907
551;"05.07.2007";12;62;5959;68946;62987
551;"05.07.2007";13;"55.1";6717;67919;61202
551;"05.07.2007";14;"53.1";7311;67075;59764
551;"05.07.2007";15;"45.5";8100;65900;57800
551;"05.07.2007";16;"40.1";8434;64847;56413
551;"05.07.2007";17;"35.9";8279;63279;55000
551;"05.07.2007";18;"33.6";8584;62963;54379
551;"05.07.2007";19;"34.5";8153;62366;54213
551;"05.07.2007";20;"28.3";7803;60983;53180
551;"05.07.2007";21;"30.7";6758;58185;51427
551;"05.07.2007";22;28;6546;56600;50054
551;"05.07.2007";23;"28.1";7145;55322;48177
551;"05.07.2007";24;"25.2";7514;51186;43672
552;"06.07.2007";1;18;7861;47758;39897
552;"06.07.2007";2;"15.5";7687;45857;38170
552;"06.07.2007";3;"14.6";7942;44997;37055
552;"06.07.2007";4;"10.1";7550;44778;37228
552;"06.07.2007";5;"4.1";7258;45624;38366
552;"06.07.2007";6;17;6962;47953;40991
552;"06.07.2007";7;"20.9";6723;54971;48248
552;"06.07.2007";8;27;6704;61141;54437
552;"06.07.2007";9;"34.8";7267;64900;57633
552;"06.07.2007";10;39;8539;66219;57680
552;"06.07.2007";11;"52.4";9205;67416;58211
552;"06.07.2007";12;"55.1";9990;68698;58708
552;"06.07.2007";13;"44.1";10679;67470;56791
552;"06.07.2007";14;"34.1";11203;65591;54388
552;"06.07.2007";15;"31.4";12254;64105;51851
552;"06.07.2007";16;"27.4";13033;63500;50467
552;"06.07.2007";17;"25.3";13749;62527;48778
552;"06.07.2007";18;"24.1";13890;62334;48444
552;"06.07.2007";19;25;12943;61649;48706
552;"06.07.2007";20;"23.7";12317;60161;47844
552;"06.07.2007";21;"24.1";11896;57580;45684
552;"06.07.2007";22;"23.2";11172;55562;44390
552;"06.07.2007";23;"25.1";11218;55137;43919
552;"06.07.2007";24;"17.1";11137;51078;39941
553;"07.07.2007";1;"19.9";11382;48187;36805
553;"07.07.2007";2;15;11558;46254;34696
553;"07.07.2007";3;"14.1";11595;44860;33265
553;"07.07.2007";4;"12.9";11287;44689;33402
553;"07.07.2007";5;"12.7";10724;44565;33841
553;"07.07.2007";6;14;10175;43915;33740
553;"07.07.2007";7;"20.9";10098;45975;35877
553;"07.07.2007";8;"20.7";9960;49433;39473
553;"07.07.2007";9;21;9774;53102;43328
553;"07.07.2007";10;"26.8";10510;55618;45108
553;"07.07.2007";11;"28.9";11334;57067;45733
553;"07.07.2007";12;31;11844;57869;46025
553;"07.07.2007";13;31;12065;56591;44526
553;"07.07.2007";14;29;11918;54198;42280
553;"07.07.2007";15;26;12500;52659;40159
553;"07.07.2007";16;"23.2";12189;51774;39585
553;"07.07.2007";17;"23.1";11575;50818;39243
553;"07.07.2007";18;"21.1";11351;51436;40085
553;"07.07.2007";19;"24.1";10609;51658;41049
553;"07.07.2007";20;"24.3";8933;50529;41596
553;"07.07.2007";21;"23.2";6988;48005;41017
553;"07.07.2007";22;"22.6";5418;46599;41181
553;"07.07.2007";23;"25.5";5040;47424;42384
553;"07.07.2007";24;"15.1";4765;44522;39757
554;"08.07.2007";1;"16.9";4917;41322;36405
554;"08.07.2007";2;"15.7";5024;39068;34044
554;"08.07.2007";3;13;4811;37814;33003
554;"08.07.2007";4;"8.8";4512;37413;32901
554;"08.07.2007";5;"9.1";4486;37090;32604
554;"08.07.2007";6;"5.7";4400;36146;31746
554;"08.07.2007";7;4;3910;36333;32423
554;"08.07.2007";8;"9.7";3221;38622;35401
554;"08.07.2007";9;15;3468;41984;38516
554;"08.07.2007";10;"16.9";4415;44858;40443
554;"08.07.2007";11;"21.8";5241;47088;41847
554;"08.07.2007";12;"25.6";5697;49308;43611
554;"08.07.2007";13;"22.6";5728;48152;42424
554;"08.07.2007";14;20;5402;46406;41004
554;"08.07.2007";15;"17.5";4929;44932;40003
554;"08.07.2007";16;"15.6";4304;43969;39665
554;"08.07.2007";17;"16.1";3769;43739;39970
554;"08.07.2007";18;"20.8";3300;44967;41667
554;"08.07.2007";19;25;2656;46013;43357
554;"08.07.2007";20;"28.1";1936;46483;44547
554;"08.07.2007";21;"25.9";1170;46232;45062
554;"08.07.2007";22;"28.1";991;46712;45721
554;"08.07.2007";23;"34.5";1024;47932;46908
554;"08.07.2007";24;"27.2";1037;44182;43145
555;"09.07.2007";1;"20.1";1049;41153;40104
555;"09.07.2007";2;"16.4";1052;39723;38671
555;"09.07.2007";3;"10.4";927;38998;38071
555;"09.07.2007";4;"10.3";856;39265;38409
555;"09.07.2007";5;"11.4";1031;40683;39652
555;"09.07.2007";6;"17.5";1095;43879;42784
555;"09.07.2007";7;"21.1";889;52345;51456
555;"09.07.2007";8;"33.1";687;59359;58672
555;"09.07.2007";9;47;522;63174;62652
555;"09.07.2007";10;52;574;64904;64330
555;"09.07.2007";11;"55.3";573;66422;65849
555;"09.07.2007";12;"82.8";494;68141;67647
555;"09.07.2007";13;"58.1";573;67438;66865
555;"09.07.2007";14;54;709;66470;65761
555;"09.07.2007";15;"51.9";726;65094;64368
555;"09.07.2007";16;"49.7";775;63932;63157
555;"09.07.2007";17;"40.5";891;62210;61319
555;"09.07.2007";18;"37.8";1023;61613;60590
555;"09.07.2007";19;"33.9";1164;61134;59970
555;"09.07.2007";20;"28.8";852;60021;59169
555;"09.07.2007";21;"28.2";781;57222;56441
555;"09.07.2007";22;27;770;55296;54526
555;"09.07.2007";23;"27.9";731;53469;52738
555;"09.07.2007";24;"21.8";657;48476;47819
556;"10.07.2007";1;"23.4";794;44246;43452
556;"10.07.2007";2;"20.9";949;42294;41345
556;"10.07.2007";3;20;1080;41152;40072
556;"10.07.2007";4;"19.1";1335;41518;40183
556;"10.07.2007";5;"19.3";1352;42655;41303
556;"10.07.2007";6;"20.3";1168;45038;43870
556;"10.07.2007";7;"21.1";1118;52412;51294
556;"10.07.2007";8;"29.2";881;59245;58364
556;"10.07.2007";9;"35.5";746;63129;62383
556;"10.07.2007";10;"46.3";775;64195;63420
556;"10.07.2007";11;"50.2";788;65832;65044
556;"10.07.2007";12;"66.1";938;67440;66502
556;"10.07.2007";13;"52.1";1104;66297;65193
556;"10.07.2007";14;"48.8";1396;65467;64071
556;"10.07.2007";15;44;1643;64179;62536
556;"10.07.2007";16;"41.9";1613;62917;61304
556;"10.07.2007";17;40;1436;61314;59878
556;"10.07.2007";18;"39.5";1548;60855;59307
556;"10.07.2007";19;"38.4";1697;60320;58623
556;"10.07.2007";20;"31.9";1230;59204;57974
556;"10.07.2007";21;"35.1";973;56774;55801
556;"10.07.2007";22;"29.2";896;55131;54235
556;"10.07.2007";23;"29.3";1259;54090;52831
556;"10.07.2007";24;"22.5";1780;49128;47348
557;"11.07.2007";1;"23.2";2396;45309;42913
557;"11.07.2007";2;"19.4";2654;43418;40764
557;"11.07.2007";3;"16.1";2984;42368;39384
557;"11.07.2007";4;"15.9";3235;42613;39378
557;"11.07.2007";5;14;3158;43666;40508
557;"11.07.2007";6;21;3075;46278;43203
557;"11.07.2007";7;"21.5";2776;53521;50745
557;"11.07.2007";8;28;2501;59488;56987
557;"11.07.2007";9;"37.4";2640;62841;60201
557;"11.07.2007";10;"44.6";3427;64233;60806
557;"11.07.2007";11;"46.9";3922;65830;61908
557;"11.07.2007";12;"54.1";4530;67239;62709
557;"11.07.2007";13;"47.9";5190;66379;61189
557;"11.07.2007";14;"41.9";5856;65660;59804
557;"11.07.2007";15;"39.3";6469;64753;58284
557;"11.07.2007";16;"34.1";6108;63447;57339
557;"11.07.2007";17;"33.4";6206;62393;56187
557;"11.07.2007";18;"32.6";5629;62291;56662
557;"11.07.2007";19;30;5249;61946;56697
557;"11.07.2007";20;"26.1";5091;60884;55793
557;"11.07.2007";21;"26.9";4889;58498;53609
557;"11.07.2007";22;"25.1";4864;56821;51957
557;"11.07.2007";23;"24.8";4919;54449;49530
557;"11.07.2007";24;"18.1";5243;49604;44361
558;"12.07.2007";1;23;5490;45887;40397
558;"12.07.2007";2;"17.1";5355;44116;38761
558;"12.07.2007";3;16;5296;43363;38067
558;"12.07.2007";4;"10.1";5483;43160;37677
558;"12.07.2007";5;"11.2";5417;44194;38777
558;"12.07.2007";6;21;4945;46830;41885
558;"12.07.2007";7;"23.6";4722;53937;49215
558;"12.07.2007";8;30;4719;60252;55533
558;"12.07.2007";9;40;4730;63745;59015
558;"12.07.2007";10;40;5025;64954;59929
558;"12.07.2007";11;"45.1";5378;66519;61141
558;"12.07.2007";12;"55.1";5626;68197;62571
558;"12.07.2007";13;"50.1";5680;67115;61435
558;"12.07.2007";14;"49.3";5702;65808;60106
558;"12.07.2007";15;"44.9";6083;64828;58745
558;"12.07.2007";16;"40.1";5826;63646;57820
558;"12.07.2007";17;38;5357;62272;56915
558;"12.07.2007";18;"33.2";5034;61625;56591
558;"12.07.2007";19;33;4076;60756;56680
558;"12.07.2007";20;"31.6";3598;60018;56420
558;"12.07.2007";21;"33.1";2905;57385;54480
558;"12.07.2007";22;"31.1";2715;55793;53078
558;"12.07.2007";23;31;2975;53926;50951
558;"12.07.2007";24;"25.9";3158;49104;45946
559;"13.07.2007";1;"23.7";3118;45630;42512
559;"13.07.2007";2;22;3144;43790;40646
559;"13.07.2007";3;"16.8";3114;42732;39618
559;"13.07.2007";4;"16.2";3219;42829;39610
559;"13.07.2007";5;14;3078;43839;40761
559;"13.07.2007";6;22;3096;46429;43333
559;"13.07.2007";7;"25.1";2881;53563;50682
559;"13.07.2007";8;"28.2";2557;60310;57753
559;"13.07.2007";9;"34.6";2606;64071;61465
559;"13.07.2007";10;"39.9";2749;65146;62397
559;"13.07.2007";11;42;3003;66492;63489
559;"13.07.2007";12;"45.9";3477;67693;64216
559;"13.07.2007";13;"44.1";3627;66320;62693
559;"13.07.2007";14;"36.1";3764;64505;60741
559;"13.07.2007";15;"34.3";3499;62962;59463
559;"13.07.2007";16;34;3278;61511;58233
559;"13.07.2007";17;"30.7";2731;60224;57493
559;"13.07.2007";18;"31.3";2427;59992;57565
559;"13.07.2007";19;32;1858;59428;57570
559;"13.07.2007";20;30;1264;57999;56735
559;"13.07.2007";21;"30.2";859;55292;54433
559;"13.07.2007";22;"28.1";895;53597;52702
559;"13.07.2007";23;"31.6";1497;53378;51881
559;"13.07.2007";24;"25.2";2018;49392;47374
560;"14.07.2007";1;"27.8";2269;45652;43383
560;"14.07.2007";2;"25.1";2656;43145;40489
560;"14.07.2007";3;"21.7";2878;41542;38664
560;"14.07.2007";4;"19.7";3041;41048;38007
560;"14.07.2007";5;19;3334;40975;37641
560;"14.07.2007";6;14;3471;40793;37322
560;"14.07.2007";7;"4.1";3515;43189;39674
560;"14.07.2007";8;"6.9";3146;47626;44480
560;"14.07.2007";9;"23.6";2681;51463;48782
560;"14.07.2007";10;"29.1";2845;54202;51357
560;"14.07.2007";11;"31.6";3269;55331;52062
560;"14.07.2007";12;"30.1";3896;56373;52477
560;"14.07.2007";13;"32.1";4981;54513;49532
560;"14.07.2007";14;28;5938;52401;46463
560;"14.07.2007";15;"25.3";6281;50732;44451
560;"14.07.2007";16;25;6185;49915;43730
560;"14.07.2007";17;"24.9";6022;49461;43439
560;"14.07.2007";18;25;5697;50057;44360
560;"14.07.2007";19;26;5092;50288;45196
560;"14.07.2007";20;"26.1";4104;49237;45133
560;"14.07.2007";21;25;3124;47164;44040
560;"14.07.2007";22;25;2593;46426;43833
560;"14.07.2007";23;28;2495;47290;44795
560;"14.07.2007";24;"23.5";1992;44365;42373
561;"15.07.2007";1;"19.1";1535;40951;39416
561;"15.07.2007";2;"15.1";1044;38611;37567
561;"15.07.2007";3;"13.9";821;37425;36604
561;"15.07.2007";4;"8.5";689;36628;35939
561;"15.07.2007";5;"7.1";640;36207;35567
561;"15.07.2007";6;"5.7";657;35186;34529
561;"15.07.2007";7;"4.9";630;35863;35233
561;"15.07.2007";8;"9.6";638;38815;38177
561;"15.07.2007";9;"16.1";612;41995;41383
561;"15.07.2007";10;19;584;44580;43996
561;"15.07.2007";11;"22.4";854;46297;45443
561;"15.07.2007";12;"26.7";1047;48225;47178
561;"15.07.2007";13;"24.1";1219;47112;45893
561;"15.07.2007";14;23;1350;45537;44187
561;"15.07.2007";15;"20.1";1539;44271;42732
561;"15.07.2007";16;"18.8";1916;43643;41727
561;"15.07.2007";17;19;2340;43826;41486
561;"15.07.2007";18;"20.4";2340;45180;42840
561;"15.07.2007";19;"21.1";2228;46644;44416
561;"15.07.2007";20;"20.9";1787;47050;45263
561;"15.07.2007";21;"20.8";2210;46729;44519
561;"15.07.2007";22;22;3051;47421;44370
561;"15.07.2007";23;"23.5";3669;49287;45618
561;"15.07.2007";24;"20.1";4019;45950;41931
562;"16.07.2007";1;24;4114;42820;38706
562;"16.07.2007";2;"19.7";3965;41066;37101
562;"16.07.2007";3;"17.4";3895;40079;36184
562;"16.07.2007";4;13;3580;40412;36832
562;"16.07.2007";5;"15.7";3303;41386;38083
562;"16.07.2007";6;18;3018;44257;41239
562;"16.07.2007";7;"21.6";2717;52350;49633
562;"16.07.2007";8;"33.9";2188;59694;57506
562;"16.07.2007";9;"41.3";1274;63773;62499
562;"16.07.2007";10;46;978;65078;64100
562;"16.07.2007";11;"55.1";1013;66251;65238
562;"16.07.2007";12;"67.6";805;67381;66576
562;"16.07.2007";13;56;1079;66616;65537
562;"16.07.2007";14;"56.1";1738;66009;64271
562;"16.07.2007";15;55;1405;64691;63286
562;"16.07.2007";16;"50.2";1329;63987;62658
562;"16.07.2007";17;"44.1";1164;62544;61380
562;"16.07.2007";18;"40.2";904;62113;61209
562;"16.07.2007";19;"39.9";702;61496;60794
562;"16.07.2007";20;"34.1";722;60625;59903
562;"16.07.2007";21;"32.4";951;58067;57116
562;"16.07.2007";22;"30.2";1225;56957;55732
562;"16.07.2007";23;"31.3";1580;55493;53913
562;"16.07.2007";24;26;2047;50408;48361
563;"17.07.2007";1;"27.1";2225;46479;44254
563;"17.07.2007";2;"23.9";2519;44684;42165
563;"17.07.2007";3;21;2587;43593;41006
563;"17.07.2007";4;16;2611;43669;41058
563;"17.07.2007";5;"13.7";3033;44512;41479
563;"17.07.2007";6;"21.9";3635;47128;43493
563;"17.07.2007";7;"21.6";4372;54480;50108
563;"17.07.2007";8;"31.7";4322;60797;56475
563;"17.07.2007";9;45;4952;63922;58970
563;"17.07.2007";10;"44.7";5725;64955;59230
563;"17.07.2007";11;"50.1";6379;66554;60175
563;"17.07.2007";12;"58.6";6488;67713;61225
563;"17.07.2007";13;55;6530;66877;60347
563;"17.07.2007";14;"55.2";6579;66033;59454
563;"17.07.2007";15;"53.1";5705;64889;59184
563;"17.07.2007";16;"51.9";4971;63900;58929
563;"17.07.2007";17;"48.4";4475;62272;57797
563;"17.07.2007";18;"46.2";3649;61771;58122
563;"17.07.2007";19;"46.2";2891;60974;58083
563;"17.07.2007";20;"42.8";2064;59862;57798
563;"17.07.2007";21;"36.6";1069;57518;56449
563;"17.07.2007";22;35;722;56221;55499
563;"17.07.2007";23;"36.9";603;55398;54795
563;"17.07.2007";24;"30.2";546;50448;49902
564;"18.07.2007";1;"30.6";673;46770;46097
564;"18.07.2007";2;"23.2";817;44373;43556
564;"18.07.2007";3;"22.1";960;43388;42428
564;"18.07.2007";4;"22.8";1098;43622;42524
564;"18.07.2007";5;"23.1";1137;44474;43337
564;"18.07.2007";6;"25.4";1291;46964;45673
564;"18.07.2007";7;"28.9";1420;54112;52692
564;"18.07.2007";8;43;1151;60480;59329
564;"18.07.2007";9;"45.1";833;63299;62466
564;"18.07.2007";10;62;961;64674;63713
564;"18.07.2007";11;61;1358;66502;65144
564;"18.07.2007";12;"79.3";1701;67887;66186
564;"18.07.2007";13;"64.9";2189;67171;64982
564;"18.07.2007";14;"62.5";2482;66207;63725
564;"18.07.2007";15;61;2818;64697;61879
564;"18.07.2007";16;"53.3";3006;63630;60624
564;"18.07.2007";17;"44.1";2572;61969;59397
564;"18.07.2007";18;"41.3";2680;61561;58881
564;"18.07.2007";19;"41.1";2377;61047;58670
564;"18.07.2007";20;37;1547;60024;58477
564;"18.07.2007";21;"36.1";1065;57273;56208
564;"18.07.2007";22;"35.1";1022;56136;55114
564;"18.07.2007";23;35;1038;55019;53981
564;"18.07.2007";24;"27.5";966;50451;49485
565;"19.07.2007";1;"25.5";820;46779;45959
565;"19.07.2007";2;"20.6";732;44653;43921
565;"19.07.2007";3;"19.1";675;43538;42863
565;"19.07.2007";4;"16.1";611;43514;42903
565;"19.07.2007";5;"16.8";600;44155;43555
565;"19.07.2007";6;21;558;46274;45716
565;"19.07.2007";7;"22.1";604;53332;52728
565;"19.07.2007";8;34;436;59394;58958
565;"19.07.2007";9;"39.9";429;62976;62547
565;"19.07.2007";10;"42.3";430;64301;63871
565;"19.07.2007";11;"50.3";428;66026;65598
565;"19.07.2007";12;"62.1";390;67643;67253
565;"19.07.2007";13;"53.4";335;66733;66398
565;"19.07.2007";14;"53.2";377;65751;65374
565;"19.07.2007";15;"51.1";378;65008;64630
565;"19.07.2007";16;"49.4";401;63983;63582
565;"19.07.2007";17;"43.6";507;62356;61849
565;"19.07.2007";18;"42.6";615;62147;61532
565;"19.07.2007";19;"40.1";812;61270;60458
565;"19.07.2007";20;"31.2";1023;59975;58952
565;"19.07.2007";21;34;1250;57596;56346
565;"19.07.2007";22;"30.1";1559;56539;54980
565;"19.07.2007";23;33;1688;54939;53251
565;"19.07.2007";24;"27.1";1743;50562;48819
566;"20.07.2007";1;"25.7";1787;47103;45316
566;"20.07.2007";2;"26.5";1827;44964;43137
566;"20.07.2007";3;"24.3";1616;43673;42057
566;"20.07.2007";4;"23.6";1565;43560;41995
566;"20.07.2007";5;19;1745;44471;42726
566;"20.07.2007";6;"25.7";1868;46566;44698
566;"20.07.2007";7;"28.5";1778;53128;51350
566;"20.07.2007";8;"35.1";1570;59555;57985
566;"20.07.2007";9;"48.9";1527;62936;61409
566;"20.07.2007";10;"54.1";1689;64112;62423
566;"20.07.2007";11;"95.1";1806;65602;63796
566;"20.07.2007";12;"98.4";2102;66822;64720
566;"20.07.2007";13;"80.1";2959;66373;63414
566;"20.07.2007";14;"52.1";3216;64823;61607
566;"20.07.2007";15;"49.9";3537;63480;59943
566;"20.07.2007";16;"42.5";3880;62469;58589
566;"20.07.2007";17;"41.6";3755;61964;58209
566;"20.07.2007";18;40;3098;61834;58736
566;"20.07.2007";19;"37.2";3008;60942;57934
566;"20.07.2007";20;"31.3";2734;59361;56627
566;"20.07.2007";21;33;2712;56314;53602
566;"20.07.2007";22;"30.1";3028;54962;51934
566;"20.07.2007";23;"31.3";3202;53630;50428
566;"20.07.2007";24;"25.5";2993;49745;46752
567;"21.07.2007";1;"25.6";3287;46574;43287
567;"21.07.2007";2;"23.6";3369;44033;40664
567;"21.07.2007";3;"20.1";3185;42610;39425
567;"21.07.2007";4;18;2958;41910;38952
567;"21.07.2007";5;"17.1";3131;41850;38719
567;"21.07.2007";6;"17.9";2899;41724;38825
567;"21.07.2007";7;"10.8";2646;43681;41035
567;"21.07.2007";8;"23.5";2099;47275;45176
567;"21.07.2007";9;28;1988;50903;48915
567;"21.07.2007";10;"35.6";1891;53318;51427
567;"21.07.2007";11;"39.3";1641;54986;53345
567;"21.07.2007";12;"44.9";1368;56081;54713
567;"21.07.2007";13;"39.9";1175;54584;53409
567;"21.07.2007";14;34;962;52266;51304
567;"21.07.2007";15;33;710;50922;50212
567;"21.07.2007";16;32;603;49994;49391
567;"21.07.2007";17;"30.1";459;49654;49195
567;"21.07.2007";18;"32.9";431;50231;49800
567;"21.07.2007";19;33;453;50382;49929
567;"21.07.2007";20;"30.1";463;49903;49440
567;"21.07.2007";21;"30.1";558;47664;47106
567;"21.07.2007";22;"29.9";914;47255;46341
567;"21.07.2007";23;31;1339;46610;45271
567;"21.07.2007";24;"26.1";1642;43260;41618
568;"22.07.2007";1;"23.9";1847;40450;38603
568;"22.07.2007";2;"20.1";1943;38525;36582
568;"22.07.2007";3;"16.5";1820;37329;35509
568;"22.07.2007";4;"16.3";1921;36635;34714
568;"22.07.2007";5;"13.8";1815;36336;34521
568;"22.07.2007";6;"11.8";1684;35947;34263
568;"22.07.2007";7;"10.2";1327;36287;34960
568;"22.07.2007";8;"13.4";1173;38614;37441
568;"22.07.2007";9;"18.1";1631;41682;40051
568;"22.07.2007";10;22;1826;44264;42438
568;"22.07.2007";11;24;2452;46380;43928
568;"22.07.2007";12;"28.4";3230;48892;45662
568;"22.07.2007";13;"25.3";3981;48121;44140
568;"22.07.2007";14;"23.2";4117;46272;42155
568;"22.07.2007";15;"22.5";4524;44902;40378
568;"22.07.2007";16;21;4928;44173;39245
568;"22.07.2007";17;"21.6";4950;44026;39076
568;"22.07.2007";18;"24.1";4350;45062;40712
568;"22.07.2007";19;26;3760;46265;42505
568;"22.07.2007";20;"27.3";3282;46554;43272
568;"22.07.2007";21;"25.2";2441;45950;43509
568;"22.07.2007";22;"25.5";2068;46504;44436
568;"22.07.2007";23;"29.8";2348;47898;45550
568;"22.07.2007";24;"23.6";2456;44426;41970
569;"23.07.2007";1;"21.8";2464;41489;39025
569;"23.07.2007";2;"18.1";2331;39956;37625
569;"23.07.2007";3;"17.6";2134;39161;37027
569;"23.07.2007";4;"17.6";1834;39288;37454
569;"23.07.2007";5;"18.5";1695;40489;38794
569;"23.07.2007";6;22;1687;43327;41640
569;"23.07.2007";7;27;1491;50522;49031
569;"23.07.2007";8;"40.1";1015;57396;56381
569;"23.07.2007";9;"46.4";868;61357;60489
569;"23.07.2007";10;"50.3";836;62777;61941
569;"23.07.2007";11;"62.1";914;64537;63623
569;"23.07.2007";12;"90.2";1086;66117;65031
569;"23.07.2007";13;"65.1";1165;65650;64485
569;"23.07.2007";14;"56.5";1202;64860;63658
569;"23.07.2007";15;"51.2";1022;63729;62707
569;"23.07.2007";16;"48.7";915;62880;61965
569;"23.07.2007";17;"43.5";946;61942;60996
569;"23.07.2007";18;"41.2";1132;61823;60691
569;"23.07.2007";19;"40.1";1569;61817;60248
569;"23.07.2007";20;"36.2";2072;60753;58681
569;"23.07.2007";21;35;2911;58238;55327
569;"23.07.2007";22;"29.6";3235;56712;53477
569;"23.07.2007";23;"27.4";3877;53940;50063
569;"23.07.2007";24;"23.1";4612;49161;44549
570;"24.07.2007";1;17;4980;45582;40602
570;"24.07.2007";2;"9.4";4781;43596;38815
570;"24.07.2007";3;"9.1";5643;43009;37366
570;"24.07.2007";4;"6.3";5470;43112;37642
570;"24.07.2007";5;"5.9";5602;44190;38588
570;"24.07.2007";6;"10.3";6013;46913;40900
570;"24.07.2007";7;16;5843;53702;47859
570;"24.07.2007";8;"23.3";5334;59916;54582
570;"24.07.2007";9;"29.7";5547;63238;57691
570;"24.07.2007";10;"33.1";6449;65054;58605
570;"24.07.2007";11;37;7100;66693;59593
570;"24.07.2007";12;"42.5";7242;68492;61250
570;"24.07.2007";13;"41.4";7509;67267;59758
570;"24.07.2007";14;38;8217;65969;57752
570;"24.07.2007";15;"37.1";8712;64896;56184
570;"24.07.2007";16;34;9629;64075;54446
570;"24.07.2007";17;"24.6";10101;62844;52743
570;"24.07.2007";18;"22.1";10748;62831;52083
570;"24.07.2007";19;"23.6";11328;62502;51174
570;"24.07.2007";20;"22.1";11265;61512;50247
570;"24.07.2007";21;"24.2";10991;59022;48031
570;"24.07.2007";22;"24.2";11158;57866;46708
570;"24.07.2007";23;"24.6";10773;55868;45095
570;"24.07.2007";24;"18.1";10443;51067;40624
571;"25.07.2007";1;"24.9";9734;47827;38093
571;"25.07.2007";2;"23.2";9338;45943;36605
571;"25.07.2007";3;"22.6";9491;45167;35676
571;"25.07.2007";4;"21.2";9117;45126;36009
571;"25.07.2007";5;"21.8";8508;45585;37077
571;"25.07.2007";6;"26.3";8115;47986;39871
571;"25.07.2007";7;"21.6";7479;54164;46685
571;"25.07.2007";8;34;6588;60150;53562
571;"25.07.2007";9;33;6448;63205;56757
571;"25.07.2007";10;"36.1";6745;63880;57135
571;"25.07.2007";11;"39.1";6866;65319;58453
571;"25.07.2007";12;"44.9";7369;66972;59603
571;"25.07.2007";13;"41.9";7624;65945;58321
571;"25.07.2007";14;"38.7";7704;64807;57103
571;"25.07.2007";15;"39.9";7705;63555;55850
571;"25.07.2007";16;"36.5";7291;62305;55014
571;"25.07.2007";17;35;6891;61064;54173
571;"25.07.2007";18;36;6337;60792;54455
571;"25.07.2007";19;"32.7";5123;59920;54797
571;"25.07.2007";20;"32.9";3322;58613;55291
571;"25.07.2007";21;"30.1";1862;55998;54136
571;"25.07.2007";22;"30.1";1459;55421;53962
571;"25.07.2007";23;"31.3";1507;54203;52696
571;"25.07.2007";24;"26.7";1820;49243;47423
572;"26.07.2007";1;"23.2";1936;45761;43825
572;"26.07.2007";2;"19.9";2102;43718;41616
572;"26.07.2007";3;18;2499;42717;40218
572;"26.07.2007";4;"17.1";2583;42655;40072
572;"26.07.2007";5;"7.6";2634;43323;40689
572;"26.07.2007";6;"20.4";2866;45925;43059
572;"26.07.2007";7;"23.6";2973;52254;49281
572;"26.07.2007";8;"26.1";2640;58363;55723
572;"26.07.2007";9;"30.1";2031;61669;59638
572;"26.07.2007";10;"35.8";1932;62914;60982
572;"26.07.2007";11;39;2629;64110;61481
572;"26.07.2007";12;"44.6";3636;65669;62033
572;"26.07.2007";13;"37.1";4340;64753;60413
572;"26.07.2007";14;"35.1";4783;64057;59274
572;"26.07.2007";15;"34.1";4660;63154;58494
572;"26.07.2007";16;"33.1";4560;62003;57443
572;"26.07.2007";17;33;4646;60953;56307
572;"26.07.2007";18;"29.5";4154;60841;56687
572;"26.07.2007";19;"30.1";3244;60356;57112
572;"26.07.2007";20;"29.1";2321;59274;56953
572;"26.07.2007";21;"27.9";2230;56899;54669
572;"26.07.2007";22;"26.1";3102;56540;53438
572;"26.07.2007";23;30;3824;54342;50518
572;"26.07.2007";24;"23.1";5019;49941;44922
573;"27.07.2007";1;"22.9";5963;46506;40543
573;"27.07.2007";2;20;6050;44543;38493
573;"27.07.2007";3;"15.9";6024;43316;37292
573;"27.07.2007";4;"13.9";6235;43129;36894
573;"27.07.2007";5;"9.4";6254;44292;38038
573;"27.07.2007";6;"16.4";6582;46768;40186
573;"27.07.2007";7;"21.4";7130;52922;45792
573;"27.07.2007";8;"26.5";7188;58751;51563
573;"27.07.2007";9;"28.9";8577;62765;54188
573;"27.07.2007";10;"27.9";9921;64715;54794
573;"27.07.2007";11;"29.9";11032;66488;55456
573;"27.07.2007";12;"32.6";11552;67736;56184
573;"27.07.2007";13;28;12293;66712;54419
573;"27.07.2007";14;"27.2";12723;65068;52345
573;"27.07.2007";15;"26.3";12418;63503;51085
573;"27.07.2007";16;"26.1";11750;61691;49941
573;"27.07.2007";17;27;10776;60551;49775
573;"27.07.2007";18;28;9485;60069;50584
573;"27.07.2007";19;30;8284;59423;51139
573;"27.07.2007";20;30;6014;57698;51684
573;"27.07.2007";21;"30.1";3689;54400;50711
573;"27.07.2007";22;"29.2";2823;53681;50858
573;"27.07.2007";23;"30.6";2790;52240;49450
573;"27.07.2007";24;"23.4";2926;48218;45292
574;"28.07.2007";1;"25.6";3129;44938;41809
574;"28.07.2007";2;24;3347;42814;39467
574;"28.07.2007";3;"24.1";3389;41505;38116
574;"28.07.2007";4;"23.5";3442;41227;37785
574;"28.07.2007";5;"23.1";3519;41178;37659
574;"28.07.2007";6;23;3728;41138;37410
574;"28.07.2007";7;"16.8";3763;43149;39386
574;"28.07.2007";8;"23.5";3570;46475;42905
574;"28.07.2007";9;29;3029;50271;47242
574;"28.07.2007";10;"32.9";2900;52663;49763
574;"28.07.2007";11;33;3143;54593;51450
574;"28.07.2007";12;"33.5";3487;55932;52445
574;"28.07.2007";13;"29.9";4143;54293;50150
574;"28.07.2007";14;"27.7";4787;51943;47156
574;"28.07.2007";15;25;5682;50276;44594
574;"28.07.2007";16;24;6346;49253;42907
574;"28.07.2007";17;23;6916;49139;42223
574;"28.07.2007";18;"23.1";7354;49906;42552
574;"28.07.2007";19;"23.2";7849;50315;42466
574;"28.07.2007";20;"23.5";7269;49553;42284
574;"28.07.2007";21;24;5920;47249;41329
574;"28.07.2007";22;24;5277;47084;41807
574;"28.07.2007";23;24;4573;46092;41519
574;"28.07.2007";24;"21.5";4198;42868;38670
575;"29.07.2007";1;18;4091;40086;35995
575;"29.07.2007";2;"15.5";4325;38092;33767
575;"29.07.2007";3;"12.1";4248;36851;32603
575;"29.07.2007";4;"9.8";4025;36188;32163
575;"29.07.2007";5;"8.1";3753;35953;32200
575;"29.07.2007";6;"9.1";3493;35813;32320
575;"29.07.2007";7;"6.4";3082;35950;32868
575;"29.07.2007";8;"10.2";2809;38087;35278
575;"29.07.2007";9;"14.8";2602;41142;38540
575;"29.07.2007";10;18;2846;44146;41300
575;"29.07.2007";11;"21.7";2959;46782;43823
575;"29.07.2007";12;"23.2";3026;49837;46811
575;"29.07.2007";13;22;2993;49022;46029
575;"29.07.2007";14;"20.5";2843;46840;43997
575;"29.07.2007";15;"17.9";2886;45314;42428
575;"29.07.2007";16;16;3079;44344;41265
575;"29.07.2007";17;"15.1";3347;43994;40647
575;"29.07.2007";18;"17.7";4042;45335;41293
575;"29.07.2007";19;"22.7";4495;46501;42006
575;"29.07.2007";20;"22.3";4918;47016;42098
575;"29.07.2007";21;"22.2";5009;46743;41734
575;"29.07.2007";22;"23.2";4959;47179;42220
575;"29.07.2007";23;"23.6";4987;47100;42113
575;"29.07.2007";24;"19.9";4869;43847;38978
576;"30.07.2007";1;"18.3";5132;41412;36280
576;"30.07.2007";2;"15.6";5131;39625;34494
576;"30.07.2007";3;14;5371;38872;33501
576;"30.07.2007";4;"12.4";5654;39042;33388
576;"30.07.2007";5;"10.4";6243;40610;34367
576;"30.07.2007";6;"16.5";6626;43829;37203
576;"30.07.2007";7;"16.9";6963;50760;43797
576;"30.07.2007";8;"24.8";7574;57257;49683
576;"30.07.2007";9;"29.1";8693;61467;52774
576;"30.07.2007";10;32;9911;63256;53345
576;"30.07.2007";11;33;10806;65147;54341
576;"30.07.2007";12;"37.5";11284;66737;55453
576;"30.07.2007";13;33;11513;66259;54746
576;"30.07.2007";14;"30.9";11816;65355;53539
576;"30.07.2007";15;"29.1";12158;64402;52244
576;"30.07.2007";16;27;12402;63188;50786
576;"30.07.2007";17;"26.1";12039;61892;49853
576;"30.07.2007";18;"25.4";11374;61053;49679
576;"30.07.2007";19;27;10815;60428;49613
576;"30.07.2007";20;"25.5";10040;59633;49593
576;"30.07.2007";21;"23.4";9223;57373;48150
576;"30.07.2007";22;"21.8";8734;56805;48071
576;"30.07.2007";23;"21.1";8567;54762;46195
576;"30.07.2007";24;"16.1";8584;49890;41306
577;"31.07.2007";1;12;8425;46248;37823
577;"31.07.2007";2;"5.8";8211;44345;36134
577;"31.07.2007";3;"7.5";7832;43185;35353
577;"31.07.2007";4;"4.3";7139;42790;35651
577;"31.07.2007";5;"4.3";6942;43560;36618
577;"31.07.2007";6;"9.4";6697;46394;39697
577;"31.07.2007";7;"12.1";6326;52309;45983
577;"31.07.2007";8;"22.3";6173;58238;52065
577;"31.07.2007";9;"25.9";5893;61693;55800
577;"31.07.2007";10;29;6687;62709;56022
577;"31.07.2007";11;30;7077;64212;57135
577;"31.07.2007";12;33;7032;65511;58479
577;"31.07.2007";13;"31.1";6920;64534;57614
577;"31.07.2007";14;30;6876;63689;56813
577;"31.07.2007";15;"29.1";6985;62473;55488
577;"31.07.2007";16;"27.1";6866;61341;54475
577;"31.07.2007";17;"27.5";6473;59923;53450
577;"31.07.2007";18;"27.8";6281;59365;53084
577;"31.07.2007";19;"28.7";5744;58745;53001
577;"31.07.2007";20;27;4333;57594;53261
577;"31.07.2007";21;25;2967;55423;52456
577;"31.07.2007";22;"25.1";2367;54922;52555
577;"31.07.2007";23;"24.9";2426;52743;50317
577;"31.07.2007";24;"17.1";2385;47645;45260
578;"01.08.2007";1;"21.5";2345;43080;40735
578;"01.08.2007";2;"14.9";2372;41177;38805
578;"01.08.2007";3;"13.1";2213;40210;37997
578;"01.08.2007";4;10;2086;40231;38145
578;"01.08.2007";5;"11.1";2033;41695;39662
578;"01.08.2007";6;19;1952;44339;42387
578;"01.08.2007";7;"17.6";1758;50882;49124
578;"01.08.2007";8;24;1465;57179;55714
578;"01.08.2007";9;30;896;60431;59535
578;"01.08.2007";10;"32.3";844;61282;60438
578;"01.08.2007";11;33;967;62457;61490
578;"01.08.2007";12;"36.1";874;64513;63639
578;"01.08.2007";13;"36.1";818;63963;63145
578;"01.08.2007";14;35;803;62822;62019
578;"01.08.2007";15;"33.3";710;61573;60863
578;"01.08.2007";16;"32.1";664;60657;59993
578;"01.08.2007";17;32;613;59701;59088
578;"01.08.2007";18;"32.1";579;59706;59127
578;"01.08.2007";19;31;591;59932;59341
578;"01.08.2007";20;"26.9";599;59267;58668
578;"01.08.2007";21;29;835;56804;55969
578;"01.08.2007";22;29;1526;56243;54717
578;"01.08.2007";23;27;2395;53664;51269
578;"01.08.2007";24;"23.1";2949;48475;45526
579;"02.08.2007";1;"23.2";3254;44507;41253
579;"02.08.2007";2;"17.8";3504;42763;39259
579;"02.08.2007";3;"13.5";3602;41721;38119
579;"02.08.2007";4;"10.5";3799;41799;38000
579;"02.08.2007";5;"12.4";3940;42840;38900
579;"02.08.2007";6;"18.9";3497;45498;42001
579;"02.08.2007";7;"18.8";2984;52137;49153
579;"02.08.2007";8;"25.8";2423;58495;56072
579;"02.08.2007";9;"28.9";1756;62972;61216
579;"02.08.2007";10;"32.1";1634;65150;63516
579;"02.08.2007";11;36;1960;66933;64973
579;"02.08.2007";12;40;1908;68470;66562
579;"02.08.2007";13;"38.1";1937;67541;65604
579;"02.08.2007";14;"36.5";2043;66408;64365
579;"02.08.2007";15;35;1869;65583;63714
579;"02.08.2007";16;34;1977;64549;62572
579;"02.08.2007";17;"32.9";2106;62966;60860
579;"02.08.2007";18;"31.1";2306;62251;59945
579;"02.08.2007";19;31;2275;61158;58883
579;"02.08.2007";20;"29.2";2336;59332;56996
579;"02.08.2007";21;29;3090;56393;53303
579;"02.08.2007";22;"27.1";3039;55688;52649
579;"02.08.2007";23;"27.7";3054;53049;49995
579;"02.08.2007";24;"22.1";3227;48267;45040
580;"03.08.2007";1;"25.1";3279;44418;41139
580;"03.08.2007";2;"23.1";3447;42118;38671
580;"03.08.2007";3;"21.1";3357;40987;37630
580;"03.08.2007";4;"19.6";3154;40914;37760
580;"03.08.2007";5;"19.9";3181;41898;38717
580;"03.08.2007";6;"27.3";3167;44565;41398
580;"03.08.2007";7;27;3104;51082;47978
580;"03.08.2007";8;"34.2";2892;57126;54234
580;"03.08.2007";9;"42.1";2701;60624;57923
580;"03.08.2007";10;"45.2";3143;61754;58611
580;"03.08.2007";11;"49.3";3298;62885;59587
580;"03.08.2007";12;"52.6";3461;64026;60565
580;"03.08.2007";13;"46.6";3734;62798;59064
580;"03.08.2007";14;"39.9";3619;60754;57135
580;"03.08.2007";15;37;3492;59055;55563
580;"03.08.2007";16;"33.8";3074;57539;54465
580;"03.08.2007";17;"31.9";2976;56415;53439
580;"03.08.2007";18;"31.1";2829;56273;53444
580;"03.08.2007";19;"30.3";2369;55882;53513
580;"03.08.2007";20;"29.9";1685;54920;53235
580;"03.08.2007";21;"28.8";1109;52977;51868
580;"03.08.2007";22;29;1059;52786;51727
580;"03.08.2007";23;"31.1";1189;50745;49556
580;"03.08.2007";24;29;1163;46563;45400
581;"04.08.2007";1;"24.9";1140;43526;42386
581;"04.08.2007";2;"22.7";1218;41216;39998
581;"04.08.2007";3;"21.6";1236;40096;38860
581;"04.08.2007";4;21;1216;39799;38583
581;"04.08.2007";5;"20.2";1300;39612;38312
581;"04.08.2007";6;"22.3";1347;39742;38395
581;"04.08.2007";7;"21.1";1404;41494;40090
581;"04.08.2007";8;"21.1";1267;45222;43955
581;"04.08.2007";9;"26.1";863;49000;48137
581;"04.08.2007";10;"30.1";621;51412;50791
581;"04.08.2007";11;"32.1";854;52787;51933
581;"04.08.2007";12;33;1272;53553;52281
581;"04.08.2007";13;33;1464;52034;50570
581;"04.08.2007";14;"31.2";1366;49935;48569
581;"04.08.2007";15;"30.1";1286;48488;47202
581;"04.08.2007";16;"31.2";1184;47574;46390
581;"04.08.2007";17;"31.5";1030;47331;46301
581;"04.08.2007";18;32;830;48013;47183
581;"04.08.2007";19;33;681;48622;47941
581;"04.08.2007";20;32;484;48038;47554
581;"04.08.2007";21;29;272;46217;45945
581;"04.08.2007";22;"29.9";240;46770;46530
581;"04.08.2007";23;"30.1";274;45678;45404
581;"04.08.2007";24;"25.1";450;42367;41917
582;"05.08.2007";1;"19.1";719;39768;39049
582;"05.08.2007";2;"16.1";867;37790;36923
582;"05.08.2007";3;"12.1";992;36676;35684
582;"05.08.2007";4;"9.7";1105;36179;35074
582;"05.08.2007";5;"9.3";1260;36159;34899
582;"05.08.2007";6;"9.4";1266;36101;34835
582;"05.08.2007";7;"8.1";1215;36252;35037
582;"05.08.2007";8;"11.2";1247;38712;37465
582;"05.08.2007";9;"15.2";909;42040;41131
582;"05.08.2007";10;"20.8";591;44635;44044
582;"05.08.2007";11;"23.2";734;46487;45753
582;"05.08.2007";12;"27.5";1033;48784;47751
582;"05.08.2007";13;"25.4";1280;47950;46670
582;"05.08.2007";14;"24.1";1413;46164;44751
582;"05.08.2007";15;"22.4";1556;45216;43660
582;"05.08.2007";16;21;1839;44358;42519
582;"05.08.2007";17;"20.9";2107;44452;42345
582;"05.08.2007";18;"21.8";2447;45635;43188
582;"05.08.2007";19;"23.2";2748;47539;44791
582;"05.08.2007";20;25;2651;47830;45179
582;"05.08.2007";21;"23.9";2881;47114;44233
582;"05.08.2007";22;"23.7";3971;48160;44189
582;"05.08.2007";23;"25.2";4999;48111;43112
582;"05.08.2007";24;"23.6";5266;44183;38917
583;"06.08.2007";1;"23.1";5178;41154;35976
583;"06.08.2007";2;"19.3";4806;39616;34810
583;"06.08.2007";3;"17.1";4281;39023;34742
583;"06.08.2007";4;13;4067;39209;35142
583;"06.08.2007";5;"16.1";3796;40832;37036
583;"06.08.2007";6;"20.3";3689;44156;40467
583;"06.08.2007";7;"23.3";3735;51314;47579
583;"06.08.2007";8;28;3107;58486;55379
583;"06.08.2007";9;35;2042;62462;60420
583;"06.08.2007";10;"37.4";1951;63132;61181
583;"06.08.2007";11;41;2821;64109;61288
583;"06.08.2007";12;45;3300;65364;62064
583;"06.08.2007";13;43;3418;64580;61162
583;"06.08.2007";14;"40.1";3552;64168;60616
583;"06.08.2007";15;"37.5";3499;63303;59804
583;"06.08.2007";16;35;3416;62512;59096
583;"06.08.2007";17;33;3009;61919;58910
583;"06.08.2007";18;32;2593;61948;59355
583;"06.08.2007";19;"31.4";2504;62088;59584
583;"06.08.2007";20;"29.2";2300;60999;58699
583;"06.08.2007";21;28;2378;58215;55837
583;"06.08.2007";22;"28.4";2959;57596;54637
583;"06.08.2007";23;"26.6";3367;54598;51231
583;"06.08.2007";24;"24.5";3198;49850;46652
584;"07.08.2007";1;"24.1";2816;46618;43802
584;"07.08.2007";2;"17.2";2553;44916;42363
584;"07.08.2007";3;"15.1";2128;43935;41807
584;"07.08.2007";4;"14.1";1667;44001;42334
584;"07.08.2007";5;"16.9";1388;45061;43673
584;"07.08.2007";6;"23.2";1172;48205;47033
584;"07.08.2007";7;"21.1";1115;54879;53764
584;"07.08.2007";8;"29.5";835;60936;60101
584;"07.08.2007";9;"33.7";474;64295;63821
584;"07.08.2007";10;"36.2";451;66149;65698
584;"07.08.2007";11;40;555;67808;67253
584;"07.08.2007";12;46;712;69598;68886
584;"07.08.2007";13;"41.5";829;68754;67925
584;"07.08.2007";14;40;843;67968;67125
584;"07.08.2007";15;39;874;66879;66005
584;"07.08.2007";16;"35.1";990;66001;65011
584;"07.08.2007";17;"32.1";1386;64532;63146
584;"07.08.2007";18;"29.6";1786;63988;62202
584;"07.08.2007";19;"29.3";2169;62966;60797
584;"07.08.2007";20;"26.5";2242;61341;59099
584;"07.08.2007";21;"26.1";2613;58393;55780
584;"07.08.2007";22;26;2880;56935;54055
584;"07.08.2007";23;"25.3";2786;53781;50995
584;"07.08.2007";24;"22.1";2465;49042;46577
585;"08.08.2007";1;"24.4";2223;45658;43435
585;"08.08.2007";2;23;2292;44133;41841
585;"08.08.2007";3;"17.8";2400;43246;40846
585;"08.08.2007";4;"16.2";2365;43210;40845
585;"08.08.2007";5;"18.8";2325;44218;41893
585;"08.08.2007";6;"24.5";2318;47410;45092
585;"08.08.2007";7;25;2324;54976;52652
585;"08.08.2007";8;"32.1";2337;60881;58544
585;"08.08.2007";9;"37.4";2227;64809;62582
585;"08.08.2007";10;"40.1";2058;66235;64177
585;"08.08.2007";11;"41.8";2058;67910;65852
585;"08.08.2007";12;"50.7";2153;69346;67193
585;"08.08.2007";13;"42.9";2341;68076;65735
585;"08.08.2007";14;40;2154;66744;64590
585;"08.08.2007";15;"34.3";2196;65323;63127
585;"08.08.2007";16;"34.1";2600;63902;61302
585;"08.08.2007";17;33;2671;62242;59571
585;"08.08.2007";18;"30.5";2835;61773;58938
585;"08.08.2007";19;"31.1";2891;60792;57901
585;"08.08.2007";20;"27.7";2863;59345;56482
585;"08.08.2007";21;27;2764;57275;54511
585;"08.08.2007";22;"25.9";2570;56345;53775
585;"08.08.2007";23;"25.4";2418;52808;50390
585;"08.08.2007";24;21;2640;47893;45253
586;"09.08.2007";1;"20.6";2525;44723;42198
586;"09.08.2007";2;"16.5";2407;42516;40109
586;"09.08.2007";3;"13.6";2580;41572;38992
586;"09.08.2007";4;"10.4";2633;41647;39014
586;"09.08.2007";5;"10.4";2736;42419;39683
586;"09.08.2007";6;"18.6";2708;45822;43114
586;"09.08.2007";7;"24.1";2538;52982;50444
586;"09.08.2007";8;"27.4";2467;59160;56693
586;"09.08.2007";9;34;2076;63158;61082
586;"09.08.2007";10;"37.5";1948;64892;62944
586;"09.08.2007";11;"40.1";1925;66368;64443
586;"09.08.2007";12;52;2052;67592;65540
586;"09.08.2007";13;"43.9";2330;66308;63978
586;"09.08.2007";14;"33.1";2322;65029;62707
586;"09.08.2007";15;33;2514;64086;61572
586;"09.08.2007";16;"31.9";2771;63125;60354
586;"09.08.2007";17;"29.8";3190;61403;58213
586;"09.08.2007";18;"30.1";3470;60862;57392
586;"09.08.2007";19;"29.5";3512;60282;56770
586;"09.08.2007";20;"27.3";3578;58758;55180
586;"09.08.2007";21;"26.5";3278;56630;53352
586;"09.08.2007";22;"25.8";3146;55578;52432
586;"09.08.2007";23;24;2836;51974;49138
586;"09.08.2007";24;"18.1";2600;47345;44745
587;"10.08.2007";1;"23.9";2169;44367;42198
587;"10.08.2007";2;"20.8";1875;42679;40804
587;"10.08.2007";3;"17.3";1671;41549;39878
587;"10.08.2007";4;"11.3";1585;41535;39950
587;"10.08.2007";5;"17.1";1530;42692;41162
587;"10.08.2007";6;"23.2";1384;45754;44370
587;"10.08.2007";7;24;1358;52467;51109
587;"10.08.2007";8;30;1242;58708;57466
587;"10.08.2007";9;35;1203;62393;61190
587;"10.08.2007";10;40;1250;64039;62789
587;"10.08.2007";11;"43.9";1347;65653;64306
587;"10.08.2007";12;"51.5";1270;67089;65819
587;"10.08.2007";13;40;1352;65877;64525
587;"10.08.2007";14;"40.1";1433;63957;62524
587;"10.08.2007";15;"33.8";1594;62430;60836
587;"10.08.2007";16;30;1830;60830;59000
587;"10.08.2007";17;28;2137;59703;57566
587;"10.08.2007";18;28;2262;59468;57206
587;"10.08.2007";19;"30.1";2256;59205;56949
587;"10.08.2007";20;29;2302;57965;55663
587;"10.08.2007";21;"31.4";2247;55967;53720
587;"10.08.2007";22;"29.4";2381;55201;52820
587;"10.08.2007";23;"26.3";2581;52062;49481
587;"10.08.2007";24;"24.1";2628;47562;44934
588;"11.08.2007";1;"25.9";2525;44310;41785
588;"11.08.2007";2;"23.5";2548;41832;39284
588;"11.08.2007";3;"18.2";2893;40379;37486
588;"11.08.2007";4;"12.1";2974;40128;37154
588;"11.08.2007";5;"10.4";2985;40080;37095
588;"11.08.2007";6;14;3061;40804;37743
588;"11.08.2007";7;7;2920;41780;38860
588;"11.08.2007";8;"15.1";3073;45157;42084
588;"11.08.2007";9;"25.6";3240;48794;45554
588;"11.08.2007";10;"30.4";3270;51774;48504
588;"11.08.2007";11;"32.1";3452;53643;50191
588;"11.08.2007";12;"33.9";3467;54713;51246
588;"11.08.2007";13;"32.1";3480;53150;49670
588;"11.08.2007";14;"28.1";3691;50911;47220
588;"11.08.2007";15;"25.1";3617;49041;45424
588;"11.08.2007";16;"24.8";3572;47804;44232
588;"11.08.2007";17;"24.5";3277;47210;43933
588;"11.08.2007";18;"25.1";3013;47953;44940
588;"11.08.2007";19;"25.8";2717;48310;45593
588;"11.08.2007";20;25;2418;47867;45449
588;"11.08.2007";21;25;2093;46347;44254
588;"11.08.2007";22;"26.1";2073;46634;44561
588;"11.08.2007";23;"26.3";2101;44924;42823
588;"11.08.2007";24;"21.2";1910;41548;39638
589;"12.08.2007";1;19;1778;38838;37060
589;"12.08.2007";2;15;1531;36427;34896
589;"12.08.2007";3;"10.4";1400;35170;33770
589;"12.08.2007";4;"9.1";1337;34725;33388
589;"12.08.2007";5;"8.6";1227;34845;33618
589;"12.08.2007";6;10;1112;35053;33941
589;"12.08.2007";7;"6.1";1074;35107;34033
589;"12.08.2007";8;"10.4";1033;36977;35944
589;"12.08.2007";9;17;871;40273;39402
589;"12.08.2007";10;20;880;43106;42226
589;"12.08.2007";11;"22.1";850;45093;44243
589;"12.08.2007";12;"25.8";809;47369;46560
589;"12.08.2007";13;"25.1";689;46268;45579
589;"12.08.2007";14;"23.4";629;44035;43406
589;"12.08.2007";15;"22.3";518;42243;41725
589;"12.08.2007";16;21;500;41431;40931
589;"12.08.2007";17;22;576;41350;40774
589;"12.08.2007";18;"23.2";584;42865;42281
589;"12.08.2007";19;25;473;44523;44050
589;"12.08.2007";20;"25.9";385;45209;44824
589;"12.08.2007";21;27;326;45718;45392
589;"12.08.2007";22;"29.2";372;48057;47685
589;"12.08.2007";23;"31.1";382;46776;46394
589;"12.08.2007";24;25;352;43043;42691
590;"13.08.2007";1;"25.4";443;39901;39458
590;"13.08.2007";2;23;584;38239;37655
590;"13.08.2007";3;20;591;37579;36988
590;"13.08.2007";4;19;627;37679;37052
590;"13.08.2007";5;20;700;39009;38309
590;"13.08.2007";6;"23.5";782;42719;41937
590;"13.08.2007";7;"24.2";960;50412;49452
590;"13.08.2007";8;"34.1";965;57049;56084
590;"13.08.2007";9;42;834;60963;60129
590;"13.08.2007";10;"42.8";830;62324;61494
590;"13.08.2007";11;"46.4";1086;63646;62560
590;"13.08.2007";12;"52.6";1479;65291;63812
590;"13.08.2007";13;47;1634;64465;62831
590;"13.08.2007";14;"42.6";1634;63376;61742
590;"13.08.2007";15;"40.2";1709;61827;60118
590;"13.08.2007";16;"38.4";1809;60351;58542
590;"13.08.2007";17;"37.6";1592;58795;57203
590;"13.08.2007";18;"37.5";1599;58543;56944
590;"13.08.2007";19;"37.7";1370;58605;57235
590;"13.08.2007";20;"34.9";851;57843;56992
590;"13.08.2007";21;36;656;56179;55523
590;"13.08.2007";22;"34.7";610;56697;56087
590;"13.08.2007";23;"32.1";498;52758;52260
590;"13.08.2007";24;"25.4";428;47509;47081
591;"14.08.2007";1;"24.9";408;44401;43993
591;"14.08.2007";2;"23.1";486;42631;42145
591;"14.08.2007";3;"21.1";582;41783;41201
591;"14.08.2007";4;21;609;41993;41384
591;"14.08.2007";5;"22.1";611;43145;42534
591;"14.08.2007";6;"24.1";597;46427;45830
591;"14.08.2007";7;"24.4";582;53307;52725
591;"14.08.2007";8;"34.3";634;59068;58434
591;"14.08.2007";9;"41.8";466;62145;61679
591;"14.08.2007";10;"46.4";330;63265;62935
591;"14.08.2007";11;"52.1";438;64730;64292
591;"14.08.2007";12;"69.5";730;66657;65927
591;"14.08.2007";13;56;1150;65651;64501
591;"14.08.2007";14;"50.1";1454;64669;63215
591;"14.08.2007";15;"50.1";1773;63650;61877
591;"14.08.2007";16;"45.9";2180;62784;60604
591;"14.08.2007";17;"40.1";2352;61146;58794
591;"14.08.2007";18;"37.4";2455;60471;58016
591;"14.08.2007";19;"37.2";2300;59911;57611
591;"14.08.2007";20;"33.9";2082;58865;56783
591;"14.08.2007";21;"34.1";2535;57286;54751
591;"14.08.2007";22;"34.9";3906;57744;53838
591;"14.08.2007";23;"33.1";4928;53819;48891
591;"14.08.2007";24;25;5860;48672;42812
592;"15.08.2007";1;"23.2";6853;45815;38962
592;"15.08.2007";2;"21.1";7255;43984;36729
592;"15.08.2007";3;"17.7";7627;42938;35311
592;"15.08.2007";4;"10.1";7785;43206;35421
592;"15.08.2007";5;"9.2";7883;44004;36121
592;"15.08.2007";6;"18.6";7643;46744;39101
592;"15.08.2007";7;"11.9";7943;52113;44170
592;"15.08.2007";8;21;8063;57514;49451
592;"15.08.2007";9;24;8099;61345;53246
592;"15.08.2007";10;"25.5";8540;62801;54261
592;"15.08.2007";11;"27.9";9222;63693;54471
592;"15.08.2007";12;"34.9";9808;65235;55427
592;"15.08.2007";13;"28.1";9920;65095;55175
592;"15.08.2007";14;"26.1";9520;64759;55239
592;"15.08.2007";15;"24.7";9197;64200;55003
592;"15.08.2007";16;"24.6";8545;62896;54351
592;"15.08.2007";17;"23.1";7472;62050;54578
592;"15.08.2007";18;"24.5";6296;62083;55787
592;"15.08.2007";19;"24.5";5555;61899;56344
592;"15.08.2007";20;24;5082;60021;54939
592;"15.08.2007";21;"25.5";5025;58390;53365
592;"15.08.2007";22;"25.5";4845;57704;52859
592;"15.08.2007";23;"24.1";4623;53374;48751
592;"15.08.2007";24;"21.1";4822;48286;43464
593;"16.08.2007";1;"21.8";5374;45096;39722
593;"16.08.2007";2;"10.4";5916;43106;37190
593;"16.08.2007";3;"10.3";6221;41645;35424
593;"16.08.2007";4;"9.6";6079;41432;35353
593;"16.08.2007";5;"10.3";6049;42780;36731
593;"16.08.2007";6;"16.1";5200;45906;40706
593;"16.08.2007";7;"22.6";5350;53084;47734
593;"16.08.2007";8;"26.3";5806;58325;52519
593;"16.08.2007";9;31;6140;61897;55757
593;"16.08.2007";10;"35.3";6893;63092;56199
593;"16.08.2007";11;"36.9";7545;63969;56424
593;"16.08.2007";12;"43.8";8128;65604;57476
593;"16.08.2007";13;"37.7";8760;63971;55211
593;"16.08.2007";14;"35.8";9272;62540;53268
593;"16.08.2007";15;"35.9";9577;60999;51422
593;"16.08.2007";16;34;9754;59753;49999
593;"16.08.2007";17;"32.2";9317;58362;49045
593;"16.08.2007";18;"32.9";9673;57961;48288
593;"16.08.2007";19;35;8008;57621;49613
593;"16.08.2007";20;"32.9";6185;56859;50674
593;"16.08.2007";21;"37.5";5098;55442;50344
593;"16.08.2007";22;"35.1";4487;55000;50513
593;"16.08.2007";23;"29.6";4223;51587;47364
593;"16.08.2007";24;"23.1";3994;46612;42618
594;"17.08.2007";1;"24.6";3727;43168;39441
594;"17.08.2007";2;"23.3";3512;41327;37815
594;"17.08.2007";3;"21.3";3356;40345;36989
594;"17.08.2007";4;"23.1";3197;40496;37299
594;"17.08.2007";5;"23.2";3106;41743;38637
594;"17.08.2007";6;"27.1";2989;45124;42135
594;"17.08.2007";7;"29.9";2917;51385;48468
594;"17.08.2007";8;"37.4";2734;57255;54521
594;"17.08.2007";9;"41.7";2699;60689;57990
594;"17.08.2007";10;"42.1";2918;61709;58791
594;"17.08.2007";11;50;3530;62935;59405
594;"17.08.2007";12;"58.3";3909;63733;59824
594;"17.08.2007";13;"42.3";4364;62443;58079
594;"17.08.2007";14;"41.7";4682;60447;55765
594;"17.08.2007";15;"35.9";4835;58910;54075
594;"17.08.2007";16;"33.8";4511;57383;52872
594;"17.08.2007";17;"31.9";4072;56834;52762
594;"17.08.2007";18;"31.7";3826;56870;53044
594;"17.08.2007";19;31;2945;56781;53836
594;"17.08.2007";20;"29.9";2351;55531;53180
594;"17.08.2007";21;"34.9";1674;54438;52764
594;"17.08.2007";22;"34.2";1810;54253;52443
594;"17.08.2007";23;"29.6";2085;51027;48942
594;"17.08.2007";24;26;2100;46558;44458
595;"18.08.2007";1;"24.9";2267;43395;41128
595;"18.08.2007";2;"19.1";2054;41300;39246
595;"18.08.2007";3;"19.9";1954;40349;38395
595;"18.08.2007";4;"20.8";1774;40077;38303
595;"18.08.2007";5;"20.1";1700;40353;38653
595;"18.08.2007";6;"19.9";1580;41307;39727
595;"18.08.2007";7;"20.1";1450;42664;41214
595;"18.08.2007";8;26;1142;45794;44652
595;"18.08.2007";9;"25.1";611;49516;48905
595;"18.08.2007";10;"27.7";355;51937;51582
595;"18.08.2007";11;"32.1";532;53490;52958
595;"18.08.2007";12;"34.9";800;54302;53502
595;"18.08.2007";13;"31.2";816;52918;52102
595;"18.08.2007";14;"27.7";760;51057;50297
595;"18.08.2007";15;"29.2";604;49844;49240
595;"18.08.2007";16;27;541;49499;48958
595;"18.08.2007";17;"25.6";411;49075;48664
595;"18.08.2007";18;"26.3";351;50074;49723
595;"18.08.2007";19;"25.8";268;50444;50176
595;"18.08.2007";20;"25.5";247;49402;49155
595;"18.08.2007";21;"28.3";292;48294;48002
595;"18.08.2007";22;"28.5";455;48669;48214
595;"18.08.2007";23;"25.6";889;46440;45551
595;"18.08.2007";24;"21.2";1396;43258;41862
596;"19.08.2007";1;"23.8";1782;40449;38667
596;"19.08.2007";2;"20.8";1949;38181;36232
596;"19.08.2007";3;"17.9";1961;36981;35020
596;"19.08.2007";4;"16.1";1926;36401;34475
596;"19.08.2007";5;15;1881;36170;34289
596;"19.08.2007";6;"15.5";1922;36625;34703
596;"19.08.2007";7;"11.3";1987;36358;34371
596;"19.08.2007";8;"19.4";1803;38057;36254
596;"19.08.2007";9;21;1315;41450;40135
596;"19.08.2007";10;"23.4";873;43912;43039
596;"19.08.2007";11;"24.9";704;46114;45410
596;"19.08.2007";12;"27.1";869;48367;47498
596;"19.08.2007";13;"26.1";1168;47262;46094
596;"19.08.2007";14;"24.1";1266;45178;43912
596;"19.08.2007";15;"22.9";1287;43769;42482
596;"19.08.2007";16;"21.9";1324;43030;41706
596;"19.08.2007";17;"22.6";1299;42960;41661
596;"19.08.2007";18;24;1135;44850;43715
596;"19.08.2007";19;"25.7";1251;46687;45436
596;"19.08.2007";20;"26.2";1167;47132;45965
596;"19.08.2007";21;"28.6";1442;47581;46139
596;"19.08.2007";22;"31.4";1965;47946;45981
596;"19.08.2007";23;"30.1";2220;46464;44244
596;"19.08.2007";24;"25.1";2436;42833;40397
597;"20.08.2007";1;"20.9";2457;40318;37861
597;"20.08.2007";2;"18.2";2323;38855;36532
597;"20.08.2007";3;"14.7";2056;38161;36105
597;"20.08.2007";4;"11.7";1923;38629;36706
597;"20.08.2007";5;"16.3";1766;40312;38546
597;"20.08.2007";6;"22.3";1645;44558;42913
597;"20.08.2007";7;"24.5";1805;52783;50978
597;"20.08.2007";8;"34.5";1665;59587;57922
597;"20.08.2007";9;"42.1";1296;63605;62309
597;"20.08.2007";10;50;1305;65494;64189
597;"20.08.2007";11;"55.1";1512;67288;65776
597;"20.08.2007";12;75;1632;68949;67317
597;"20.08.2007";13;58;1710;67909;66199
597;"20.08.2007";14;55;1651;66966;65315
597;"20.08.2007";15;50;1634;65742;64108
597;"20.08.2007";16;"42.1";1621;64897;63276
597;"20.08.2007";17;42;1389;63716;62327
597;"20.08.2007";18;42;1299;63014;61715
597;"20.08.2007";19;"37.8";1136;62333;61197
597;"20.08.2007";20;"37.5";896;61941;61045
597;"20.08.2007";21;35;667;60905;60238
597;"20.08.2007";22;"31.9";630;59733;59103
597;"20.08.2007";23;"27.6";644;55390;54746
597;"20.08.2007";24;"24.2";671;50228;49557
598;"21.08.2007";1;"24.3";854;46705;45851
598;"21.08.2007";2;"20.2";952;44558;43606
598;"21.08.2007";3;"17.9";1016;43322;42306
598;"21.08.2007";4;20;1164;43367;42203
598;"21.08.2007";5;13;1551;44285;42734
598;"21.08.2007";6;"23.1";1814;47770;45956
598;"21.08.2007";7;25;2188;54783;52595
598;"21.08.2007";8;"33.6";2352;60588;58236
598;"21.08.2007";9;"42.1";2490;64176;61686
598;"21.08.2007";10;47;2945;65490;62545
598;"21.08.2007";11;50;3532;67050;63518
598;"21.08.2007";12;"60.1";3892;68625;64733
598;"21.08.2007";13;"45.1";4297;67589;63292
598;"21.08.2007";14;41;4780;67029;62249
598;"21.08.2007";15;"38.1";5172;65950;60778
598;"21.08.2007";16;35;5580;64946;59366
598;"21.08.2007";17;32;5898;63437;57539
598;"21.08.2007";18;"30.8";6659;63493;56834
598;"21.08.2007";19;"31.4";6316;63080;56764
598;"21.08.2007";20;"29.1";6252;62158;55906
598;"21.08.2007";21;"28.9";5879;61327;55448
598;"21.08.2007";22;"27.9";5316;59252;53936
598;"21.08.2007";23;"25.4";4826;54847;50021
598;"21.08.2007";24;"19.8";4899;49794;44895
599;"22.08.2007";1;"13.1";4878;46340;41462
599;"22.08.2007";2;12;4726;44361;39635
599;"22.08.2007";3;"11.1";4668;43222;38554
599;"22.08.2007";4;"11.1";4368;43278;38910
599;"22.08.2007";5;"10.4";4111;44443;40332
599;"22.08.2007";6;21;3806;48198;44392
599;"22.08.2007";7;"23.5";3662;55568;51906
599;"22.08.2007";8;"29.7";3434;61606;58172
599;"22.08.2007";9;"34.7";2789;64944;62155
599;"22.08.2007";10;40;2471;66033;63562
599;"22.08.2007";11;"45.1";2252;67730;65478
599;"22.08.2007";12;55;1977;69606;67629
599;"22.08.2007";13;"48.1";1943;68278;66335
599;"22.08.2007";14;"47.1";1803;67823;66020
599;"22.08.2007";15;"45.6";1683;66701;65018
599;"22.08.2007";16;"42.1";1608;65732;64124
599;"22.08.2007";17;"38.4";1563;64450;62887
599;"22.08.2007";18;"35.9";1144;63584;62440
599;"22.08.2007";19;34;775;63266;62491
599;"22.08.2007";20;"32.1";743;62428;61685
599;"22.08.2007";21;"34.1";713;62289;61576
599;"22.08.2007";22;"34.1";683;61204;60521
599;"22.08.2007";23;"31.6";632;56902;56270
599;"22.08.2007";24;"25.5";631;51525;50894
600;"23.08.2007";1;25;660;47627;46967
600;"23.08.2007";2;"23.4";603;45526;44923
600;"23.08.2007";3;"19.9";595;44339;43744
600;"23.08.2007";4;"18.9";638;44590;43952
600;"23.08.2007";5;20;707;45406;44699
600;"23.08.2007";6;24;808;49042;48234
600;"23.08.2007";7;"24.8";846;56542;55696
600;"23.08.2007";8;"30.2";760;62451;61691
600;"23.08.2007";9;"38.4";634;65899;65265
600;"23.08.2007";10;"39.1";505;67050;66545
600;"23.08.2007";11;"41.7";515;68430;67915
600;"23.08.2007";12;"51.1";527;69761;69234
600;"23.08.2007";13;"42.3";529;68048;67519
600;"23.08.2007";14;43;568;67040;66472
600;"23.08.2007";15;40;530;65720;65190
600;"23.08.2007";16;"40.1";498;64907;64409
600;"23.08.2007";17;37;562;63553;62991
600;"23.08.2007";18;"35.6";602;63029;62427
600;"23.08.2007";19;"33.4";635;62312;61677
600;"23.08.2007";20;"32.7";690;61483;60793
600;"23.08.2007";21;35;603;61133;60530
600;"23.08.2007";22;"32.9";679;59482;58803
600;"23.08.2007";23;"28.8";762;55026;54264
600;"23.08.2007";24;"22.6";678;49959;49281
601;"24.08.2007";1;"25.9";734;46502;45768
601;"24.08.2007";2;"23.2";670;44774;44104
601;"24.08.2007";3;"22.1";809;43451;42642
601;"24.08.2007";4;"20.9";832;43314;42482
601;"24.08.2007";5;"22.4";889;44056;43167
601;"24.08.2007";6;"24.9";998;47967;46969
601;"24.08.2007";7;"25.1";917;55112;54195
601;"24.08.2007";8;40;685;60759;60074
601;"24.08.2007";9;"42.3";568;63865;63297
601;"24.08.2007";10;"47.1";462;65073;64611
601;"24.08.2007";11;"47.2";541;66088;65547
601;"24.08.2007";12;"67.9";540;66958;66418
601;"24.08.2007";13;48;602;65594;64992
601;"24.08.2007";14;"44.8";786;64131;63345
601;"24.08.2007";15;"40.5";865;62540;61675
601;"24.08.2007";16;"39.2";976;61231;60255
601;"24.08.2007";17;"36.2";881;60097;59216
601;"24.08.2007";18;"36.7";813;60310;59497
601;"24.08.2007";19;36;757;60182;59425
601;"24.08.2007";20;"34.4";658;59242;58584
601;"24.08.2007";21;"38.5";655;58582;57927
601;"24.08.2007";22;42;753;58062;57309
601;"24.08.2007";23;"42.1";758;53997;53239
601;"24.08.2007";24;"31.4";721;49765;49044
602;"25.08.2007";1;"27.8";687;46267;45580
602;"25.08.2007";2;"25.4";730;43786;43056
602;"25.08.2007";3;"23.2";798;42179;41381
602;"25.08.2007";4;"22.1";954;41543;40589
602;"25.08.2007";5;"21.6";1049;41550;40501
602;"25.08.2007";6;"23.6";1222;42614;41392
602;"25.08.2007";7;"23.2";1294;43771;42477
602;"25.08.2007";8;23;1164;47541;46377
602;"25.08.2007";9;"26.9";939;51354;50415
602;"25.08.2007";10;"32.3";1006;54230;53224
602;"25.08.2007";11;37;1363;55459;54096
602;"25.08.2007";12;"37.2";1783;55438;53655
602;"25.08.2007";13;"32.9";2271;53594;51323
602;"25.08.2007";14;29;2918;51196;48278
602;"25.08.2007";15;"24.1";3315;49321;46006
602;"25.08.2007";16;"24.6";3570;48629;45059
602;"25.08.2007";17;"23.2";3689;48135;44446
602;"25.08.2007";18;"24.6";3414;48990;45576
602;"25.08.2007";19;28;2962;49452;46490
602;"25.08.2007";20;"28.1";2420;49026;46606
602;"25.08.2007";21;"29.4";1957;48547;46590
602;"25.08.2007";22;"29.1";1939;48462;46523
602;"25.08.2007";23;"28.4";2022;46330;44308
602;"25.08.2007";24;"24.5";1900;43147;41247
603;"26.08.2007";1;"21.4";2067;40078;38011
603;"26.08.2007";2;"18.8";2265;38084;35819
603;"26.08.2007";3;15;2333;37314;34981
603;"26.08.2007";4;"10.3";2495;36529;34034
603;"26.08.2007";5;"10.3";2880;36262;33382
603;"26.08.2007";6;"9.8";3199;36608;33409
603;"26.08.2007";7;"8.3";3216;36454;33238
603;"26.08.2007";8;"10.4";3133;38444;35311
603;"26.08.2007";9;"17.9";2934;41893;38959
603;"26.08.2007";10;"23.9";3233;44371;41138
603;"26.08.2007";11;"25.1";3722;46395;42673
603;"26.08.2007";12;"27.9";4159;48413;44254
603;"26.08.2007";13;"26.9";4676;47181;42505
603;"26.08.2007";14;"22.1";5086;44604;39518
603;"26.08.2007";15;"20.8";5882;42978;37096
603;"26.08.2007";16;"18.1";6047;41918;35871
603;"26.08.2007";17;"18.7";5762;41708;35946
603;"26.08.2007";18;"22.5";5479;43255;37776
603;"26.08.2007";19;"25.1";4471;45417;40946
603;"26.08.2007";20;"27.7";3609;46309;42700
603;"26.08.2007";21;27;2990;48005;45015
603;"26.08.2007";22;28;2613;49121;46508
603;"26.08.2007";23;"27.1";2524;47290;44766
603;"26.08.2007";24;"22.2";2534;43976;41442
604;"27.08.2007";1;"21.5";2649;41165;38516
604;"27.08.2007";2;"18.8";2433;39757;37324
604;"27.08.2007";3;"11.6";2380;39070;36690
604;"27.08.2007";4;"11.2";2267;39335;37068
604;"27.08.2007";5;"18.3";2134;40577;38443
604;"27.08.2007";6;"22.5";2002;44945;42943
604;"27.08.2007";7;"24.7";1886;53704;51818
604;"27.08.2007";8;"33.2";1756;60376;58620
604;"27.08.2007";9;42;1550;63778;62228
604;"27.08.2007";10;"42.1";1714;64690;62976
604;"27.08.2007";11;"44.8";2259;65933;63674
604;"27.08.2007";12;"56.1";2685;67341;64656
604;"27.08.2007";13;"45.9";2992;66872;63880
604;"27.08.2007";14;44;3545;65903;62358
604;"27.08.2007";15;"42.1";3647;64465;60818
604;"27.08.2007";16;40;3912;63420;59508
604;"27.08.2007";17;37;4315;61816;57501
604;"27.08.2007";18;"36.3";4302;61455;57153
604;"27.08.2007";19;37;3939;61166;57227
604;"27.08.2007";20;"35.3";3411;60919;57508
604;"27.08.2007";21;"34.2";3083;61299;58216
604;"27.08.2007";22;"32.1";3196;59644;56448
604;"27.08.2007";23;"29.6";3383;55038;51655
604;"27.08.2007";24;"24.6";3071;50228;47157
605;"28.08.2007";1;"23.2";2973;46723;43750
605;"28.08.2007";2;"21.3";2817;45369;42552
605;"28.08.2007";3;"18.2";2628;44562;41934
605;"28.08.2007";4;"15.3";2375;44460;42085
605;"28.08.2007";5;15;2196;45475;43279
605;"28.08.2007";6;"24.7";2158;48961;46803
605;"28.08.2007";7;"29.6";2103;56747;54644
605;"28.08.2007";8;"39.7";1740;62255;60515
605;"28.08.2007";9;42;1357;64921;63564
605;"28.08.2007";10;45;1624;65393;63769
605;"28.08.2007";11;"48.1";2202;66563;64361
605;"28.08.2007";12;"59.3";2278;68077;65799
605;"28.08.2007";13;"50.1";2426;66926;64500
605;"28.08.2007";14;"49.2";2329;65783;63454
605;"28.08.2007";15;"46.7";2318;64490;62172
605;"28.08.2007";16;"43.1";2485;63232;60747
605;"28.08.2007";17;"42.1";2252;62004;59752
605;"28.08.2007";18;42;2152;62148;59996
605;"28.08.2007";19;40;1856;61572;59716
605;"28.08.2007";20;36;1276;61122;59846
605;"28.08.2007";21;"40.1";1153;61184;60031
605;"28.08.2007";22;"39.6";1242;59139;57897
605;"28.08.2007";23;"33.8";1199;54524;53325
605;"28.08.2007";24;"25.3";1109;49397;48288
606;"29.08.2007";1;26;1160;46438;45278
606;"29.08.2007";2;"23.9";1211;44913;43702
606;"29.08.2007";3;"23.5";1094;44132;43038
606;"29.08.2007";4;"23.4";956;44679;43723
606;"29.08.2007";5;"23.2";980;46170;45190
606;"29.08.2007";6;26;896;50299;49403
606;"29.08.2007";7;"32.7";967;57885;56918
606;"29.08.2007";8;39;1003;63592;62589
606;"29.08.2007";9;"45.4";642;66766;66124
606;"29.08.2007";10;"44.9";547;67878;67331
606;"29.08.2007";11;"50.1";664;69452;68788
606;"29.08.2007";12;"75.1";811;70756;69945
606;"29.08.2007";13;"50.1";952;69445;68493
606;"29.08.2007";14;47;1168;68355;67187
606;"29.08.2007";15;"45.1";1287;67016;65729
606;"29.08.2007";16;"42.1";1350;65797;64447
606;"29.08.2007";17;"37.5";1507;63753;62246
606;"29.08.2007";18;"34.1";1621;62982;61361
606;"29.08.2007";19;33;1466;62437;60971
606;"29.08.2007";20;"30.7";1208;62006;60798
606;"29.08.2007";21;"39.7";1173;61874;60701
606;"29.08.2007";22;36;1247;59817;58570
606;"29.08.2007";23;30;1180;55370;54190
606;"29.08.2007";24;"25.1";1256;50350;49094
607;"30.08.2007";1;"25.1";1372;46960;45588
607;"30.08.2007";2;"22.1";1459;45041;43582
607;"30.08.2007";3;"18.5";1584;44362;42778
607;"30.08.2007";4;"17.1";1639;44348;42709
607;"30.08.2007";5;"15.1";1899;45506;43607
607;"30.08.2007";6;"23.1";2052;49299;47247
607;"30.08.2007";7;"24.5";2020;57087;55067
607;"30.08.2007";8;"36.3";1983;62622;60639
607;"30.08.2007";9;"42.3";1648;65671;64023
607;"30.08.2007";10;"45.6";1481;66470;64989
607;"30.08.2007";11;"49.1";1869;67661;65792
607;"30.08.2007";12;"54.1";2670;69309;66639
607;"30.08.2007";13;"46.1";3479;68052;64573
607;"30.08.2007";14;"44.4";4146;67516;63370
607;"30.08.2007";15;"42.3";5032;66814;61782
607;"30.08.2007";16;"41.1";5529;65667;60138
607;"30.08.2007";17;"38.9";5840;64023;58183
607;"30.08.2007";18;"35.5";6324;63475;57151
607;"30.08.2007";19;35;6376;63288;56912
607;"30.08.2007";20;"30.9";6018;62607;56589
607;"30.08.2007";21;39;5632;62920;57288
607;"30.08.2007";22;"35.7";5525;60702;55177
607;"30.08.2007";23;"30.5";5362;56485;51123
607;"30.08.2007";24;"24.9";5012;51713;46701
608;"31.08.2007";1;"23.1";4523;48698;44175
608;"31.08.2007";2;19;4166;46719;42553
608;"31.08.2007";3;17;3901;45751;41850
608;"31.08.2007";4;"14.1";3568;45783;42215
608;"31.08.2007";5;"16.3";3294;46810;43516
608;"31.08.2007";6;"24.8";3276;50619;47343
608;"31.08.2007";7;"26.1";2920;58558;55638
608;"31.08.2007";8;"32.1";2589;64123;61534
608;"31.08.2007";9;"35.1";2576;67175;64599
608;"31.08.2007";10;"39.1";2500;67923;65423
608;"31.08.2007";11;"42.1";3015;68807;65792
608;"31.08.2007";12;45;3631;69698;66067
608;"31.08.2007";13;42;4126;68089;63963
608;"31.08.2007";14;38;4650;66287;61637
608;"31.08.2007";15;"32.8";5439;64420;58981
608;"31.08.2007";16;"29.2";5859;62985;57126
608;"31.08.2007";17;"27.1";5887;62258;56371
608;"31.08.2007";18;27;5357;62305;56948
608;"31.08.2007";19;"26.4";5379;61628;56249
608;"31.08.2007";20;"26.1";5210;60403;55193
608;"31.08.2007";21;"27.2";5053;60081;55028
608;"31.08.2007";22;"25.1";5020;56806;51786
608;"31.08.2007";23;"25.8";5048;52951;47903
608;"31.08.2007";24;"24.2";4906;48959;44053
609;"01.09.2007";1;"21.1";4682;47231;42549
609;"01.09.2007";2;"19.4";4545;44883;40338
609;"01.09.2007";3;"18.1";4346;43543;39197
609;"01.09.2007";4;"15.1";4029;43022;38993
609;"01.09.2007";5;"11.1";3833;42949;39116
609;"01.09.2007";6;15;3496;43658;40162
609;"01.09.2007";7;"10.7";3336;45803;42467
609;"01.09.2007";8;14;2932;49143;46211
609;"01.09.2007";9;"22.9";2617;52908;50291
609;"01.09.2007";10;"24.8";2635;55829;53194
609;"01.09.2007";11;27;2847;57491;54644
609;"01.09.2007";12;"29.1";2757;58637;55880
609;"01.09.2007";13;"25.1";2782;57120;54338
609;"01.09.2007";14;"25.4";2915;54575;51660
609;"01.09.2007";15;"23.8";2902;52775;49873
609;"01.09.2007";16;24;2894;51935;49041
609;"01.09.2007";17;"23.1";2679;50914;48235
609;"01.09.2007";18;"23.1";2276;51680;49404
609;"01.09.2007";19;"24.1";1736;52497;50761
609;"01.09.2007";20;24;1292;52434;51142
609;"01.09.2007";21;"23.1";1273;52292;51019
609;"01.09.2007";22;"21.1";1439;50298;48859
609;"01.09.2007";23;22;1609;48234;46625
609;"01.09.2007";24;"14.5";1720;44856;43136
610;"02.09.2007";1;"18.1";1852;41543;39691
610;"02.09.2007";2;"16.9";2092;39408;37316
610;"02.09.2007";3;"11.5";2200;38330;36130
610;"02.09.2007";4;"9.1";2336;37645;35309
610;"02.09.2007";5;"9.2";2553;37817;35264
610;"02.09.2007";6;"9.4";2715;38314;35599
610;"02.09.2007";7;"5.1";2874;38658;35784
610;"02.09.2007";8;"9.2";2995;40181;37186
610;"02.09.2007";9;16;2919;43602;40683
610;"02.09.2007";10;"18.7";3063;46624;43561
610;"02.09.2007";11;"20.1";3771;49149;45378
610;"02.09.2007";12;23;4709;51832;47123
610;"02.09.2007";13;"22.1";5452;51353;45901
610;"02.09.2007";14;"20.5";5911;49163;43252
610;"02.09.2007";15;"19.1";6181;47557;41376
610;"02.09.2007";16;"17.1";5860;46416;40556
610;"02.09.2007";17;"16.1";5691;45934;40243
610;"02.09.2007";18;"19.2";5568;47681;42113
610;"02.09.2007";19;22;5305;49545;44240
610;"02.09.2007";20;"23.1";5194;50555;45361
610;"02.09.2007";21;"24.4";5539;52865;47326
610;"02.09.2007";22;"24.2";5906;51969;46063
610;"02.09.2007";23;23;6630;50520;43890
610;"02.09.2007";24;"19.1";6236;46859;40623
611;"03.09.2007";1;"14.7";5878;44266;38388
611;"03.09.2007";2;"10.8";5498;42654;37156
611;"03.09.2007";3;"8.7";4770;41817;37047
611;"03.09.2007";4;"7.6";4521;41845;37324
611;"03.09.2007";5;"9.3";4070;43249;39179
611;"03.09.2007";6;"17.7";3741;47773;44032
611;"03.09.2007";7;"23.1";3664;57037;53373
611;"03.09.2007";8;"33.5";3729;63195;59466
611;"03.09.2007";9;41;3474;66558;63084
611;"03.09.2007";10;"42.8";3278;67379;64101
611;"03.09.2007";11;"43.4";3507;68963;65456
611;"03.09.2007";12;"50.3";4069;70856;66787
611;"03.09.2007";13;"43.3";4550;69983;65433
611;"03.09.2007";14;"42.1";5020;69268;64248
611;"03.09.2007";15;"40.7";5693;67893;62200
611;"03.09.2007";16;38;6315;66694;60379
611;"03.09.2007";17;"35.1";6222;64871;58649
611;"03.09.2007";18;"34.1";6917;64766;57849
611;"03.09.2007";19;35;6338;64375;58037
611;"03.09.2007";20;34;5248;63676;58428
611;"03.09.2007";21;"32.6";4978;63689;58711
611;"03.09.2007";22;"27.9";4785;60286;55501
611;"03.09.2007";23;"25.3";5033;56387;51354
611;"03.09.2007";24;"21.6";4966;50937;45971
612;"04.09.2007";1;22;4788;47224;42436
612;"04.09.2007";2;"22.5";4846;45740;40894
612;"04.09.2007";3;"20.9";5008;44513;39505
612;"04.09.2007";4;16;5384;44987;39603
612;"04.09.2007";5;"10.7";5404;46227;40823
612;"04.09.2007";6;"24.7";5698;50041;44343
612;"04.09.2007";7;"27.7";5333;57525;52192
612;"04.09.2007";8;"38.9";5257;62884;57627
612;"04.09.2007";9;"45.6";5083;65732;60649
612;"04.09.2007";10;"44.3";5404;66373;60969
612;"04.09.2007";11;"46.3";6140;67799;61659
612;"04.09.2007";12;"51.6";6851;69074;62223
612;"04.09.2007";13;"45.1";7372;67900;60528
612;"04.09.2007";14;43;7641;66866;59225
612;"04.09.2007";15;"42.1";7821;65543;57722
612;"04.09.2007";16;"40.1";8031;64320;56289
612;"04.09.2007";17;"36.1";7699;63030;55331
612;"04.09.2007";18;35;7407;62534;55127
612;"04.09.2007";19;"36.9";6391;62210;55819
612;"04.09.2007";20;"40.9";5759;62198;56439
612;"04.09.2007";21;"42.5";5186;62924;57738
612;"04.09.2007";22;36;5029;60339;55310
612;"04.09.2007";23;"32.1";5072;56074;51002
612;"04.09.2007";24;27;4602;50585;45983
613;"05.09.2007";1;"21.7";3964;46726;42762
613;"05.09.2007";2;20;3940;44888;40948
613;"05.09.2007";3;"19.1";3703;43830;40127
613;"05.09.2007";4;23;3542;44256;40714
613;"05.09.2007";5;"22.9";3502;45796;42294
613;"05.09.2007";6;"25.7";3085;49387;46302
613;"05.09.2007";7;34;2919;57503;54584
613;"05.09.2007";8;"42.5";2434;62520;60086
613;"05.09.2007";9;"43.3";1622;65189;63567
613;"05.09.2007";10;"43.3";1335;65684;64349
613;"05.09.2007";11;"46.1";1247;66867;65620
613;"05.09.2007";12;"48.6";1388;68470;67082
613;"05.09.2007";13;"45.2";1429;67505;66076
613;"05.09.2007";14;"46.1";1380;67101;65721
613;"05.09.2007";15;"48.3";1451;65713;64262
613;"05.09.2007";16;"45.1";1615;64297;62682
613;"05.09.2007";17;"42.2";1882;62601;60719
613;"05.09.2007";18;"39.6";2067;62738;60671
613;"05.09.2007";19;40;1918;62564;60646
613;"05.09.2007";20;39;1835;63158;61323
613;"05.09.2007";21;41;1954;63786;61832
613;"05.09.2007";22;35;2159;60401;58242
613;"05.09.2007";23;"31.1";2188;56044;53856
613;"05.09.2007";24;26;2260;50364;48104
614;"06.09.2007";1;27;2272;46885;44613
614;"06.09.2007";2;"22.6";1983;44933;42950
614;"06.09.2007";3;24;1717;44289;42572
614;"06.09.2007";4;"22.8";1740;44116;42376
614;"06.09.2007";5;"21.5";1833;44711;42878
614;"06.09.2007";6;"24.7";1785;49192;47407
614;"06.09.2007";7;"28.1";1681;57222;55541
614;"06.09.2007";8;"39.4";1660;63031;61371
614;"06.09.2007";9;"43.6";1439;66216;64777
614;"06.09.2007";10;"42.1";1571;67056;65485
614;"06.09.2007";11;"48.3";1948;68567;66619
614;"06.09.2007";12;"54.3";2341;70479;68138
614;"06.09.2007";13;49;2768;69078;66310
614;"06.09.2007";14;"47.9";3183;68378;65195
614;"06.09.2007";15;"43.9";3777;67033;63256
614;"06.09.2007";16;"41.3";4166;65637;61471
614;"06.09.2007";17;"39.3";4640;64437;59797
614;"06.09.2007";18;"37.1";4516;64155;59639
614;"06.09.2007";19;37;4074;64122;60048
614;"06.09.2007";20;37;3703;64078;60375
614;"06.09.2007";21;"37.8";3628;64297;60669
614;"06.09.2007";22;"34.1";3894;60973;57079
614;"06.09.2007";23;"31.1";4454;57042;52588
614;"06.09.2007";24;26;4314;51837;47523
615;"07.09.2007";1;"25.2";4340;48425;44085
615;"07.09.2007";2;"23.5";4071;46413;42342
615;"07.09.2007";3;"21.1";3791;45426;41635
615;"07.09.2007";4;"20.1";3551;45758;42207
615;"07.09.2007";5;"20.8";3483;46849;43366
615;"07.09.2007";6;"26.6";3450;50690;47240
615;"07.09.2007";7;"29.6";3451;59001;55550
615;"07.09.2007";8;"41.8";3088;64058;60970
615;"07.09.2007";9;"48.8";2935;67394;64459
615;"07.09.2007";10;"49.3";3548;68168;64620
615;"07.09.2007";11;55;3979;69363;65384
615;"07.09.2007";12;"53.3";4133;70583;66450
615;"07.09.2007";13;"48.1";4456;69033;64577
615;"07.09.2007";14;"41.6";4712;67059;62347
615;"07.09.2007";15;"37.5";5143;65638;60495
615;"07.09.2007";16;"38.9";5249;64438;59189
615;"07.09.2007";17;"35.1";5537;63439;57902
615;"07.09.2007";18;"39.6";5281;63546;58265
615;"07.09.2007";19;41;4676;63203;58527
615;"07.09.2007";20;"40.5";3912;62928;59016
615;"07.09.2007";21;43;3669;63012;59343
615;"07.09.2007";22;36;3721;59174;55453
615;"07.09.2007";23;"27.3";3851;56060;52209
615;"07.09.2007";24;24;3595;51730;48135
616;"08.09.2007";1;34;3471;47817;44346
616;"08.09.2007";2;"27.4";3260;45279;42019
616;"08.09.2007";3;"25.7";3087;44217;41130
616;"08.09.2007";4;"23.1";2815;43903;41088
616;"08.09.2007";5;"22.4";2633;44304;41671
616;"08.09.2007";6;23;2754;44976;42222
616;"08.09.2007";7;"23.6";2947;46753;43806
616;"08.09.2007";8;"28.1";2981;49662;46681
616;"08.09.2007";9;"34.5";3223;53935;50712
616;"08.09.2007";10;"43.9";3480;56760;53280
616;"08.09.2007";11;"42.9";3814;58656;54842
616;"08.09.2007";12;"43.7";4507;59818;55311
616;"08.09.2007";13;38;5050;58408;53358
616;"08.09.2007";14;"33.9";5854;56290;50436
616;"08.09.2007";15;"30.4";6461;54941;48480
616;"08.09.2007";16;"27.6";7418;54515;47097
616;"08.09.2007";17;"27.3";7570;53988;46418
616;"08.09.2007";18;28;7764;54849;47085
616;"08.09.2007";19;"28.1";8289;56024;47735
616;"08.09.2007";20;"30.3";8479;56671;48192
616;"08.09.2007";21;28;8860;56877;48017
616;"08.09.2007";22;"23.1";8955;54407;45452
616;"08.09.2007";23;"22.1";8816;51855;43039
616;"08.09.2007";24;"13.3";8242;47938;39696
617;"09.09.2007";1;"22.1";8180;44671;36491
617;"09.09.2007";2;"14.1";8057;42563;34506
617;"09.09.2007";3;"10.4";7502;40955;33453
617;"09.09.2007";4;"9.4";7261;40771;33510
617;"09.09.2007";5;"9.3";6789;40773;33984
617;"09.09.2007";6;"10.1";6412;40926;34514
617;"09.09.2007";7;"10.1";6026;40888;34862
617;"09.09.2007";8;"14.6";5759;42363;36604
617;"09.09.2007";9;"16.2";5702;45666;39964
617;"09.09.2007";10;"21.4";5739;48386;42647
617;"09.09.2007";11;24;6384;51177;44793
617;"09.09.2007";12;"26.9";6449;53685;47236
617;"09.09.2007";13;25;6278;52709;46431
617;"09.09.2007";14;"23.1";6114;50405;44291
617;"09.09.2007";15;21;6206;48473;42267
617;"09.09.2007";16;20;6108;47499;41391
617;"09.09.2007";17;"19.7";6049;46949;40900
617;"09.09.2007";18;"23.2";5459;48454;42995
617;"09.09.2007";19;"26.3";4293;50103;45810
617;"09.09.2007";20;"29.9";3395;51661;48266
617;"09.09.2007";21;"33.3";3195;53851;50656
617;"09.09.2007";22;"29.7";3623;51906;48283
617;"09.09.2007";23;30;3639;50505;46866
617;"09.09.2007";24;"25.1";3294;46827;43533
618;"10.09.2007";1;"22.7";3053;43674;40621
618;"10.09.2007";2;"19.6";3049;42127;39078
618;"10.09.2007";3;"16.1";3390;41537;38147
618;"10.09.2007";4;"11.9";3703;42105;38402
618;"10.09.2007";5;17;4317;43866;39549
618;"10.09.2007";6;"23.5";5201;48178;42977
618;"10.09.2007";7;30;6288;57964;51676
618;"10.09.2007";8;"42.1";6944;62751;55807
618;"10.09.2007";9;"50.8";7739;67043;59304
618;"10.09.2007";10;"49.5";8053;67980;59927
618;"10.09.2007";11;"50.2";8492;69592;61100
618;"10.09.2007";12;"58.6";9138;71506;62368
618;"10.09.2007";13;"47.8";9595;70320;60725
618;"10.09.2007";14;45;9891;69871;59980
618;"10.09.2007";15;"44.3";9646;68761;59115
618;"10.09.2007";16;"42.2";9600;67715;58115
618;"10.09.2007";17;"41.4";9174;65867;56693
618;"10.09.2007";18;40;8681;65486;56805
618;"10.09.2007";19;"40.1";7507;65325;57818
618;"10.09.2007";20;42;7272;65767;58495
618;"10.09.2007";21;42;7479;65404;57925
618;"10.09.2007";22;"35.5";7280;61628;54348
618;"10.09.2007";23;"28.7";7347;57413;50066
618;"10.09.2007";24;"21.1";6633;51963;45330
619;"11.09.2007";1;"22.9";6648;48766;42118
619;"11.09.2007";2;"19.3";6377;46900;40523
619;"11.09.2007";3;17;5655;45491;39836
619;"11.09.2007";4;"12.1";5103;45411;40308
619;"11.09.2007";5;"12.9";4906;46944;42038
619;"11.09.2007";6;26;4734;50828;46094
619;"11.09.2007";7;29;4315;59160;54845
619;"11.09.2007";8;"42.1";3782;64244;60462
619;"11.09.2007";9;"46.5";3164;66801;63637
619;"11.09.2007";10;"46.1";2877;67722;64845
619;"11.09.2007";11;"48.4";2956;68541;65585
619;"11.09.2007";12;55;2904;69694;66790
619;"11.09.2007";13;50;3080;68651;65571
619;"11.09.2007";14;"46.8";3138;67952;64814
619;"11.09.2007";15;"45.5";3276;66589;63313
619;"11.09.2007";16;"43.4";3140;65708;62568
619;"11.09.2007";17;41;3031;64480;61449
619;"11.09.2007";18;"43.3";2657;64192;61535
619;"11.09.2007";19;"40.1";2375;64080;61705
619;"11.09.2007";20;"44.9";2085;64536;62451
619;"11.09.2007";21;"49.4";1977;64957;62980
619;"11.09.2007";22;"44.9";1940;61021;59081
619;"11.09.2007";23;"40.8";1981;56758;54777
619;"11.09.2007";24;"31.8";2078;51592;49514
620;"12.09.2007";1;"24.6";2021;47950;45929
620;"12.09.2007";2;"24.1";1967;45767;43800
620;"12.09.2007";3;"24.1";1971;44805;42834
620;"12.09.2007";4;"24.2";1966;45065;43099
620;"12.09.2007";5;"25.3";1929;46536;44607
620;"12.09.2007";6;"30.2";1772;50293;48521
620;"12.09.2007";7;"34.1";1721;59166;57445
620;"12.09.2007";8;"50.1";1719;64071;62352
620;"12.09.2007";9;65;1625;66538;64913
620;"12.09.2007";10;"61.7";1701;66843;65142
620;"12.09.2007";11;"62.3";1937;67819;65882
620;"12.09.2007";12;"71.2";2151;69064;66913
620;"12.09.2007";13;"57.1";2565;68078;65513
620;"12.09.2007";14;"52.6";2932;67500;64568
620;"12.09.2007";15;"53.2";3125;66033;62908
620;"12.09.2007";16;"47.7";3358;64817;61459
620;"12.09.2007";17;45;3380;63099;59719
620;"12.09.2007";18;"42.9";3863;63281;59418
620;"12.09.2007";19;"43.5";4014;63680;59666
620;"12.09.2007";20;"46.1";3991;64489;60498
620;"12.09.2007";21;"47.9";3636;65423;61787
620;"12.09.2007";22;42;3544;61623;58079
620;"12.09.2007";23;"37.6";3114;57316;54202
620;"12.09.2007";24;29;2871;51914;49043
621;"13.09.2007";1;"32.8";2737;47773;45036
621;"13.09.2007";2;"25.9";2493;45853;43360
621;"13.09.2007";3;"23.8";2274;44679;42405
621;"13.09.2007";4;"23.2";2004;44978;42974
621;"13.09.2007";5;23;1762;46527;44765
621;"13.09.2007";6;"27.8";1585;50035;48450
621;"13.09.2007";7;35;1386;58591;57205
621;"13.09.2007";8;"51.4";1178;63580;62402
621;"13.09.2007";9;"55.7";1060;65985;64925
621;"13.09.2007";10;55;1027;66026;64999
621;"13.09.2007";11;55;1021;66546;65525
621;"13.09.2007";12;65;921;67761;66840
621;"13.09.2007";13;55;739;66380;65641
621;"13.09.2007";14;"55.1";658;65660;65002
621;"13.09.2007";15;"55.1";597;64607;64010
621;"13.09.2007";16;55;503;63620;63117
621;"13.09.2007";17;"52.1";428;62274;61846
621;"13.09.2007";18;52;358;62278;61920
621;"13.09.2007";19;"51.4";360;62587;62227
621;"13.09.2007";20;55;378;63801;63423
621;"13.09.2007";21;"55.1";454;64706;64252
621;"13.09.2007";22;"44.8";425;60630;60205
621;"13.09.2007";23;"40.1";385;56151;55766
621;"13.09.2007";24;"31.1";440;51086;50646
622;"14.09.2007";1;"26.1";516;47590;47074
622;"14.09.2007";2;"23.1";607;45667;45060
622;"14.09.2007";3;"19.1";748;44781;44033
622;"14.09.2007";4;"16.1";1016;45326;44310
622;"14.09.2007";5;"16.9";1279;46902;45623
622;"14.09.2007";6;"24.8";1461;50412;48951
622;"14.09.2007";7;"33.1";1749;58688;56939
622;"14.09.2007";8;41;2103;63416;61313
622;"14.09.2007";9;"47.1";1941;65630;63689
622;"14.09.2007";10;"47.4";1675;65515;63840
622;"14.09.2007";11;50;1781;66408;64627
622;"14.09.2007";12;"50.1";2387;67619;65232
622;"14.09.2007";13;"47.1";2786;66378;63592
622;"14.09.2007";14;"42.1";3404;65340;61936
622;"14.09.2007";15;39;4164;64275;60111
622;"14.09.2007";16;"37.7";4979;63176;58197
622;"14.09.2007";17;"33.9";5519;62279;56760
622;"14.09.2007";18;"33.1";5392;62505;57113
622;"14.09.2007";19;"33.1";5128;62602;57474
622;"14.09.2007";20;34;5416;64163;58747
622;"14.09.2007";21;34;5620;63698;58078
622;"14.09.2007";22;"25.7";5717;59937;54220
622;"14.09.2007";23;"24.7";6235;55931;49696
622;"14.09.2007";24;"21.5";6363;51713;45350
623;"15.09.2007";1;"28.8";6789;48569;41780
623;"15.09.2007";2;"25.9";7377;46667;39290
623;"15.09.2007";3;"21.9";7283;45299;38016
623;"15.09.2007";4;"20.5";7136;44881;37745
623;"15.09.2007";5;"18.8";6994;45111;38117
623;"15.09.2007";6;"23.3";6947;45741;38794
623;"15.09.2007";7;"23.1";6995;47834;40839
623;"15.09.2007";8;"26.7";6924;50850;43926
623;"15.09.2007";9;32;7362;54888;47526
623;"15.09.2007";10;"33.8";8014;58057;50043
623;"15.09.2007";11;34;9161;59950;50789
623;"15.09.2007";12;"35.9";10114;60714;50600
623;"15.09.2007";13;"37.4";10295;59283;48988
623;"15.09.2007";14;"32.6";10220;56790;46570
623;"15.09.2007";15;30;10188;55064;44876
623;"15.09.2007";16;"28.1";9665;53884;44219
623;"15.09.2007";17;"27.8";8924;53136;44212
623;"15.09.2007";18;29;7681;53540;45859
623;"15.09.2007";19;"33.1";5420;53454;48034
623;"15.09.2007";20;"36.5";3263;53876;50613
623;"15.09.2007";21;"38.5";2477;54483;52006
623;"15.09.2007";22;33;2235;51498;49263
623;"15.09.2007";23;31;1987;49183;47196
623;"15.09.2007";24;"26.2";1881;45765;43884
624;"16.09.2007";1;23;2017;42377;40360
624;"16.09.2007";2;19;2469;40226;37757
624;"16.09.2007";3;"16.8";2824;38847;36023
624;"16.09.2007";4;"10.9";3023;38495;35472
624;"16.09.2007";5;"10.3";3355;39117;35762
624;"16.09.2007";6;"10.5";3677;39399;35722
624;"16.09.2007";7;"10.1";4008;39624;35616
624;"16.09.2007";8;"10.7";4028;40594;36566
624;"16.09.2007";9;"19.1";3560;43603;40043
624;"16.09.2007";10;"23.1";2642;46104;43462
624;"16.09.2007";11;"24.6";2614;48125;45511
624;"16.09.2007";12;"28.3";3123;50340;47217
624;"16.09.2007";13;26;4013;48862;44849
624;"16.09.2007";14;"23.5";5104;46959;41855
624;"16.09.2007";15;"21.5";5945;45753;39808
624;"16.09.2007";16;"20.1";6257;44844;38587
624;"16.09.2007";17;"19.9";6177;45025;38848
624;"16.09.2007";18;"22.2";5351;46804;41453
624;"16.09.2007";19;"26.3";3732;49008;45276
624;"16.09.2007";20;"29.6";3413;51652;48239
624;"16.09.2007";21;"32.4";4289;54154;49865
624;"16.09.2007";22;30;5082;51901;46819
624;"16.09.2007";23;"28.2";5616;50582;44966
624;"16.09.2007";24;"22.2";6009;46788;40779
625;"17.09.2007";1;"22.1";6124;43749;37625
625;"17.09.2007";2;"17.9";6157;41976;35819
625;"17.09.2007";3;"12.1";6523;41613;35090
625;"17.09.2007";4;10;6403;42061;35658
625;"17.09.2007";5;"13.4";5958;43446;37488
625;"17.09.2007";6;"23.1";5297;47986;42689
625;"17.09.2007";7;"29.9";4892;58269;53377
625;"17.09.2007";8;"41.2";4538;63515;58977
625;"17.09.2007";9;"48.7";3872;65942;62070
625;"17.09.2007";10;"46.5";3173;66614;63441
625;"17.09.2007";11;"49.8";3163;67596;64433
625;"17.09.2007";12;"55.1";3452;69517;66065
625;"17.09.2007";13;"49.8";3939;68257;64318
625;"17.09.2007";14;"48.8";4287;67932;63645
625;"17.09.2007";15;"49.8";4009;66687;62678
625;"17.09.2007";16;"47.6";3367;65891;62524
625;"17.09.2007";17;47;2957;64595;61638
625;"17.09.2007";18;"45.1";2546;65010;62464
625;"17.09.2007";19;"45.7";2040;65616;63576
625;"17.09.2007";20;"47.7";2016;67371;65355
625;"17.09.2007";21;"48.8";1805;65462;63657
625;"17.09.2007";22;39;1935;61085;59150
625;"17.09.2007";23;"30.3";1698;56327;54629
625;"17.09.2007";24;"25.7";1665;51150;49485
626;"18.09.2007";1;"22.1";1658;47813;46155
626;"18.09.2007";2;"19.1";1222;45733;44511
626;"18.09.2007";3;"19.8";1229;44544;43315
626;"18.09.2007";4;"19.7";1435;44993;43558
626;"18.09.2007";5;"20.8";1658;46215;44557
626;"18.09.2007";6;"24.8";2209;50155;47946
626;"18.09.2007";7;"31.9";2543;59509;56966
626;"18.09.2007";8;"52.1";3418;65445;62027
626;"18.09.2007";9;"63.8";4026;68135;64109
626;"18.09.2007";10;"52.3";4672;68875;64203
626;"18.09.2007";11;52;5581;70328;64747
626;"18.09.2007";12;"54.9";6677;71670;64993
626;"18.09.2007";13;"49.9";7521;70208;62687
626;"18.09.2007";14;"46.8";8277;69436;61159
626;"18.09.2007";15;"48.4";8936;68226;59290
626;"18.09.2007";16;"47.4";8858;67147;58289
626;"18.09.2007";17;"45.1";9003;65808;56805
626;"18.09.2007";18;"43.5";8928;65757;56829
626;"18.09.2007";19;"43.9";7601;65231;57630
626;"18.09.2007";20;"46.1";6203;66028;59825
626;"18.09.2007";21;"46.9";5594;65413;59819
626;"18.09.2007";22;"38.2";5519;61616;56097
626;"18.09.2007";23;31;5278;57358;52080
626;"18.09.2007";24;"13.8";4875;52858;47983
627;"19.09.2007";1;28;4665;49270;44605
627;"19.09.2007";2;"24.9";4401;47082;42681
627;"19.09.2007";3;"21.1";4254;46426;42172
627;"19.09.2007";4;20;4137;46614;42477
627;"19.09.2007";5;"21.1";4273;48204;43931
627;"19.09.2007";6;"26.1";4265;51819;47554
627;"19.09.2007";7;"39.1";3888;60358;56470
627;"19.09.2007";8;50;3952;65103;61151
627;"19.09.2007";9;55;3607;66995;63388
627;"19.09.2007";10;"64.2";3412;67113;63701
627;"19.09.2007";11;"60.2";3759;67740;63981
627;"19.09.2007";12;"61.8";4553;68599;64046
627;"19.09.2007";13;"55.1";5151;67460;62309
627;"19.09.2007";14;"52.5";5792;66870;61078
627;"19.09.2007";15;"50.4";6106;65903;59797
627;"19.09.2007";16;"46.6";6116;64974;58858
627;"19.09.2007";17;"44.2";5868;63285;57417
627;"19.09.2007";18;"47.7";5399;63562;58163
627;"19.09.2007";19;"49.3";4728;63858;59130
627;"19.09.2007";20;57;4873;66183;61310
627;"19.09.2007";21;"52.7";5586;65864;60278
627;"19.09.2007";22;"44.9";6362;61696;55334
627;"19.09.2007";23;38;6902;57624;50722
627;"19.09.2007";24;"33.4";7254;52369;45115
628;"20.09.2007";1;"24.9";7180;48457;41277
628;"20.09.2007";2;"23.2";6961;46346;39385
628;"20.09.2007";3;"20.5";6906;45607;38701
628;"20.09.2007";4;"15.3";6711;45600;38889
628;"20.09.2007";5;10;6638;47114;40476
628;"20.09.2007";6;"23.1";6942;50500;43558
628;"20.09.2007";7;"28.3";6680;59300;52620
628;"20.09.2007";8;"39.5";6891;63948;57057
628;"20.09.2007";9;46;6737;65688;58951
628;"20.09.2007";10;45;6752;65735;58983
628;"20.09.2007";11;"47.5";7069;66754;59685
628;"20.09.2007";12;"49.9";7243;67854;60611
628;"20.09.2007";13;"47.8";8220;67425;59205
628;"20.09.2007";14;"47.4";8188;66970;58782
628;"20.09.2007";15;47;7621;66087;58466
628;"20.09.2007";16;46;7334;65582;58248
628;"20.09.2007";17;"45.9";7157;64213;57056
628;"20.09.2007";18;"45.9";6405;64249;57844
628;"20.09.2007";19;"47.9";5729;64764;59035
628;"20.09.2007";20;"49.9";5822;66970;61148
628;"20.09.2007";21;"49.9";6323;66255;59932
628;"20.09.2007";22;"41.7";6641;61921;55280
628;"20.09.2007";23;"33.8";6769;57786;51017
628;"20.09.2007";24;"28.1";6798;52432;45634
629;"21.09.2007";1;"27.1";6766;48769;42003
629;"21.09.2007";2;"20.4";6408;46759;40351
629;"21.09.2007";3;"20.7";5919;45882;39963
629;"21.09.2007";4;22;5598;46077;40479
629;"21.09.2007";5;"24.1";5164;47741;42577
629;"21.09.2007";6;31;4884;51392;46508
629;"21.09.2007";7;"38.8";4590;59815;55225
629;"21.09.2007";8;"49.1";4254;64943;60689
629;"21.09.2007";9;"50.2";3785;66676;62891
629;"21.09.2007";10;"50.1";3189;66323;63134
629;"21.09.2007";11;50;3158;67136;63978
629;"21.09.2007";12;52;3498;68030;64532
629;"21.09.2007";13;"49.3";3874;67066;63192
629;"21.09.2007";14;"47.7";4190;65619;61429
629;"21.09.2007";15;"47.6";4189;63861;59672
629;"21.09.2007";16;"45.9";4154;62814;58660
629;"21.09.2007";17;"42.3";3419;61638;58219
629;"21.09.2007";18;"39.9";2892;61841;58949
629;"21.09.2007";19;"41.8";2329;62300;59971
629;"21.09.2007";20;"48.5";2451;64178;61727
629;"21.09.2007";21;"50.2";3083;63494;60411
629;"21.09.2007";22;"41.8";3705;59466;55761
629;"21.09.2007";23;"36.6";4451;55911;51460
629;"21.09.2007";24;"29.3";4643;51611;46968
630;"22.09.2007";1;25;4611;47956;43345
630;"22.09.2007";2;25;4564;45669;41105
630;"22.09.2007";3;"21.6";4418;44444;40026
630;"22.09.2007";4;"17.1";4134;44196;40062
630;"22.09.2007";5;"15.1";3641;44873;41232
630;"22.09.2007";6;21;3019;45734;42715
630;"22.09.2007";7;"21.6";2613;47907;45294
630;"22.09.2007";8;"29.6";2275;50182;47907
630;"22.09.2007";9;"34.5";1735;53789;52054
630;"22.09.2007";10;"37.2";982;56193;55211
630;"22.09.2007";11;"41.1";585;57341;56756
630;"22.09.2007";12;"43.1";449;57965;57516
630;"22.09.2007";13;"40.1";506;56107;55601
630;"22.09.2007";14;36;541;53701;53160
630;"22.09.2007";15;"37.1";481;51864;51383
630;"22.09.2007";16;35;442;51163;50721
630;"22.09.2007";17;"33.4";352;50340;49988
630;"22.09.2007";18;"35.9";288;51447;51159
630;"22.09.2007";19;"37.8";223;52889;52666
630;"22.09.2007";20;40;241;55410;55169
630;"22.09.2007";21;"42.4";259;55017;54758
630;"22.09.2007";22;"35.3";299;51819;51520
630;"22.09.2007";23;34;400;49298;48898
630;"22.09.2007";24;"28.5";385;45539;45154
631;"23.09.2007";1;"24.9";369;42310;41941
631;"23.09.2007";2;"22.1";360;40235;39875
631;"23.09.2007";3;"20.6";369;39181;38812
631;"23.09.2007";4;"17.1";412;39101;38689
631;"23.09.2007";5;"17.2";454;39479;39025
631;"23.09.2007";6;18;478;39815;39337
631;"23.09.2007";7;"16.8";522;39908;39386
631;"23.09.2007";8;"16.7";623;41106;40483
631;"23.09.2007";9;22;764;44642;43878
631;"23.09.2007";10;"25.1";628;47170;46542
631;"23.09.2007";11;"26.1";353;48918;48565
631;"23.09.2007";12;"29.3";330;51076;50746
631;"23.09.2007";13;27;461;49768;49307
631;"23.09.2007";14;"25.1";559;47261;46702
631;"23.09.2007";15;"23.2";684;45509;44825
631;"23.09.2007";16;"22.1";695;44639;43944
631;"23.09.2007";17;"21.9";642;44832;44190
631;"23.09.2007";18;"23.9";590;47055;46465
631;"23.09.2007";19;"26.1";607;49517;48910
631;"23.09.2007";20;32;1032;53425;52393
631;"23.09.2007";21;"34.7";1664;54702;53038
631;"23.09.2007";22;"30.3";2176;52451;50275
631;"23.09.2007";23;30;2460;51282;48822
631;"23.09.2007";24;"24.9";2676;47244;44568
632;"24.09.2007";1;"23.2";2678;43728;41050
632;"24.09.2007";2;"17.8";2685;42095;39410
632;"24.09.2007";3;13;2791;41584;38793
632;"24.09.2007";4;"10.8";2837;42003;39166
632;"24.09.2007";5;"13.4";2931;43652;40721
632;"24.09.2007";6;"23.7";2995;48674;45679
632;"24.09.2007";7;32;3344;58476;55132
632;"24.09.2007";8;"46.3";3849;64147;60298
632;"24.09.2007";9;"52.2";3821;66746;62925
632;"24.09.2007";10;"50.4";3137;66628;63491
632;"24.09.2007";11;"52.3";3079;67124;64045
632;"24.09.2007";12;56;4357;68617;64260
632;"24.09.2007";13;"52.2";6083;67860;61777
632;"24.09.2007";14;"50.7";7273;67419;60146
632;"24.09.2007";15;"49.1";8137;66885;58748
632;"24.09.2007";16;"47.9";8276;66254;57978
632;"24.09.2007";17;"44.7";8061;65038;56977
632;"24.09.2007";18;"46.8";6706;64945;58239
632;"24.09.2007";19;"47.6";5302;65418;60116
632;"24.09.2007";20;"51.6";5403;68083;62680
632;"24.09.2007";21;"50.3";4925;66223;61298
632;"24.09.2007";22;"41.5";4557;61562;57005
632;"24.09.2007";23;"34.1";3999;57190;53191
632;"24.09.2007";24;"27.9";3406;52066;48660
633;"25.09.2007";1;"24.8";2978;48205;45227
633;"25.09.2007";2;"23.3";2566;46123;43557
633;"25.09.2007";3;"17.8";2604;45253;42649
633;"25.09.2007";4;13;2467;45110;42643
633;"25.09.2007";5;16;2567;46765;44198
633;"25.09.2007";6;"25.8";2733;50653;47920
633;"25.09.2007";7;42;3243;60022;56779
633;"25.09.2007";8;"52.8";3125;65077;61952
633;"25.09.2007";9;57;3123;67430;64307
633;"25.09.2007";10;58;3556;67938;64382
633;"25.09.2007";11;"56.9";3976;69444;65468
633;"25.09.2007";12;"65.1";4226;70773;66547
633;"25.09.2007";13;"55.5";4667;69411;64744
633;"25.09.2007";14;56;4699;68402;63703
633;"25.09.2007";15;"56.9";4344;67261;62917
633;"25.09.2007";16;"54.9";3841;66591;62750
633;"25.09.2007";17;"53.9";3162;65207;62045
633;"25.09.2007";18;"51.2";2637;65248;62611
633;"25.09.2007";19;"52.1";1986;65642;63656
633;"25.09.2007";20;56;1832;67569;65737
633;"25.09.2007";21;"55.4";2127;65694;63567
633;"25.09.2007";22;"49.9";2444;61168;58724
633;"25.09.2007";23;40;2488;57071;54583
633;"25.09.2007";24;"29.2";2280;52266;49986
634;"26.09.2007";1;"24.8";2158;48802;46644
634;"26.09.2007";2;"22.7";1895;46663;44768
634;"26.09.2007";3;"24.6";1835;46096;44261
634;"26.09.2007";4;"24.1";1709;46711;45002
634;"26.09.2007";5;"22.4";1630;48054;46424
634;"26.09.2007";6;"24.9";1513;51366;49853
634;"26.09.2007";7;"44.3";1375;59254;57879
634;"26.09.2007";8;"54.8";1177;64594;63417
634;"26.09.2007";9;"61.2";803;66813;66010
634;"26.09.2007";10;62;474;67412;66938
634;"26.09.2007";11;"79.9";294;68761;68467
634;"26.09.2007";12;"100.1";272;69998;69726
634;"26.09.2007";13;"85.1";269;68912;68643
634;"26.09.2007";14;"85.1";220;68329;68109
634;"26.09.2007";15;75;244;67082;66838
634;"26.09.2007";16;"64.5";260;66429;66169
634;"26.09.2007";17;"59.4";271;64815;64544
634;"26.09.2007";18;"56.9";275;64812;64537
634;"26.09.2007";19;56;378;65269;64891
634;"26.09.2007";20;59;568;67610;67042
634;"26.09.2007";21;"58.9";881;65245;64364
634;"26.09.2007";22;"51.7";1050;60878;59828
634;"26.09.2007";23;"44.9";1255;56854;55599
634;"26.09.2007";24;32;1374;52371;50997
635;"27.09.2007";1;"30.5";1546;48289;46743
635;"27.09.2007";2;"25.5";1888;46086;44198
635;"27.09.2007";3;"23.6";2358;45338;42980
635;"27.09.2007";4;"23.4";2727;45690;42963
635;"27.09.2007";5;"23.2";3148;47129;43981
635;"27.09.2007";6;"27.7";3673;50742;47069
635;"27.09.2007";7;"39.9";4108;59147;55039
635;"27.09.2007";8;"52.5";4671;65705;61034
635;"27.09.2007";9;"62.1";4809;68332;63523
635;"27.09.2007";10;"58.1";5120;69353;64233
635;"27.09.2007";11;"59.9";5927;70955;65028
635;"27.09.2007";12;"65.1";7234;72725;65491
635;"27.09.2007";13;55;8328;71706;63378
635;"27.09.2007";14;"54.3";8860;70849;61989
635;"27.09.2007";15;"52.1";9706;70142;60436
635;"27.09.2007";16;"51.6";10442;69580;59138
635;"27.09.2007";17;50;10684;67994;57310
635;"27.09.2007";18;"50.1";10867;68523;57656
635;"27.09.2007";19;"52.1";10714;69256;58542
635;"27.09.2007";20;"54.9";10870;71035;60165
635;"27.09.2007";21;50;11006;68153;57147
635;"27.09.2007";22;"35.9";10619;64121;53502
635;"27.09.2007";23;"34.2";10251;60077;49826
635;"27.09.2007";24;27;10022;55029;45007
636;"28.09.2007";1;"24.5";9459;51151;41692
636;"28.09.2007";2;"22.2";9218;48854;39636
636;"28.09.2007";3;"16.7";8898;47391;38493
636;"28.09.2007";4;"6.8";8255;47438;39183
636;"28.09.2007";5;"18.5";7498;48965;41467
636;"28.09.2007";6;"24.9";6790;52208;45418
636;"28.09.2007";7;"34.1";6043;60227;54184
636;"28.09.2007";8;"50.1";5580;66039;60459
636;"28.09.2007";9;"48.3";5289;68957;63668
636;"28.09.2007";10;"49.6";4996;69684;64688
636;"28.09.2007";11;"51.4";4638;70599;65961
636;"28.09.2007";12;"54.6";4406;71580;67174
636;"28.09.2007";13;"51.3";4639;70340;65701
636;"28.09.2007";14;"49.1";4912;68732;63820
636;"28.09.2007";15;"49.8";5327;66846;61519
636;"28.09.2007";16;"45.7";5796;65814;60018
636;"28.09.2007";17;"40.1";5839;64883;59044
636;"28.09.2007";18;38;5657;64932;59275
636;"28.09.2007";19;"41.3";5281;65696;60415
636;"28.09.2007";20;52;5372;67361;61989
636;"28.09.2007";21;52;5406;64115;58709
636;"28.09.2007";22;"41.1";5563;59855;54292
636;"28.09.2007";23;"36.6";5625;56712;51087
636;"28.09.2007";24;"29.4";5423;52257;46834
637;"29.09.2007";1;"29.2";5727;48550;42823
637;"29.09.2007";2;"25.9";6353;46220;39867
637;"29.09.2007";3;"25.5";6387;44537;38150
637;"29.09.2007";4;"18.1";6193;44425;38232
637;"29.09.2007";5;18;6040;45171;39131
637;"29.09.2007";6;"19.9";5921;45360;39439
637;"29.09.2007";7;"22.2";5875;47411;41536
637;"29.09.2007";8;"28.9";6161;50420;44259
637;"29.09.2007";9;"32.6";6163;54086;47923
637;"29.09.2007";10;40;6289;57019;50730
637;"29.09.2007";11;"40.9";6394;58718;52324
637;"29.09.2007";12;"42.1";6659;59563;52904
637;"29.09.2007";13;"42.2";6888;58311;51423
637;"29.09.2007";14;"35.5";7034;56478;49444
637;"29.09.2007";15;"29.9";7569;55035;47466
637;"29.09.2007";16;"29.4";7763;54500;46737
637;"29.09.2007";17;"29.3";7492;54324;46832
637;"29.09.2007";18;"30.4";7545;56163;48618
637;"29.09.2007";19;"34.1";6908;57810;50902
637;"29.09.2007";20;"42.7";6907;59829;52922
637;"29.09.2007";21;"35.6";7449;57317;49868
637;"29.09.2007";22;"31.4";7541;54748;47207
637;"29.09.2007";23;"32.2";7794;52628;44834
637;"29.09.2007";24;"25.8";7299;48852;41553
638;"30.09.2007";1;"25.4";7213;45150;37937
638;"30.09.2007";2;22;7151;42806;35655
638;"30.09.2007";3;"17.1";6923;41356;34433
638;"30.09.2007";4;"14.1";6883;41231;34348
638;"30.09.2007";5;13;6708;41470;34762
638;"30.09.2007";6;"16.1";5952;41204;35252
638;"30.09.2007";7;"15.1";5485;41216;35731
638;"30.09.2007";8;"19.9";5234;42333;37099
638;"30.09.2007";9;"23.1";4727;45377;40650
638;"30.09.2007";10;27;4369;48104;43735
638;"30.09.2007";11;29;4570;50668;46098
638;"30.09.2007";12;"33.3";4779;52764;47985
638;"30.09.2007";13;"31.9";4531;51367;46836
638;"30.09.2007";14;"27.2";4228;49137;44909
638;"30.09.2007";15;25;3696;47434;43738
638;"30.09.2007";16;"23.8";2997;46471;43474
638;"30.09.2007";17;"23.7";2290;46278;43988
638;"30.09.2007";18;"25.9";1661;47938;46277
638;"30.09.2007";19;"31.8";1283;50945;49662
638;"30.09.2007";20;"41.2";1330;55164;53834
638;"30.09.2007";21;"42.3";1346;54080;52734
638;"30.09.2007";22;"37.1";1285;51771;50486
638;"30.09.2007";23;"35.6";1197;51127;49930
638;"30.09.2007";24;"28.9";1110;47107;45997
639;"01.10.2007";1;"24.9";979;43611;42632
639;"01.10.2007";2;"20.1";849;41655;40806
639;"01.10.2007";3;"16.1";817;41321;40504
639;"01.10.2007";4;"15.8";769;41808;41039
639;"01.10.2007";5;19;727;43895;43168
639;"01.10.2007";6;"27.2";557;48203;47646
639;"01.10.2007";7;"38.2";473;57828;57355
639;"01.10.2007";8;"54.8";416;63857;63441
639;"01.10.2007";9;"63.4";395;65801;65406
639;"01.10.2007";10;"60.5";387;66158;65771
639;"01.10.2007";11;"62.5";307;66905;66598
639;"01.10.2007";12;"76.2";303;68053;67750
639;"01.10.2007";13;"59.8";304;67257;66953
639;"01.10.2007";14;59;315;66532;66217
639;"01.10.2007";15;"56.4";328;65594;65266
639;"01.10.2007";16;55;374;65088;64714
639;"01.10.2007";17;"53.1";315;63710;63395
639;"01.10.2007";18;53;363;63836;63473
639;"01.10.2007";19;"55.1";632;65584;64952
639;"01.10.2007";20;57;944;68561;67617
639;"01.10.2007";21;"53.7";1182;65413;64231
639;"01.10.2007";22;"42.2";1242;61092;59850
639;"01.10.2007";23;"35.5";1262;57054;55792
639;"01.10.2007";24;"27.8";1234;51718;50484
640;"02.10.2007";1;"27.3";1209;47611;46402
640;"02.10.2007";2;"25.4";1146;45463;44317
640;"02.10.2007";3;"21.8";1149;44611;43462
640;"02.10.2007";4;"19.2";1198;44844;43646
640;"02.10.2007";5;"18.7";1055;46564;45509
640;"02.10.2007";6;23;1049;50382;49333
640;"02.10.2007";7;"46.1";980;59264;58284
640;"02.10.2007";8;"54.3";882;65656;64774
640;"02.10.2007";9;62;799;67818;67019
640;"02.10.2007";10;"63.1";653;68038;67385
640;"02.10.2007";11;64;508;69606;69098
640;"02.10.2007";12;"65.1";494;70323;69829
640;"02.10.2007";13;"65.9";484;69445;68961
640;"02.10.2007";14;"61.2";456;68892;68436
640;"02.10.2007";15;"57.6";397;67697;67300
640;"02.10.2007";16;"55.1";390;66352;65962
640;"02.10.2007";17;"53.2";373;64594;64221
640;"02.10.2007";18;"54.1";368;64732;64364
640;"02.10.2007";19;"54.8";422;65618;65196
640;"02.10.2007";20;"58.9";553;68154;67601
640;"02.10.2007";21;55;511;64672;64161
640;"02.10.2007";22;"51.8";547;59964;59417
640;"02.10.2007";23;"38.8";565;55784;55219
640;"02.10.2007";24;"30.3";569;50681;50112
641;"03.10.2007";1;34;581;47449;46868
641;"03.10.2007";2;"27.6";603;44857;44254
641;"03.10.2007";3;"26.7";597;43595;42998
641;"03.10.2007";4;"25.4";659;43061;42402
641;"03.10.2007";5;"28.2";662;43848;43186
641;"03.10.2007";6;"25.3";736;42854;42118
641;"03.10.2007";7;"26.1";808;42530;41722
641;"03.10.2007";8;34;865;43808;42943
641;"03.10.2007";9;42;885;46581;45696
641;"03.10.2007";10;"48.9";912;49264;48352
641;"03.10.2007";11;"50.1";696;51511;50815
641;"03.10.2007";12;"54.9";606;53728;53122
641;"03.10.2007";13;"53.3";668;52619;51951
641;"03.10.2007";14;"50.3";746;50572;49826
641;"03.10.2007";15;"44.3";804;48692;47888
641;"03.10.2007";16;"34.1";992;47797;46805
641;"03.10.2007";17;"36.9";1034;47908;46874
641;"03.10.2007";18;"48.9";1164;49737;48573
641;"03.10.2007";19;"54.9";1383;52938;51555
641;"03.10.2007";20;63;1815;56929;55114
641;"03.10.2007";21;"55.2";1945;55053;53108
641;"03.10.2007";22;"48.9";2012;52731;50719
641;"03.10.2007";23;"36.1";1871;51013;49142
641;"03.10.2007";24;"32.2";1788;46931;45143
642;"04.10.2007";1;"26.2";1889;43322;41433
642;"04.10.2007";2;"22.8";1527;41305;39778
642;"04.10.2007";3;19;1299;40606;39307
642;"04.10.2007";4;"17.4";1230;40861;39631
642;"04.10.2007";5;"20.9";1028;42396;41368
642;"04.10.2007";6;"26.8";945;47110;46165
642;"04.10.2007";7;"42.2";914;57560;56646
642;"04.10.2007";8;"55.2";1009;64995;63986
642;"04.10.2007";9;65;935;67727;66792
642;"04.10.2007";10;65;811;68263;67452
642;"04.10.2007";11;"68.6";718;69327;68609
642;"04.10.2007";12;"79.5";767;70104;69337
642;"04.10.2007";13;"66.7";873;68703;67830
642;"04.10.2007";14;"64.3";1046;67740;66694
642;"04.10.2007";15;"58.8";985;66564;65579
642;"04.10.2007";16;"56.9";1074;65554;64480
642;"04.10.2007";17;"55.3";1115;64210;63095
642;"04.10.2007";18;"55.6";1092;63704;62612
642;"04.10.2007";19;"56.1";1202;65164;63962
642;"04.10.2007";20;"65.9";1216;68527;67311
642;"04.10.2007";21;"54.3";1271;65812;64541
642;"04.10.2007";22;"41.9";1266;61479;60213
642;"04.10.2007";23;"38.8";1335;57256;55921
642;"04.10.2007";24;"29.7";1453;51835;50382
643;"05.10.2007";1;"30.6";1413;47713;46300
643;"05.10.2007";2;"25.6";1482;45442;43960
643;"05.10.2007";3;"24.9";1436;44512;43076
643;"05.10.2007";4;"24.4";1451;44446;42995
643;"05.10.2007";5;"24.3";1467;46040;44573
643;"05.10.2007";6;"31.6";1400;49984;48584
643;"05.10.2007";7;"53.4";1274;58384;57110
643;"05.10.2007";8;"59.7";1031;64550;63519
643;"05.10.2007";9;"66.8";879;66522;65643
643;"05.10.2007";10;"66.4";721;67026;66305
643;"05.10.2007";11;"66.5";617;67853;67236
643;"05.10.2007";12;"78.7";584;68757;68173
643;"05.10.2007";13;"65.7";673;67394;66721
643;"05.10.2007";14;"61.2";655;65708;65053
643;"05.10.2007";15;"62.5";596;63990;63394
643;"05.10.2007";16;63;680;62770;62090
643;"05.10.2007";17;"59.5";639;61653;61014
643;"05.10.2007";18;"58.2";656;62240;61584
643;"05.10.2007";19;"60.1";783;63533;62750
643;"05.10.2007";20;70;1068;66330;65262
643;"05.10.2007";21;"61.4";1212;63209;61997
643;"05.10.2007";22;"53.5";1314;59223;57909
643;"05.10.2007";23;"41.6";1245;55760;54515
643;"05.10.2007";24;"36.4";1120;51300;50180
644;"06.10.2007";1;34;1122;47663;46541
644;"06.10.2007";2;"28.1";1019;45260;44241
644;"06.10.2007";3;"24.7";874;43627;42753
644;"06.10.2007";4;"25.1";798;43611;42813
644;"06.10.2007";5;"24.4";687;44343;43656
644;"06.10.2007";6;"25.1";592;45091;44499
644;"06.10.2007";7;"25.6";563;47017;46454
644;"06.10.2007";8;"30.2";530;50287;49757
644;"06.10.2007";9;"37.1";544;53542;52998
644;"06.10.2007";10;54;442;56064;55622
644;"06.10.2007";11;55;387;57357;56970
644;"06.10.2007";12;"59.5";416;58033;57617
644;"06.10.2007";13;"52.1";475;56515;56040
644;"06.10.2007";14;"45.1";491;54126;53635
644;"06.10.2007";15;36;551;52401;51850
644;"06.10.2007";16;"33.1";612;51298;50686
644;"06.10.2007";17;31;579;50920;50341
644;"06.10.2007";18;33;587;52474;51887
644;"06.10.2007";19;"37.5";551;54619;54068
644;"06.10.2007";20;"54.9";709;57958;57249
644;"06.10.2007";21;"44.1";904;55202;54298
644;"06.10.2007";22;35;864;51768;50904
644;"06.10.2007";23;"30.7";841;49745;48904
644;"06.10.2007";24;"26.1";844;45944;45100
645;"07.10.2007";1;"27.3";853;42452;41599
645;"07.10.2007";2;24;852;40338;39486
645;"07.10.2007";3;"21.3";800;39391;38591
645;"07.10.2007";4;"17.6";651;39191;38540
645;"07.10.2007";5;"17.7";544;39693;39149
645;"07.10.2007";6;"19.4";502;39780;39278
645;"07.10.2007";7;"17.7";485;39870;39385
645;"07.10.2007";8;"21.1";511;41294;40783
645;"07.10.2007";9;"24.1";497;44058;43561
645;"07.10.2007";10;"27.2";463;46853;46390
645;"07.10.2007";11;30;273;48821;48548
645;"07.10.2007";12;"34.7";203;50974;50771
645;"07.10.2007";13;"31.2";241;49569;49328
645;"07.10.2007";14;"28.4";261;47056;46795
645;"07.10.2007";15;"26.4";308;45321;45013
645;"07.10.2007";16;"25.3";267;44544;44277
645;"07.10.2007";17;25;305;44881;44576
645;"07.10.2007";18;"27.6";249;47422;47173
645;"07.10.2007";19;"36.6";253;51265;51012
645;"07.10.2007";20;"56.1";305;55915;55610
645;"07.10.2007";21;"48.5";356;54074;53718
645;"07.10.2007";22;"39.1";425;51938;51513
645;"07.10.2007";23;"39.1";532;51001;50469
645;"07.10.2007";24;"29.9";584;47342;46758
646;"08.10.2007";1;26;630;43772;43142
646;"08.10.2007";2;"20.8";629;42174;41545
646;"08.10.2007";3;"18.5";723;41889;41166
646;"08.10.2007";4;"18.5";915;42548;41633
646;"08.10.2007";5;"21.6";1052;44690;43638
646;"08.10.2007";6;"27.6";1121;49389;48268
646;"08.10.2007";7;49;1157;59195;58038
646;"08.10.2007";8;"67.2";1178;65660;64482
646;"08.10.2007";9;"81.1";1234;67718;66484
646;"08.10.2007";10;"70.5";1009;67916;66907
646;"08.10.2007";11;"75.4";798;68129;67331
646;"08.10.2007";12;"94.8";996;69090;68094
646;"08.10.2007";13;"80.1";1069;68116;67047
646;"08.10.2007";14;"78.4";1046;67398;66352
646;"08.10.2007";15;"66.4";1090;66306;65216
646;"08.10.2007";16;"66.6";1030;65094;64064
646;"08.10.2007";17;"63.4";901;63774;62873
646;"08.10.2007";18;"63.2";792;63941;63149
646;"08.10.2007";19;"72.7";778;66427;65649
646;"08.10.2007";20;"86.1";760;69814;69054
646;"08.10.2007";21;"65.7";706;65944;65238
646;"08.10.2007";22;"59.5";633;61306;60673
646;"08.10.2007";23;"45.1";543;57470;56927
646;"08.10.2007";24;"33.4";418;52324;51906
647;"09.10.2007";1;"29.1";356;48824;48468
647;"09.10.2007";2;"25.8";288;46748;46460
647;"09.10.2007";3;"25.7";262;45839;45577
647;"09.10.2007";4;"21.9";257;46259;46002
647;"09.10.2007";5;"21.7";259;47924;47665
647;"09.10.2007";6;"26.8";258;51750;51492
647;"09.10.2007";7;"46.6";207;60590;60383
647;"09.10.2007";8;"71.2";190;66579;66389
647;"09.10.2007";9;"79.4";157;68157;68000
647;"09.10.2007";10;"75.1";135;68500;68365
647;"09.10.2007";11;"73.1";129;69157;69028
647;"09.10.2007";12;"74.8";145;70303;70158
647;"09.10.2007";13;"69.1";126;69110;68984
647;"09.10.2007";14;70;142;68211;68069
647;"09.10.2007";15;"66.9";169;66857;66688
647;"09.10.2007";16;"68.9";161;66190;66029
647;"09.10.2007";17;"63.4";165;64972;64807
647;"09.10.2007";18;"58.5";223;65686;65463
647;"09.10.2007";19;"62.1";407;67306;66899
647;"09.10.2007";20;79;847;70154;69307
647;"09.10.2007";21;"71.5";1194;66307;65113
647;"09.10.2007";22;"48.1";1451;62771;61320
647;"09.10.2007";23;"36.3";1538;58709;57171
647;"09.10.2007";24;"31.1";1516;53380;51864
648;"10.10.2007";1;"29.4";1513;49148;47635
648;"10.10.2007";2;"27.4";1406;47000;45594
648;"10.10.2007";3;"25.3";1291;46177;44886
648;"10.10.2007";4;"25.8";1257;46668;45411
648;"10.10.2007";5;"26.1";1197;48437;47240
648;"10.10.2007";6;30;1075;52428;51353
648;"10.10.2007";7;"43.3";1002;61341;60339
648;"10.10.2007";8;"71.4";851;67586;66735
648;"10.10.2007";9;86;780;69241;68461
648;"10.10.2007";10;78;580;69051;68471
648;"10.10.2007";11;81;363;69421;69058
648;"10.10.2007";12;"89.4";208;70116;69908
648;"10.10.2007";13;"71.2";240;68562;68322
648;"10.10.2007";14;"67.9";277;67805;67528
648;"10.10.2007";15;"71.1";296;66428;66132
648;"10.10.2007";16;"68.9";299;65302;65003
648;"10.10.2007";17;"62.1";319;63811;63492
648;"10.10.2007";18;"58.5";379;64319;63940
648;"10.10.2007";19;"63.9";523;66546;66023
648;"10.10.2007";20;80;920;69967;69047
648;"10.10.2007";21;"75.8";1024;66251;65227
648;"10.10.2007";22;"59.9";837;61827;60990
648;"10.10.2007";23;"50.1";759;57815;57056
648;"10.10.2007";24;"35.6";624;52700;52076
649;"11.10.2007";1;33;554;48564;48010
649;"11.10.2007";2;27;415;46222;45807
649;"11.10.2007";3;"25.6";400;45562;45162
649;"11.10.2007";4;"22.4";411;46188;45777
649;"11.10.2007";5;"25.9";450;47991;47541
649;"11.10.2007";6;29;528;51422;50894
649;"11.10.2007";7;"58.1";599;59753;59154
649;"11.10.2007";8;"77.1";692;66428;65736
649;"11.10.2007";9;75;745;68039;67294
649;"11.10.2007";10;"71.2";642;68136;67494
649;"11.10.2007";11;"71.1";610;68821;68211
649;"11.10.2007";12;"72.6";670;69753;69083
649;"11.10.2007";13;"67.1";883;68427;67544
649;"11.10.2007";14;"62.1";1161;67471;66310
649;"11.10.2007";15;62;1410;66152;64742
649;"11.10.2007";16;"63.1";1599;65329;63730
649;"11.10.2007";17;59;1640;64339;62699
649;"11.10.2007";18;"56.1";1488;64464;62976
649;"11.10.2007";19;"66.5";1636;66946;65310
649;"11.10.2007";20;"71.3";2275;70307;68032
649;"11.10.2007";21;69;3143;66852;63709
649;"11.10.2007";22;52;4014;63099;59085
649;"11.10.2007";23;"41.8";4490;59911;55421
649;"11.10.2007";24;"31.8";5027;55175;50148
650;"12.10.2007";1;"29.1";5183;51082;45899
650;"12.10.2007";2;"26.8";5134;48751;43617
650;"12.10.2007";3;"23.8";5432;47700;42268
650;"12.10.2007";4;"15.4";6154;48093;41939
650;"12.10.2007";5;18;6870;49832;42962
650;"12.10.2007";6;"27.6";7382;53523;46141
650;"12.10.2007";7;30;7419;62169;54750
650;"12.10.2007";8;"56.9";7703;69163;61460
650;"12.10.2007";9;"68.4";8074;71093;63019
650;"12.10.2007";10;"69.6";8226;71511;63285
650;"12.10.2007";11;"69.6";8341;72722;64381
650;"12.10.2007";12;70;8281;73659;65378
650;"12.10.2007";13;62;8283;72403;64120
650;"12.10.2007";14;"52.4";8003;70806;62803
650;"12.10.2007";15;"51.9";6890;68734;61844
650;"12.10.2007";16;"46.1";5999;67009;61010
650;"12.10.2007";17;"44.5";4761;65614;60853
650;"12.10.2007";18;"52.7";3684;65573;61889
650;"12.10.2007";19;"61.4";2951;67461;64510
650;"12.10.2007";20;70;2748;69246;66498
650;"12.10.2007";21;"63.1";2434;64864;62430
650;"12.10.2007";22;"58.3";2038;60965;58927
650;"12.10.2007";23;"42.1";1656;57847;56191
650;"12.10.2007";24;"33.1";1485;53344;51859
651;"13.10.2007";1;52;1155;49413;48258
651;"13.10.2007";2;40;901;46543;45642
651;"13.10.2007";3;37;802;45038;44236
651;"13.10.2007";4;"29.5";813;44656;43843
651;"13.10.2007";5;"28.7";851;45444;44593
651;"13.10.2007";6;"31.5";950;45804;44854
651;"13.10.2007";7;"33.5";970;47581;46611
651;"13.10.2007";8;"48.1";891;51020;50129
651;"13.10.2007";9;"64.9";750;54130;53380
651;"13.10.2007";10;"68.2";493;56885;56392
651;"13.10.2007";11;"69.8";297;58312;58015
651;"13.10.2007";12;"72.7";261;58611;58350
651;"13.10.2007";13;"75.3";236;57119;56883
651;"13.10.2007";14;"63.5";205;54470;54265
651;"13.10.2007";15;"58.1";171;52019;51848
651;"13.10.2007";16;"46.4";157;51126;50969
651;"13.10.2007";17;45;169;50573;50404
651;"13.10.2007";18;"59.1";219;52075;51856
651;"13.10.2007";19;"68.2";378;55171;54793
651;"13.10.2007";20;"74.9";758;58732;57974
651;"13.10.2007";21;"63.5";1127;55183;54056
651;"13.10.2007";22;"47.9";1409;52269;50860
651;"13.10.2007";23;"47.9";1658;50565;48907
651;"13.10.2007";24;"37.4";1767;47177;45410
652;"14.10.2007";1;28;1907;43630;41723
652;"14.10.2007";2;"25.2";1700;41124;39424
652;"14.10.2007";3;"23.3";1634;40178;38544
652;"14.10.2007";4;"18.7";1675;40229;38554
652;"14.10.2007";5;"18.9";1728;40533;38805
652;"14.10.2007";6;"22.1";1690;40528;38838
652;"14.10.2007";7;"20.1";1692;40126;38434
652;"14.10.2007";8;"23.9";1828;41309;39481
652;"14.10.2007";9;27;1983;44723;42740
652;"14.10.2007";10;"28.7";1708;47627;45919
652;"14.10.2007";11;"32.1";970;49334;48364
652;"14.10.2007";12;"34.9";820;51507;50687
652;"14.10.2007";13;"33.7";992;49806;48814
652;"14.10.2007";14;30;1011;47141;46130
652;"14.10.2007";15;"27.1";955;45109;44154
652;"14.10.2007";16;"25.9";932;44295;43363
652;"14.10.2007";17;"23.8";882;44354;43472
652;"14.10.2007";18;"27.7";902;46727;45825
652;"14.10.2007";19;36;1542;51937;50395
652;"14.10.2007";20;"47.7";2780;56379;53599
652;"14.10.2007";21;"42.8";3794;54201;50407
652;"14.10.2007";22;"35.9";4317;52408;48091
652;"14.10.2007";23;"34.8";4192;52093;47901
652;"14.10.2007";24;30;4484;48597;44113
653;"15.10.2007";1;"26.4";4555;45268;40713
653;"15.10.2007";2;"21.9";4368;43323;38955
653;"15.10.2007";3;19;3837;42669;38832
653;"15.10.2007";4;"18.4";3414;43359;39945
653;"15.10.2007";5;"22.8";3507;45302;41795
653;"15.10.2007";6;"26.5";3788;49645;45857
653;"15.10.2007";7;"40.2";3696;59060;55364
653;"15.10.2007";8;61;3853;65718;61865
653;"15.10.2007";9;68;3710;67585;63875
653;"15.10.2007";10;"66.3";2998;67464;64466
653;"15.10.2007";11;"67.7";1896;68276;66380
653;"15.10.2007";12;"69.9";1441;69028;67587
653;"15.10.2007";13;"66.1";1348;67943;66595
653;"15.10.2007";14;"63.2";1609;67212;65603
653;"15.10.2007";15;"67.1";2042;66278;64236
653;"15.10.2007";16;"63.1";2288;65201;62913
653;"15.10.2007";17;"59.3";2298;63741;61443
653;"15.10.2007";18;"59.4";2166;64171;62005
653;"15.10.2007";19;"65.7";2620;67035;64415
653;"15.10.2007";20;"73.1";3852;70643;66791
653;"15.10.2007";21;"61.1";4932;66917;61985
653;"15.10.2007";22;"49.9";4963;62658;57695
653;"15.10.2007";23;"36.4";4754;58771;54017
653;"15.10.2007";24;"29.1";4700;53477;48777
654;"16.10.2007";1;"29.1";4593;49733;45140
654;"16.10.2007";2;25;4457;47382;42925
654;"16.10.2007";3;"17.6";4051;46165;42114
654;"16.10.2007";4;16;4104;46696;42592
654;"16.10.2007";5;"19.1";3885;48030;44145
654;"16.10.2007";6;29;3834;51872;48038
654;"16.10.2007";7;"34.9";3946;60624;56678
654;"16.10.2007";8;67;3744;67330;63586
654;"16.10.2007";9;"60.1";3680;69517;65837
654;"16.10.2007";10;"61.1";3383;69024;65641
654;"16.10.2007";11;"63.1";3263;69176;65913
654;"16.10.2007";12;67;3401;69914;66513
654;"16.10.2007";13;61;3874;68565;64691
654;"16.10.2007";14;"62.8";4313;67463;63150
654;"16.10.2007";15;"60.1";4629;66692;62063
654;"16.10.2007";16;55;4459;65598;61139
654;"16.10.2007";17;51;3920;64242;60322
654;"16.10.2007";18;"49.6";2998;64862;61864
654;"16.10.2007";19;"65.8";3124;67835;64711
654;"16.10.2007";20;"76.5";4031;70620;66589
654;"16.10.2007";21;63;4690;66584;61894
654;"16.10.2007";22;"49.1";5195;62273;57078
654;"16.10.2007";23;34;5383;58634;53251
654;"16.10.2007";24;30;5644;53755;48111
655;"17.10.2007";1;"31.1";5559;49661;44102
655;"17.10.2007";2;"25.8";5364;47589;42225
655;"17.10.2007";3;"24.7";5290;46760;41470
655;"17.10.2007";4;"23.1";5300;47141;41841
655;"17.10.2007";5;"23.4";5370;48775;43405
655;"17.10.2007";6;29;5478;52543;47065
655;"17.10.2007";7;55;5404;61029;55625
655;"17.10.2007";8;"67.7";5545;67785;62240
655;"17.10.2007";9;"69.9";5130;68736;63606
655;"17.10.2007";10;"69.1";4316;68982;64666
655;"17.10.2007";11;"68.2";3931;69492;65561
655;"17.10.2007";12;"69.9";3784;70407;66623
655;"17.10.2007";13;"69.9";4159;69986;65827
655;"17.10.2007";14;"69.9";4631;69653;65022
655;"17.10.2007";15;"67.3";5024;68638;63614
655;"17.10.2007";16;67;5323;68017;62694
655;"17.10.2007";17;"65.1";5225;66930;61705
655;"17.10.2007";18;"62.9";5384;67831;62447
655;"17.10.2007";19;"69.9";5734;70701;64967
655;"17.10.2007";20;85;5732;71582;65850
655;"17.10.2007";21;67;6509;67387;60878
655;"17.10.2007";22;"52.6";5991;63167;57176
655;"17.10.2007";23;"37.5";5522;59148;53626
655;"17.10.2007";24;34;5037;54276;49239
656;"18.10.2007";1;"31.2";5544;50488;44944
656;"18.10.2007";2;"25.5";5449;48351;42902
656;"18.10.2007";3;"25.6";5267;47522;42255
656;"18.10.2007";4;"26.2";5251;48122;42871
656;"18.10.2007";5;27;5358;49509;44151
656;"18.10.2007";6;29;5209;52409;47200
656;"18.10.2007";7;"32.8";5498;60810;55312
656;"18.10.2007";8;"71.1";5541;67297;61756
656;"18.10.2007";9;"78.6";5433;68439;63006
656;"18.10.2007";10;"74.9";5361;68474;63113
656;"18.10.2007";11;"74.7";6118;69874;63756
656;"18.10.2007";12;"73.7";6867;71219;64352
656;"18.10.2007";13;"69.9";7874;70584;62710
656;"18.10.2007";14;"61.2";8320;69764;61444
656;"18.10.2007";15;65;8582;68917;60335
656;"18.10.2007";16;"61.2";8502;68244;59742
656;"18.10.2007";17;"63.9";8103;66876;58773
656;"18.10.2007";18;"61.4";6922;66630;59708
656;"18.10.2007";19;"64.1";6222;69515;63293
656;"18.10.2007";20;75;5945;71691;65746
656;"18.10.2007";21;60;5914;68027;62113
656;"18.10.2007";22;52;5410;64168;58758
656;"18.10.2007";23;"37.2";5108;61032;55924
656;"18.10.2007";24;"31.1";4721;55765;51044
657;"19.10.2007";1;"41.1";4233;52282;48049
657;"19.10.2007";2;"34.8";4011;49994;45983
657;"19.10.2007";3;"30.4";3835;49212;45377
657;"19.10.2007";4;"25.3";3674;49530;45856
657;"19.10.2007";5;"27.4";3577;51262;47685
657;"19.10.2007";6;44;3555;54335;50780
657;"19.10.2007";7;"59.9";3553;61987;58434
657;"19.10.2007";8;"75.2";3411;68437;65026
657;"19.10.2007";9;"84.8";2822;69965;67143
657;"19.10.2007";10;"88.6";2268;70176;67908
657;"19.10.2007";11;"87.7";1982;70728;68746
657;"19.10.2007";12;"87.1";2400;71570;69170
657;"19.10.2007";13;76;3115;70441;67326
657;"19.10.2007";14;"74.1";3541;69075;65534
657;"19.10.2007";15;"69.2";3934;67259;63325
657;"19.10.2007";16;"67.1";4156;66369;62213
657;"19.10.2007";17;"60.1";3782;64842;61060
657;"19.10.2007";18;"59.5";3496;65408;61912
657;"19.10.2007";19;70;3098;68450;65352
657;"19.10.2007";20;"80.1";2984;69965;66981
657;"19.10.2007";21;"72.5";3251;65434;62183
657;"19.10.2007";22;"57.1";3046;61579;58533
657;"19.10.2007";23;"55.1";2804;59356;56552
657;"19.10.2007";24;"50.1";2492;55374;52882
658;"20.10.2007";1;"36.1";2214;51425;49211
658;"20.10.2007";2;35;1780;49064;47284
658;"20.10.2007";3;"34.1";1549;48205;46656
658;"20.10.2007";4;30;1453;47840;46387
658;"20.10.2007";5;"29.3";1427;48528;47101
658;"20.10.2007";6;"31.1";1253;48336;47083
658;"20.10.2007";7;"30.9";1154;48864;47710
658;"20.10.2007";8;"38.1";1184;52320;51136
658;"20.10.2007";9;"50.1";1267;55321;54054
658;"20.10.2007";10;"65.1";1072;57625;56553
658;"20.10.2007";11;66;760;58918;58158
658;"20.10.2007";12;68;761;59767;59006
658;"20.10.2007";13;"54.1";986;58331;57345
658;"20.10.2007";14;50;1034;56244;55210
658;"20.10.2007";15;"43.3";1020;54414;53394
658;"20.10.2007";16;"32.5";1063;53713;52650
658;"20.10.2007";17;"29.7";1005;53678;52673
658;"20.10.2007";18;38;942;55263;54321
658;"20.10.2007";19;"63.1";1054;59313;58259
658;"20.10.2007";20;"79.9";1227;60388;59161
658;"20.10.2007";21;"65.1";1316;56373;55057
658;"20.10.2007";22;"49.3";1355;53739;52384
658;"20.10.2007";23;"45.4";1331;52974;51643
658;"20.10.2007";24;"38.8";1331;49548;48217
659;"21.10.2007";1;"33.8";1407;46113;44706
659;"21.10.2007";2;"30.5";1527;43772;42245
659;"21.10.2007";3;"27.7";1439;42597;41158
659;"21.10.2007";4;"26.1";1333;42261;40928
659;"21.10.2007";5;"26.2";1274;42613;41339
659;"21.10.2007";6;"27.6";1399;42179;40780
659;"21.10.2007";7;"26.2";1383;41152;39769
659;"21.10.2007";8;29;1300;42650;41350
659;"21.10.2007";9;"33.8";1308;46183;44875
659;"21.10.2007";10;"38.1";1177;49839;48662
659;"21.10.2007";11;"42.7";1369;52685;51316
659;"21.10.2007";12;"52.7";1596;55801;54205
659;"21.10.2007";13;"45.1";1836;54846;53010
659;"21.10.2007";14;"38.2";1974;52556;50582
659;"21.10.2007";15;"35.5";1980;50796;48816
659;"21.10.2007";16;"33.5";2060;49998;47938
659;"21.10.2007";17;"33.5";2265;49779;47514
659;"21.10.2007";18;"39.7";2170;51853;49683
659;"21.10.2007";19;"60.2";2345;56008;53663
659;"21.10.2007";20;"74.9";2515;57265;54750
659;"21.10.2007";21;"58.1";3001;55474;52473
659;"21.10.2007";22;"49.9";3227;54143;50916
659;"21.10.2007";23;45;3350;54415;51065
659;"21.10.2007";24;"35.1";3260;51133;47873
660;"22.10.2007";1;"35.1";3115;48104;44989
660;"22.10.2007";2;32;2740;46220;43480
660;"22.10.2007";3;29;2500;45792;43292
660;"22.10.2007";4;"28.7";2346;46453;44107
660;"22.10.2007";5;31;2217;48272;46055
660;"22.10.2007";6;"38.8";2021;51623;49602
660;"22.10.2007";7;"67.9";1922;60739;58817
660;"22.10.2007";8;102;1846;67945;66099
660;"22.10.2007";9;"107.8";1827;69279;67452
660;"22.10.2007";10;"116.7";1643;69306;67663
660;"22.10.2007";11;"116.7";1074;70221;69147
660;"22.10.2007";12;"134.3";1115;71022;69907
660;"22.10.2007";13;"99.9";1487;70032;68545
660;"22.10.2007";14;94;1961;69331;67370
660;"22.10.2007";15;85;2162;68398;66236
660;"22.10.2007";16;"80.1";1968;67513;65545
660;"22.10.2007";17;76;1997;66267;64270
660;"22.10.2007";18;"74.9";1977;66611;64634
660;"22.10.2007";19;"97.3";2390;70499;68109
660;"22.10.2007";20;"141.5";2762;72126;69364
660;"22.10.2007";21;"80.3";2990;67902;64912
660;"22.10.2007";22;"67.5";3331;64852;61521
660;"22.10.2007";23;"55.1";3473;61689;58216
660;"22.10.2007";24;"37.6";3331;56500;53169
661;"23.10.2007";1;45;3216;52941;49725
661;"23.10.2007";2;"40.1";3205;51058;47853
661;"23.10.2007";3;"32.9";3045;50184;47139
661;"23.10.2007";4;"28.3";3008;50421;47413
661;"23.10.2007";5;"28.8";3011;51720;48709
661;"23.10.2007";6;45;2960;54588;51628
661;"23.10.2007";7;"67.5";3172;62533;59361
661;"23.10.2007";8;120;3308;69385;66077
661;"23.10.2007";9;"129.3";3157;70451;67294
661;"23.10.2007";10;"119.9";2896;70874;67978
661;"23.10.2007";11;"139.8";2315;71308;68993
661;"23.10.2007";12;"153.7";2561;72148;69587
661;"23.10.2007";13;"92.7";3504;71375;67871
661;"23.10.2007";14;"91.9";4015;70738;66723
661;"23.10.2007";15;"86.4";4019;69740;65721
661;"23.10.2007";16;90;3829;69007;65178
661;"23.10.2007";17;80;3881;67680;63799
661;"23.10.2007";18;"80.5";3631;67685;64054
661;"23.10.2007";19;"94.3";3565;70571;67006
661;"23.10.2007";20;"95.1";4013;71822;67809
661;"23.10.2007";21;"80.5";4197;68136;63939
661;"23.10.2007";22;56;4425;64686;60261
661;"23.10.2007";23;53;4294;61804;57510
661;"23.10.2007";24;"46.6";4298;56963;52665
662;"24.10.2007";1;"37.5";4329;53475;49146
662;"24.10.2007";2;"40.4";4371;51400;47029
662;"24.10.2007";3;"32.6";4369;50171;45802
662;"24.10.2007";4;"27.1";4205;50344;46139
662;"24.10.2007";5;"29.9";4178;52057;47879
662;"24.10.2007";6;"45.4";3735;54859;51124
662;"24.10.2007";7;"61.7";3624;62062;58438
662;"24.10.2007";8;"87.5";3808;68959;65151
662;"24.10.2007";9;"111.9";3901;70770;66869
662;"24.10.2007";10;"199.8";3814;70908;67094
662;"24.10.2007";11;"199.8";3863;71446;67583
662;"24.10.2007";12;"199.8";3873;71895;68022
662;"24.10.2007";13;"129.3";3759;71451;67692
662;"24.10.2007";14;128;3635;70702;67067
662;"24.10.2007";15;"178.7";3465;69843;66378
662;"24.10.2007";16;"135.9";3358;69393;66035
662;"24.10.2007";17;110;3218;68095;64877
662;"24.10.2007";18;126;2924;68647;65723
662;"24.10.2007";19;"165.5";2887;71474;68587
662;"24.10.2007";20;250;3070;71164;68094
662;"24.10.2007";21;"116.3";3008;67820;64812
662;"24.10.2007";22;"75.9";2662;65202;62540
662;"24.10.2007";23;"56.5";2474;62561;60087
662;"24.10.2007";24;"42.3";2269;57455;55186
663;"25.10.2007";1;"56.4";1882;52912;51030
663;"25.10.2007";2;"45.7";1726;50531;48805
663;"25.10.2007";3;"41.2";1583;49266;47683
663;"25.10.2007";4;"36.9";1510;49404;47894
663;"25.10.2007";5;"31.9";1616;50702;49086
663;"25.10.2007";6;46;1660;53582;51922
663;"25.10.2007";7;"69.6";1651;60717;59066
663;"25.10.2007";8;115;1575;67524;65949
663;"25.10.2007";9;"171.5";1429;69704;68275
663;"25.10.2007";10;"199.9";1444;70043;68599
663;"25.10.2007";11;"235.1";1486;70629;69143
663;"25.10.2007";12;250;1532;71651;70119
663;"25.10.2007";13;"148.8";1723;70940;69217
663;"25.10.2007";14;"127.3";1912;70338;68426
663;"25.10.2007";15;"106.6";1852;69106;67254
663;"25.10.2007";16;"111.1";1773;68333;66560
663;"25.10.2007";17;"97.1";1575;67364;65789
663;"25.10.2007";18;"94.8";1508;67469;65961
663;"25.10.2007";19;"163.1";1447;70098;68651
663;"25.10.2007";20;"249.2";1529;70439;68910
663;"25.10.2007";21;99;1588;67673;66085
663;"25.10.2007";22;"69.3";1678;64686;63008
663;"25.10.2007";23;"54.4";1742;62229;60487
663;"25.10.2007";24;"40.4";1649;57387;55738
664;"26.10.2007";1;"43.9";1421;52720;51299
664;"26.10.2007";2;"35.5";1311;50023;48712
664;"26.10.2007";3;37;1233;48558;47325
664;"26.10.2007";4;"33.2";1223;48732;47509
664;"26.10.2007";5;35;1305;50240;48935
664;"26.10.2007";6;"35.7";1430;53161;51731
664;"26.10.2007";7;"59.1";1374;59484;58110
664;"26.10.2007";8;90;1368;66216;64848
664;"26.10.2007";9;"69.8";1449;69317;67868
664;"26.10.2007";10;84;1309;70400;69091
664;"26.10.2007";11;90;1248;71159;69911
664;"26.10.2007";12;94;1428;71812;70384
664;"26.10.2007";13;"70.1";1368;71083;69715
664;"26.10.2007";14;80;1125;69798;68673
664;"26.10.2007";15;"75.4";927;68345;67418
664;"26.10.2007";16;"61.6";898;66929;66031
664;"26.10.2007";17;"63.4";933;66193;65260
664;"26.10.2007";18;"73.9";899;66703;65804
664;"26.10.2007";19;"70.3";796;69597;68801
664;"26.10.2007";20;70;645;69834;69189
664;"26.10.2007";21;"78.1";552;66081;65529
664;"26.10.2007";22;"65.9";489;63023;62534
664;"26.10.2007";23;"59.6";403;61142;60739
664;"26.10.2007";24;"42.7";271;56936;56665
665;"27.10.2007";1;57;213;52380;52167
665;"27.10.2007";2;"55.9";172;49189;49017
665;"27.10.2007";3;50;177;47260;47083
665;"27.10.2007";4;38;193;47012;46819
665;"27.10.2007";5;"36.9";216;47554;47338
665;"27.10.2007";6;"35.6";278;47430;47152
665;"27.10.2007";7;"39.5";348;48404;48056
665;"27.10.2007";8;"42.6";413;51794;51381
665;"27.10.2007";9;"49.2";484;55673;55189
665;"27.10.2007";10;"64.5";491;58857;58366
665;"27.10.2007";11;"78.9";435;60445;60010
665;"27.10.2007";12;"80.1";399;61134;60735
665;"27.10.2007";13;"79.9";457;60300;59843
665;"27.10.2007";14;65;453;58153;57700
665;"27.10.2007";15;55;465;56667;56202
665;"27.10.2007";16;41;427;56153;55726
665;"27.10.2007";17;"45.5";478;55917;55439
665;"27.10.2007";18;"52.8";410;58034;57624
665;"27.10.2007";19;77;459;61495;61036
665;"27.10.2007";20;"80.1";574;60238;59664
665;"27.10.2007";21;"45.5";735;56402;55667
665;"27.10.2007";22;"32.1";864;54120;53256
665;"27.10.2007";23;"36.7";929;53229;52300
665;"27.10.2007";24;"27.2";1043;49773;48730
666;"28.10.2007";1;38;1172;46424;45252
666;"28.10.2007";2;34;1306;43834;42528
666;"28.10.2007";3;"27.8";1617;42543;40926
666;"28.10.2007";4;"28.3";1947;42254;40307
666;"28.10.2007";5;"26.4";2337;42382;40045
666;"28.10.2007";6;27;2620;41559;38939
666;"28.10.2007";7;"24.1";2695;41677;38982
666;"28.10.2007";8;"24.3";3016;44057;41041
666;"28.10.2007";9;"32.4";3038;47931;44893
666;"28.10.2007";10;"42.2";2768;50429;47661
666;"28.10.2007";11;"46.2";2919;52369;49450
666;"28.10.2007";12;"51.4";3277;54470;51193
666;"28.10.2007";13;"48.5";3735;52803;49068
666;"28.10.2007";14;"41.4";4146;50735;46589
666;"28.10.2007";15;36;4214;49067;44853
666;"28.10.2007";16;"32.2";3975;48652;44677
666;"28.10.2007";17;"32.3";4081;49723;45642
666;"28.10.2007";18;"45.9";4531;55802;51271
666;"28.10.2007";19;"67.1";5446;58265;52819
666;"28.10.2007";20;"56.3";6070;56944;50874
666;"28.10.2007";21;"47.5";6474;54533;48059
666;"28.10.2007";22;"41.5";6459;53891;47432
666;"28.10.2007";23;"42.9";6201;54345;48144
666;"28.10.2007";24;"31.6";5795;50105;44310
667;"29.10.2007";1;35;5524;48207;42683
667;"29.10.2007";2;"26.5";5439;46905;41466
667;"29.10.2007";3;"25.7";5364;46853;41489
667;"29.10.2007";4;"23.1";5514;47577;42063
667;"29.10.2007";5;"25.5";5549;49034;43485
667;"29.10.2007";6;38;5627;52792;47165
667;"29.10.2007";7;66;5063;60615;55552
667;"29.10.2007";8;"89.9";4562;66386;61824
667;"29.10.2007";9;"106.6";4130;68534;64404
667;"29.10.2007";10;"104.9";3521;68957;65436
667;"29.10.2007";11;94;2942;70096;67154
667;"29.10.2007";12;100;2339;71052;68713
667;"29.10.2007";13;"97.3";2181;70341;68160
667;"29.10.2007";14;95;1972;69976;68004
667;"29.10.2007";15;"91.9";1885;69291;67406
667;"29.10.2007";16;90;1553;68774;67221
667;"29.10.2007";17;"83.7";1309;68672;67363
667;"29.10.2007";18;180;1253;72135;70882
667;"29.10.2007";19;"198.7";1350;72647;71297
667;"29.10.2007";20;120;1586;70058;68472
667;"29.10.2007";21;"87.1";1447;66009;64562
667;"29.10.2007";22;"68.7";1489;63127;61638
667;"29.10.2007";23;"53.9";1413;60965;59552
667;"29.10.2007";24;"41.5";1541;54869;53328
668;"30.10.2007";1;"35.9";1513;50616;49103
668;"30.10.2007";2;"33.7";1699;48298;46599
668;"30.10.2007";3;"28.5";1541;47715;46174
668;"30.10.2007";4;"24.4";1484;48330;46846
668;"30.10.2007";5;"29.9";1454;50136;48682
668;"30.10.2007";6;"46.4";1475;53175;51700
668;"30.10.2007";7;"75.6";1539;60629;59090
668;"30.10.2007";8;"108.5";1745;66541;64796
668;"30.10.2007";9;"155.9";1644;68804;67160
668;"30.10.2007";10;115;1484;69258;67774
668;"30.10.2007";11;"115.1";1383;70158;68775
668;"30.10.2007";12;"129.9";1265;71459;70194
668;"30.10.2007";13;"103.9";1478;70437;68959
668;"30.10.2007";14;"119.4";1538;70273;68735
668;"30.10.2007";15;"107.5";1553;68892;67339
668;"30.10.2007";16;"103.4";1422;68530;67108
668;"30.10.2007";17;"117.6";1410;67956;66546
668;"30.10.2007";18;"147.9";1452;71927;70475
668;"30.10.2007";19;"219.2";1530;72690;71160
668;"30.10.2007";20;"123.8";1929;70602;68673
668;"30.10.2007";21;"97.2";2173;66216;64043
668;"30.10.2007";22;"63.9";2172;63062;60890
668;"30.10.2007";23;"60.1";2262;61224;58962
668;"30.10.2007";24;"39.1";2254;56141;53887
669;"31.10.2007";1;"40.7";2203;52174;49971
669;"31.10.2007";2;"34.2";2182;49869;47687
669;"31.10.2007";3;39;2336;49312;46976
669;"31.10.2007";4;"33.8";2582;49637;47055
669;"31.10.2007";5;"30.2";2704;50791;48087
669;"31.10.2007";6;"37.4";2777;53211;50434
669;"31.10.2007";7;"58.4";2634;59292;56658
669;"31.10.2007";8;79;2845;64178;61333
669;"31.10.2007";9;"72.1";2902;66278;63376
669;"31.10.2007";10;"80.1";2511;66377;63866
669;"31.10.2007";11;"88.2";2079;66930;64851
669;"31.10.2007";12;"92.9";2129;68363;66234
669;"31.10.2007";13;80;2412;67123;64711
669;"31.10.2007";14;"72.2";2691;66237;63546
669;"31.10.2007";15;"58.5";2739;65131;62392
669;"31.10.2007";16;"54.7";2651;64443;61792
669;"31.10.2007";17;73;2628;64723;62095
669;"31.10.2007";18;"82.1";2759;69681;66922
669;"31.10.2007";19;"80.4";3115;70933;67818
669;"31.10.2007";20;80;3583;68388;64805
669;"31.10.2007";21;"77.4";3859;64376;60517
669;"31.10.2007";22;"48.4";4018;61424;57406
669;"31.10.2007";23;"40.9";3999;59760;55761
669;"31.10.2007";24;"36.6";3977;55061;51084
670;"01.11.2007";1;"38.4";3655;50813;47158
670;"01.11.2007";2;"33.6";3512;48687;45175
670;"01.11.2007";3;"33.1";3519;47646;44127
670;"01.11.2007";4;"30.1";3449;47641;44192
670;"01.11.2007";5;"19.8";3428;47868;44440
670;"01.11.2007";6;"27.1";3319;48147;44828
670;"01.11.2007";7;22;3519;48430;44911
670;"01.11.2007";8;"29.1";3681;51360;47679
670;"01.11.2007";9;"33.8";3805;54065;50260
670;"01.11.2007";10;"37.5";3744;55729;51985
670;"01.11.2007";11;"39.1";3491;57661;54170
670;"01.11.2007";12;"40.1";3283;58869;55586
670;"01.11.2007";13;"39.9";3370;58554;55184
670;"01.11.2007";14;"39.1";3451;56972;53521
670;"01.11.2007";15;"35.1";3414;55366;51952
670;"01.11.2007";16;"32.3";3429;55138;51709
670;"01.11.2007";17;"23.1";3468;55862;52394
670;"01.11.2007";18;"46.7";3509;60518;57009
670;"01.11.2007";19;"74.6";3547;62924;59377
670;"01.11.2007";20;"69.1";3496;61376;57880
670;"01.11.2007";21;"43.2";3244;58478;55234
670;"01.11.2007";22;"36.6";2969;56404;53435
670;"01.11.2007";23;"44.1";2728;54913;52185
670;"01.11.2007";24;"39.1";2551;50936;48385
671;"02.11.2007";1;"25.8";2446;47261;44815
671;"02.11.2007";2;"26.1";2323;44922;42599
671;"02.11.2007";3;"23.1";2029;44219;42190
671;"02.11.2007";4;"19.1";1770;44743;42973
671;"02.11.2007";5;21;1524;46198;44674
671;"02.11.2007";6;32;1459;49205;47746
671;"02.11.2007";7;"31.6";1333;55284;53951
671;"02.11.2007";8;"58.1";1154;60603;59449
671;"02.11.2007";9;"69.9";993;63677;62684
671;"02.11.2007";10;71;904;64555;63651
671;"02.11.2007";11;"75.5";915;65390;64475
671;"02.11.2007";12;"70.6";764;66309;65545
671;"02.11.2007";13;"75.6";611;65817;65206
671;"02.11.2007";14;"70.6";542;64453;63911
671;"02.11.2007";15;70;482;63025;62543
671;"02.11.2007";16;"58.9";456;62612;62156
671;"02.11.2007";17;"58.9";435;63653;63218
671;"02.11.2007";18;95;545;68267;67722
671;"02.11.2007";19;100;548;69023;68475
671;"02.11.2007";20;"80.2";510;66437;65927
671;"02.11.2007";21;57;506;62154;61648
671;"02.11.2007";22;41;533;58834;58301
671;"02.11.2007";23;"40.8";609;57212;56603
671;"02.11.2007";24;"35.5";794;52782;51988
672;"03.11.2007";1;"43.7";1121;48835;47714
672;"03.11.2007";2;"34.9";1304;46260;44956
672;"03.11.2007";3;"31.6";1822;44832;43010
672;"03.11.2007";4;"27.9";2132;45010;42878
672;"03.11.2007";5;"21.1";2501;45609;43108
672;"03.11.2007";6;"26.1";3087;46325;43238
672;"03.11.2007";7;"21.6";3915;47367;43452
672;"03.11.2007";8;26;4204;50407;46203
672;"03.11.2007";9;33;4253;54587;50334
672;"03.11.2007";10;"41.1";4478;57921;53443
672;"03.11.2007";11;"42.1";4831;59547;54716
672;"03.11.2007";12;"41.9";4822;60301;55479
672;"03.11.2007";13;42;5050;59322;54272
672;"03.11.2007";14;"33.9";5362;57733;52371
672;"03.11.2007";15;"29.4";5493;56456;50963
672;"03.11.2007";16;"31.1";5369;56316;50947
672;"03.11.2007";17;31;5152;57530;52378
672;"03.11.2007";18;62;5084;62175;57091
672;"03.11.2007";19;"58.5";5015;62091;57076
672;"03.11.2007";20;46;4682;59344;54662
672;"03.11.2007";21;"33.6";4661;55481;50820
672;"03.11.2007";22;"25.2";4425;53937;49512
672;"03.11.2007";23;"28.2";4403;53114;48711
672;"03.11.2007";24;"20.9";4192;49423;45231
673;"04.11.2007";1;21;4283;46062;41779
673;"04.11.2007";2;"17.6";4601;43682;39081
673;"04.11.2007";3;"10.2";4868;42644;37776
673;"04.11.2007";4;"9.3";4818;42426;37608
673;"04.11.2007";5;6;4287;42890;38603
673;"04.11.2007";6;"10.3";3914;42329;38415
673;"04.11.2007";7;"9.2";3673;41675;38002
673;"04.11.2007";8;"16.5";3276;42736;39460
673;"04.11.2007";9;"21.5";2907;45824;42917
673;"04.11.2007";10;"25.1";2465;48851;46386
673;"04.11.2007";11;"34.6";2527;51361;48834
673;"04.11.2007";12;42;2480;54235;51755
673;"04.11.2007";13;"39.8";2333;53381;51048
673;"04.11.2007";14;"33.1";2140;51282;49142
673;"04.11.2007";15;"28.2";1937;49694;47757
673;"04.11.2007";16;23;1642;49483;47841
673;"04.11.2007";17;"23.6";1362;51431;50069
673;"04.11.2007";18;"41.9";1472;57330;55858
673;"04.11.2007";19;"65.1";1304;58947;57643
673;"04.11.2007";20;"62.1";1142;57260;56118
673;"04.11.2007";21;"47.9";881;54926;54045
673;"04.11.2007";22;"41.9";649;53635;52986
673;"04.11.2007";23;"42.8";450;53865;53415
673;"04.11.2007";24;"33.1";280;50023;49743
674;"05.11.2007";1;"26.1";227;46726;46499
674;"05.11.2007";2;23;229;45140;44911
674;"05.11.2007";3;21;249;44948;44699
674;"05.11.2007";4;"20.1";261;45972;45711
674;"05.11.2007";5;"24.1";337;47770;47433
674;"05.11.2007";6;"32.2";380;51415;51035
674;"05.11.2007";7;"54.5";445;60253;59808
674;"05.11.2007";8;"100.1";572;65759;65187
674;"05.11.2007";9;"118.2";796;67514;66718
674;"05.11.2007";10;"115.6";856;67288;66432
674;"05.11.2007";11;"129.4";826;67961;67135
674;"05.11.2007";12;"151.2";890;68955;68065
674;"05.11.2007";13;"120.1";1304;68356;67052
674;"05.11.2007";14;121;1856;68102;66246
674;"05.11.2007";15;110;2242;67390;65148
674;"05.11.2007";16;"118.2";2603;67381;64778
674;"05.11.2007";17;"116.7";2966;67818;64852
674;"05.11.2007";18;"207.5";3772;72623;68851
674;"05.11.2007";19;200;4745;72844;68099
674;"05.11.2007";20;108;5870;71215;65345
674;"05.11.2007";21;"79.1";7007;67502;60495
674;"05.11.2007";22;"51.3";7923;64605;56682
674;"05.11.2007";23;"42.1";8369;62491;54122
674;"05.11.2007";24;"32.5";8885;57503;48618
675;"06.11.2007";1;"27.1";9261;53647;44386
675;"06.11.2007";2;23;9770;51831;42061
675;"06.11.2007";3;"21.5";10115;51083;40968
675;"06.11.2007";4;"13.6";9914;51791;41877
675;"06.11.2007";5;"21.5";9594;53498;43904
675;"06.11.2007";6;"31.9";9497;56638;47141
675;"06.11.2007";7;"36.1";9807;64502;54695
675;"06.11.2007";8;"67.1";9950;69693;59743
675;"06.11.2007";9;"73.8";10016;71314;61298
675;"06.11.2007";10;"70.4";10725;71455;60730
675;"06.11.2007";11;"70.1";11447;72973;61526
675;"06.11.2007";12;"77.9";12326;74327;62001
675;"06.11.2007";13;"70.4";13342;73899;60557
675;"06.11.2007";14;"73.1";13262;73476;60214
675;"06.11.2007";15;"64.5";13299;72958;59659
675;"06.11.2007";16;"62.8";12864;72285;59421
675;"06.11.2007";17;"68.7";12083;72030;59947
675;"06.11.2007";18;"86.8";11156;75654;64498
675;"06.11.2007";19;"99.4";10456;75772;65316
675;"06.11.2007";20;80;9925;73498;63573
675;"06.11.2007";21;"60.8";9373;69610;60237
675;"06.11.2007";22;"44.4";8532;66215;57683
675;"06.11.2007";23;"39.7";8039;63564;55525
675;"06.11.2007";24;"29.3";7730;58903;51173
676;"07.11.2007";1;"31.2";7106;54566;47460
676;"07.11.2007";2;"24.7";7361;51934;44573
676;"07.11.2007";3;"17.5";8371;51140;42769
676;"07.11.2007";4;"19.9";9884;52032;42148
676;"07.11.2007";5;18;11333;54083;42750
676;"07.11.2007";6;"28.9";13016;57756;44740
676;"07.11.2007";7;"43.9";14760;65964;51204
676;"07.11.2007";8;"52.1";15317;72150;56833
676;"07.11.2007";9;"71.3";16156;74811;58655
676;"07.11.2007";10;"71.3";16508;75661;59153
676;"07.11.2007";11;"71.3";16629;76812;60183
676;"07.11.2007";12;"79.1";16093;77694;61601
676;"07.11.2007";13;"69.9";15985;77232;61247
676;"07.11.2007";14;74;16060;76954;60894
676;"07.11.2007";15;"71.3";16042;76443;60401
676;"07.11.2007";16;"55.1";15705;75866;60161
676;"07.11.2007";17;76;15739;76174;60435
676;"07.11.2007";18;92;14932;78377;63445
676;"07.11.2007";19;86;14765;77611;62846
676;"07.11.2007";20;"66.2";14314;75479;61165
676;"07.11.2007";21;"51.8";13872;71504;57632
676;"07.11.2007";22;35;13083;68169;55086
676;"07.11.2007";23;"30.8";12331;65450;53119
676;"07.11.2007";24;23;11354;60216;48862
677;"08.11.2007";1;"32.5";10721;55361;44640
677;"08.11.2007";2;"24.5";9813;52766;42953
677;"08.11.2007";3;"22.2";8941;51306;42365
677;"08.11.2007";4;"20.8";8233;51464;43231
677;"08.11.2007";5;22;7624;52765;45141
677;"08.11.2007";6;"35.6";7051;55746;48695
677;"08.11.2007";7;55;6352;63321;56969
677;"08.11.2007";8;"84.9";6208;69046;62838
677;"08.11.2007";9;"92.6";5907;70423;64516
677;"08.11.2007";10;"102.7";5408;70212;64804
677;"08.11.2007";11;"99.9";5594;71153;65559
677;"08.11.2007";12;100;6352;72682;66330
677;"08.11.2007";13;86;7202;72226;65024
677;"08.11.2007";14;84;8167;72203;64036
677;"08.11.2007";15;80;8852;71959;63107
677;"08.11.2007";16;"73.7";9495;72102;62607
677;"08.11.2007";17;"64.2";10385;73041;62656
677;"08.11.2007";18;94;11178;76021;64843
677;"08.11.2007";19;"103.9";11654;75620;63966
677;"08.11.2007";20;"69.8";11958;73767;61809
677;"08.11.2007";21;"58.9";11392;69587;58195
677;"08.11.2007";22;"38.3";11109;66851;55742
677;"08.11.2007";23;31;10368;64069;53701
677;"08.11.2007";24;"20.3";9581;58524;48943
678;"09.11.2007";1;"28.9";9364;53795;44431
678;"09.11.2007";2;"23.1";10180;51698;41518
678;"09.11.2007";3;"17.1";10067;51189;41122
678;"09.11.2007";4;"18.4";10382;52134;41752
678;"09.11.2007";5;"20.8";10253;53812;43559
678;"09.11.2007";6;"32.8";10987;56807;45820
678;"09.11.2007";7;"30.4";11484;64452;52968
678;"09.11.2007";8;"58.9";12373;70380;58007
678;"09.11.2007";9;"60.5";13179;72803;59624
678;"09.11.2007";10;"60.4";14448;73727;59279
678;"09.11.2007";11;53;15306;75007;59701
678;"09.11.2007";12;"65.2";16104;76110;60006
678;"09.11.2007";13;"61.1";16967;75695;58728
678;"09.11.2007";14;55;17286;74512;57226
678;"09.11.2007";15;"44.3";16930;73396;56466
678;"09.11.2007";16;"39.6";16564;72469;55905
678;"09.11.2007";17;"43.9";16548;73096;56548
678;"09.11.2007";18;"73.1";16213;76170;59957
678;"09.11.2007";19;"68.9";15314;75694;60380
678;"09.11.2007";20;"53.2";15264;73167;57903
678;"09.11.2007";21;"44.3";14472;69198;54726
678;"09.11.2007";22;"39.6";14574;66333;51759
678;"09.11.2007";23;"33.3";14048;64666;50618
678;"09.11.2007";24;"21.9";13563;60778;47215
679;"10.11.2007";1;"20.9";12991;56797;43806
679;"10.11.2007";2;"17.6";12365;54878;42513
679;"10.11.2007";3;"17.5";11374;53364;41990
679;"10.11.2007";4;"17.5";10757;52635;41878
679;"10.11.2007";5;"21.6";10302;52304;42002
679;"10.11.2007";6;"21.4";9267;50502;41235
679;"10.11.2007";7;18;7863;49991;42128
679;"10.11.2007";8;"21.5";7042;53151;46109
679;"10.11.2007";9;"26.5";6108;57039;50931
679;"10.11.2007";10;"33.1";6102;60706;54604
679;"10.11.2007";11;36;6265;62481;56216
679;"10.11.2007";12;40;6693;63393;56700
679;"10.11.2007";13;"44.6";7604;62221;54617
679;"10.11.2007";14;"37.4";8414;60920;52506
679;"10.11.2007";15;"32.8";8776;59387;50611
679;"10.11.2007";16;"28.7";7753;58778;51025
679;"10.11.2007";17;34;7224;59881;52657
679;"10.11.2007";18;"45.9";6774;64368;57594
679;"10.11.2007";19;"46.3";7093;64241;57148
679;"10.11.2007";20;"40.3";6854;61620;54766
679;"10.11.2007";21;"25.1";6293;57985;51692
679;"10.11.2007";22;"26.2";5726;56179;50453
679;"10.11.2007";23;"27.5";5417;55843;50426
679;"10.11.2007";24;"21.9";5576;52628;47052
680;"11.11.2007";1;"17.4";5656;48795;43139
680;"11.11.2007";2;"9.2";5670;46154;40484
680;"11.11.2007";3;5;6043;44777;38734
680;"11.11.2007";4;"4.3";7255;43987;36732
680;"11.11.2007";5;"4.2";8379;43810;35431
680;"11.11.2007";6;"4.3";8739;43016;34277
680;"11.11.2007";7;"0.1";9242;42031;32789
680;"11.11.2007";8;"3.8";9499;43745;34246
680;"11.11.2007";9;"9.2";9316;47859;38543
680;"11.11.2007";10;"17.6";9225;51460;42235
680;"11.11.2007";11;"26.5";8926;54617;45691
680;"11.11.2007";12;"33.1";8290;57605;49315
680;"11.11.2007";13;"28.2";7687;56752;49065
680;"11.11.2007";14;"24.6";7215;54416;47201
680;"11.11.2007";15;"20.4";6933;52754;45821
680;"11.11.2007";16;"19.1";6026;52233;46207
680;"11.11.2007";17;25;5783;53599;47816
680;"11.11.2007";18;"36.5";6153;58770;52617
680;"11.11.2007";19;"41.3";5996;59537;53541
680;"11.11.2007";20;"38.1";6210;58486;52276
680;"11.11.2007";21;35;6852;56698;49846
680;"11.11.2007";22;"27.9";7068;55849;48781
680;"11.11.2007";23;"31.5";6656;56659;50003
680;"11.11.2007";24;"20.8";7219;53284;46065
681;"12.11.2007";1;"10.8";7370;50366;42996
681;"12.11.2007";2;"7.2";7881;48703;40822
681;"12.11.2007";3;4;8349;48577;40228
681;"12.11.2007";4;4;8664;49448;40784
681;"12.11.2007";5;"7.2";8846;50870;42024
681;"12.11.2007";6;"21.9";9011;54816;45805
681;"12.11.2007";7;38;9544;62962;53418
681;"12.11.2007";8;"61.2";9860;68697;58837
681;"12.11.2007";9;"61.4";9759;70386;60627
681;"12.11.2007";10;"72.5";9339;70566;61227
681;"12.11.2007";11;"73.4";9118;71753;62635
681;"12.11.2007";12;"73.1";8894;72641;63747
681;"12.11.2007";13;58;8407;71876;63469
681;"12.11.2007";14;"60.7";7974;71665;63691
681;"12.11.2007";15;"55.4";7767;71089;63322
681;"12.11.2007";16;"58.1";6803;70159;63356
681;"12.11.2007";17;"72.6";6515;70850;64335
681;"12.11.2007";18;110;6478;74382;67904
681;"12.11.2007";19;120;6588;73867;67279
681;"12.11.2007";20;100;6105;71819;65714
681;"12.11.2007";21;"71.2";6216;68180;61964
681;"12.11.2007";22;"45.9";5759;64928;59169
681;"12.11.2007";23;"40.3";5770;62960;57190
681;"12.11.2007";24;34;5698;57761;52063
682;"13.11.2007";1;"34.5";5532;54412;48880
682;"13.11.2007";2;"26.4";5467;52424;46957
682;"13.11.2007";3;"27.4";5787;51865;46078
682;"13.11.2007";4;"25.9";5738;52183;46445
682;"13.11.2007";5;17;5662;53066;47404
682;"13.11.2007";6;"41.9";5608;55650;50042
682;"13.11.2007";7;"59.9";5663;62662;56999
682;"13.11.2007";8;"84.4";5557;68721;63164
682;"13.11.2007";9;"81.9";5660;70113;64453
682;"13.11.2007";10;79;5446;70317;64871
682;"13.11.2007";11;"80.1";5155;71201;66046
682;"13.11.2007";12;"96.9";5203;72063;66860
682;"13.11.2007";13;"82.2";5172;71763;66591
682;"13.11.2007";14;"80.9";5139;71863;66724
682;"13.11.2007";15;87;5023;71524;66501
682;"13.11.2007";16;"80.1";4574;71318;66744
682;"13.11.2007";17;"105.3";3725;71726;68001
682;"13.11.2007";18;"282.2";3470;74463;70993
682;"13.11.2007";19;"185.1";3188;73568;70380
682;"13.11.2007";20;85;2980;71295;68315
682;"13.11.2007";21;"61.2";2444;67367;64923
682;"13.11.2007";22;58;2136;64124;61988
682;"13.11.2007";23;"56.1";2129;61809;59680
682;"13.11.2007";24;"45.7";2122;56830;54708
683;"14.11.2007";1;"69.8";2082;53144;51062
683;"14.11.2007";2;50;2244;51238;48994
683;"14.11.2007";3;"42.8";2468;50871;48403
683;"14.11.2007";4;"49.4";2747;51362;48615
683;"14.11.2007";5;"55.1";3125;52537;49412
683;"14.11.2007";6;"58.1";3295;54701;51406
683;"14.11.2007";7;"61.1";3221;61923;58702
683;"14.11.2007";8;130;3251;68399;65148
683;"14.11.2007";9;"130.7";3580;70165;66585
683;"14.11.2007";10;"130.5";3469;70572;67103
683;"14.11.2007";11;"158.4";3265;71401;68136
683;"14.11.2007";12;"149.3";3883;72351;68468
683;"14.11.2007";13;"114.4";4118;71636;67518
683;"14.11.2007";14;"114.3";4042;71297;67255
683;"14.11.2007";15;"106.1";3622;70531;66909
683;"14.11.2007";16;"89.9";3849;69989;66140
683;"14.11.2007";17;"109.9";3838;70813;66975
683;"14.11.2007";18;"300.1";3627;74209;70582
683;"14.11.2007";19;"361.3";3847;73746;69899
683;"14.11.2007";20;"200.1";3484;71371;67887
683;"14.11.2007";21;"85.1";3256;67572;64316
683;"14.11.2007";22;"61.1";3203;64734;61531
683;"14.11.2007";23;"63.1";3229;62689;59460
683;"14.11.2007";24;"47.7";2781;58225;55444
684;"15.11.2007";1;"35.6";2625;54376;51751
684;"15.11.2007";2;"26.2";2467;52245;49778
684;"15.11.2007";3;"23.1";2243;51368;49125
684;"15.11.2007";4;"17.6";2248;51524;49276
684;"15.11.2007";5;"22.9";2161;52451;50290
684;"15.11.2007";6;"31.4";2077;54969;52892
684;"15.11.2007";7;"44.7";2216;61663;59447
684;"15.11.2007";8;"79.9";2079;67329;65250
684;"15.11.2007";9;"80.9";1919;67883;65964
684;"15.11.2007";10;155;1533;68414;66881
684;"15.11.2007";11;"171.1";1162;68989;67827
684;"15.11.2007";12;"171.7";1088;70099;69011
684;"15.11.2007";13;"147.6";1018;69571;68553
684;"15.11.2007";14;"124.9";1090;69094;68004
684;"15.11.2007";15;"109.9";1127;69150;68023
684;"15.11.2007";16;"120.1";966;69099;68133
684;"15.11.2007";17;250;903;69363;68460
684;"15.11.2007";18;"821.9";1073;73308;72235
684;"15.11.2007";19;701;1055;72848;71793
684;"15.11.2007";20;"96.2";973;71171;70198
684;"15.11.2007";21;"100.2";1016;67497;66481
684;"15.11.2007";22;"62.9";1087;64903;63816
684;"15.11.2007";23;58;1180;62874;61694
684;"15.11.2007";24;"38.7";1286;58574;57288
685;"16.11.2007";1;53;1344;55330;53986
685;"16.11.2007";2;"43.5";1515;53378;51863
685;"16.11.2007";3;"33.2";1657;52472;50815
685;"16.11.2007";4;31;1811;52702;50891
685;"16.11.2007";5;"35.4";1859;53810;51951
685;"16.11.2007";6;41;2055;56178;54123
685;"16.11.2007";7;"65.1";2197;62674;60477
685;"16.11.2007";8;"84.9";2247;68496;66249
685;"16.11.2007";9;"104.1";2292;69934;67642
685;"16.11.2007";10;100;2484;70186;67702
685;"16.11.2007";11;"99.9";2281;70602;68321
685;"16.11.2007";12;"90.1";2186;71228;69042
685;"16.11.2007";13;"80.2";2206;70349;68143
685;"16.11.2007";14;"78.5";2265;69069;66804
685;"16.11.2007";15;"60.5";2203;67781;65578
685;"16.11.2007";16;"53.7";2298;67456;65158
685;"16.11.2007";17;"57.8";2490;69134;66644
685;"16.11.2007";18;"107.3";2698;73240;70542
685;"16.11.2007";19;100;2900;72174;69274
685;"16.11.2007";20;"78.4";2904;69876;66972
685;"16.11.2007";21;"65.1";2796;65916;63120
685;"16.11.2007";22;"44.3";2889;63003;60114
685;"16.11.2007";23;"51.6";2934;61918;58984
685;"16.11.2007";24;"41.5";2839;58294;55455
686;"17.11.2007";1;"52.5";2857;54743;51886
686;"17.11.2007";2;"50.9";2778;52299;49521
686;"17.11.2007";3;"44.3";2745;50757;48012
686;"17.11.2007";4;"40.1";2710;50240;47530
686;"17.11.2007";5;"33.9";2543;49924;47381
686;"17.11.2007";6;"40.4";2424;49518;47094
686;"17.11.2007";7;"26.1";2395;49235;46840
686;"17.11.2007";8;"33.7";2422;53103;50681
686;"17.11.2007";9;"42.1";2383;56729;54346
686;"17.11.2007";10;"64.6";2236;59808;57572
686;"17.11.2007";11;"80.1";1942;61266;59324
686;"17.11.2007";12;"80.3";1684;61993;60309
686;"17.11.2007";13;"73.1";1475;61197;59722
686;"17.11.2007";14;"45.4";1277;59223;57946
686;"17.11.2007";15;"45.4";1278;57958;56680
686;"17.11.2007";16;"49.9";1107;57868;56761
686;"17.11.2007";17;74;1038;59924;58886
686;"17.11.2007";18;110;993;64197;63204
686;"17.11.2007";19;120;984;63500;62516
686;"17.11.2007";20;"77.8";1067;60934;59867
686;"17.11.2007";21;"48.2";1070;57256;56186
686;"17.11.2007";22;"39.9";1042;55391;54349
686;"17.11.2007";23;"45.2";1044;55638;54594
686;"17.11.2007";24;"33.1";997;52708;51711
687;"18.11.2007";1;"34.2";935;49331;48396
687;"18.11.2007";2;"31.2";966;46623;45657
687;"18.11.2007";3;"29.7";913;45427;44514
687;"18.11.2007";4;"26.2";872;45077;44205
687;"18.11.2007";5;"26.1";746;44861;44115
687;"18.11.2007";6;"25.3";750;43621;42871
687;"18.11.2007";7;"13.5";630;41487;40857
687;"18.11.2007";8;"19.4";755;42931;42176
687;"18.11.2007";9;"24.9";957;46151;45194
687;"18.11.2007";10;"33.4";930;50157;49227
687;"18.11.2007";11;"39.1";1056;52998;51942
687;"18.11.2007";12;49;1066;55523;54457
687;"18.11.2007";13;43;1174;54350;53176
687;"18.11.2007";14;"34.8";1439;52079;50640
687;"18.11.2007";15;"27.3";1762;50503;48741
687;"18.11.2007";16;23;2318;50444;48126
687;"18.11.2007";17;"28.1";2877;53072;50195
687;"18.11.2007";18;"48.9";3410;58660;55250
687;"18.11.2007";19;"54.9";3873;59675;55802
687;"18.11.2007";20;49;4231;58211;53980
687;"18.11.2007";21;"44.3";4694;56235;51541
687;"18.11.2007";22;"37.4";5140;55481;50341
687;"18.11.2007";23;"40.5";5153;56796;51643
687;"18.11.2007";24;"30.5";5477;53490;48013
688;"19.11.2007";1;"31.2";5647;50623;44976
688;"19.11.2007";2;"25.1";5752;48914;43162
688;"19.11.2007";3;"22.6";6190;48567;42377
688;"19.11.2007";4;21;6567;48937;42370
688;"19.11.2007";5;"23.9";7069;50582;43513
688;"19.11.2007";6;"31.2";7037;54098;47061
688;"19.11.2007";7;41;6585;62494;55909
688;"19.11.2007";8;"82.3";6333;69043;62710
688;"19.11.2007";9;"94.4";5961;70839;64878
688;"19.11.2007";10;"99.2";5265;71335;66070
688;"19.11.2007";11;"100.1";4890;72023;67133
688;"19.11.2007";12;121;4797;73235;68438
688;"19.11.2007";13;"100.1";4208;72803;68595
688;"19.11.2007";14;117;3763;72375;68612
688;"19.11.2007";15;"130.1";3015;71484;68469
688;"19.11.2007";16;125;2751;71255;68504
688;"19.11.2007";17;"120.4";2902;72284;69382
688;"19.11.2007";18;"300.1";3082;74516;71434
688;"19.11.2007";19;"274.1";2953;73175;70222
688;"19.11.2007";20;"137.2";2661;71483;68822
688;"19.11.2007";21;"106.4";2402;67798;65396
688;"19.11.2007";22;"54.9";2487;65196;62709
688;"19.11.2007";23;"52.5";2230;63038;60808
688;"19.11.2007";24;"43.6";2120;57980;55860
689;"20.11.2007";1;"71.1";1948;54791;52843
689;"20.11.2007";2;55;1888;53015;51127
689;"20.11.2007";3;"47.8";1917;51992;50075
689;"20.11.2007";4;40;1897;52125;50228
689;"20.11.2007";5;"38.6";1918;53274;51356
689;"20.11.2007";6;"58.1";2055;55952;53897
689;"20.11.2007";7;87;2074;62990;60916
689;"20.11.2007";8;301;2201;69251;67050
689;"20.11.2007";9;"437.3";2106;70716;68610
689;"20.11.2007";10;"249.9";2018;71362;69344
689;"20.11.2007";11;"240.7";2010;71834;69824
689;"20.11.2007";12;"168.9";2157;72495;70338
689;"20.11.2007";13;"122.1";2044;71740;69696
689;"20.11.2007";14;"127.3";2214;71341;69127
689;"20.11.2007";15;"120.9";2406;70533;68127
689;"20.11.2007";16;116;2851;70431;67580
689;"20.11.2007";17;"136.3";3588;72099;68511
689;"20.11.2007";18;"141.7";4197;75217;71020
689;"20.11.2007";19;"121.9";4608;74624;70016
689;"20.11.2007";20;109;4784;72637;67853
689;"20.11.2007";21;"85.9";4894;68583;63689
689;"20.11.2007";22;"65.2";4564;65407;60843
689;"20.11.2007";23;"56.9";4531;63509;58978
689;"20.11.2007";24;"51.4";4618;58209;53591
690;"21.11.2007";1;"36.2";4713;54433;49720
690;"21.11.2007";2;"35.9";4508;52114;47606
690;"21.11.2007";3;"31.9";4562;51122;46560
690;"21.11.2007";4;25;5200;51601;46401
690;"21.11.2007";5;27;5305;52686;47381
690;"21.11.2007";6;"34.4";5614;55167;49553
690;"21.11.2007";7;"50.8";5492;61518;56026
690;"21.11.2007";8;77;5510;68219;62709
690;"21.11.2007";9;"80.1";5557;70060;64503
690;"21.11.2007";10;108;5480;69946;64466
690;"21.11.2007";11;"109.3";4913;70983;66070
690;"21.11.2007";12;"125.7";4280;71998;67718
690;"21.11.2007";13;120;3601;71178;67577
690;"21.11.2007";14;122;3194;70557;67363
690;"21.11.2007";15;"117.9";2982;69941;66959
690;"21.11.2007";16;"111.9";3052;69715;66663
690;"21.11.2007";17;150;3117;70629;67512
690;"21.11.2007";18;"189.5";3159;74241;71082
690;"21.11.2007";19;"193.1";3035;73420;70385
690;"21.11.2007";20;165;3073;71160;68087
690;"21.11.2007";21;86;3131;67377;64246
690;"21.11.2007";22;"66.6";3246;64535;61289
690;"21.11.2007";23;"61.1";3227;62468;59241
690;"21.11.2007";24;"53.1";3456;57620;54164
691;"22.11.2007";1;"54.9";3686;54089;50403
691;"22.11.2007";2;"39.2";3507;51471;47964
691;"22.11.2007";3;"36.7";3239;50366;47127
691;"22.11.2007";4;"36.3";3223;50768;47545
691;"22.11.2007";5;40;3169;52218;49049
691;"22.11.2007";6;45;3037;55007;51970
691;"22.11.2007";7;"71.2";3011;62315;59304
691;"22.11.2007";8;"97.6";2939;68845;65906
691;"22.11.2007";9;140;2656;69855;67199
691;"22.11.2007";10;132;2517;69731;67214
691;"22.11.2007";11;"141.6";2096;70501;68405
691;"22.11.2007";12;"126.9";1835;71500;69665
691;"22.11.2007";13;121;1656;70798;69142
691;"22.11.2007";14;119;1826;70451;68625
691;"22.11.2007";15;119;1841;69359;67518
691;"22.11.2007";16;"111.2";1856;69649;67793
691;"22.11.2007";17;"122.1";2612;71181;68569
691;"22.11.2007";18;190;3261;74130;70869
691;"22.11.2007";19;190;3519;73695;70176
691;"22.11.2007";20;"128.9";3561;71411;67850
691;"22.11.2007";21;"87.9";3742;67488;63746
691;"22.11.2007";22;"71.1";3889;64509;60620
691;"22.11.2007";23;"57.9";3969;62385;58416
691;"22.11.2007";24;"49.5";3652;57316;53664
692;"23.11.2007";1;"34.5";3545;53130;49585
692;"23.11.2007";2;"31.3";3368;50720;47352
692;"23.11.2007";3;"30.1";3045;49894;46849
692;"23.11.2007";4;"27.7";2804;50348;47544
692;"23.11.2007";5;28;2614;51434;48820
692;"23.11.2007";6;"34.4";2688;54410;51722
692;"23.11.2007";7;"62.2";2699;61472;58773
692;"23.11.2007";8;"114.2";2288;68322;66034
692;"23.11.2007";9;"119.3";2005;69778;67773
692;"23.11.2007";10;118;1696;70378;68682
692;"23.11.2007";11;"138.5";1705;71277;69572
692;"23.11.2007";12;"147.2";1650;71720;70070
692;"23.11.2007";13;"115.1";2019;71155;69136
692;"23.11.2007";14;"110.1";2085;70378;68293
692;"23.11.2007";15;"101.9";1891;69207;67316
692;"23.11.2007";16;"95.9";1912;68701;66789
692;"23.11.2007";17;"115.1";2180;70444;68264
692;"23.11.2007";18;"198.9";2638;72549;69911
692;"23.11.2007";19;"131.9";3135;71100;67965
692;"23.11.2007";20;"113.9";3779;68753;64974
692;"23.11.2007";21;"79.7";4346;64866;60520
692;"23.11.2007";22;"52.7";4584;62648;58064
692;"23.11.2007";23;"53.5";4467;61799;57332
692;"23.11.2007";24;"34.9";4341;57814;53473
693;"24.11.2007";1;"45.9";4145;53707;49562
693;"24.11.2007";2;"43.9";3923;51287;47364
693;"24.11.2007";3;"41.6";3938;50156;46218
693;"24.11.2007";4;"35.9";3798;49931;46133
693;"24.11.2007";5;"29.1";3394;50151;46757
693;"24.11.2007";6;32;2829;49655;46826
693;"24.11.2007";7;"31.2";2648;49792;47144
693;"24.11.2007";8;"44.6";2387;53301;50914
693;"24.11.2007";9;"60.1";2160;56678;54518
693;"24.11.2007";10;"84.8";1912;59471;57559
693;"24.11.2007";11;"75.1";1798;60825;59027
693;"24.11.2007";12;"76.9";1714;61358;59644
693;"24.11.2007";13;"73.5";1822;60078;58256
693;"24.11.2007";14;76;2103;58117;56014
693;"24.11.2007";15;64;2690;56623;53933
693;"24.11.2007";16;"60.3";3277;56866;53589
693;"24.11.2007";17;"48.4";4260;59428;55168
693;"24.11.2007";18;"83.1";5551;64137;58586
693;"24.11.2007";19;"53.7";6837;63993;57156
693;"24.11.2007";20;"46.5";8353;61917;53564
693;"24.11.2007";21;"41.1";9582;58125;48543
693;"24.11.2007";22;"33.3";10558;56326;45768
693;"24.11.2007";23;"34.4";11140;56536;45396
693;"24.11.2007";24;"30.4";11464;54468;43004
694;"25.11.2007";1;"30.4";11630;52089;40459
694;"25.11.2007";2;"24.2";11795;49742;37947
694;"25.11.2007";3;"17.7";11902;48263;36361
694;"25.11.2007";4;"10.3";11358;47652;36294
694;"25.11.2007";5;5;10933;47225;36292
694;"25.11.2007";6;"9.2";11120;46422;35302
694;"25.11.2007";7;0;11044;44740;33696
694;"25.11.2007";8;"4.1";10905;46013;35108
694;"25.11.2007";9;"13.5";11046;49086;38040
694;"25.11.2007";10;"25.7";11422;52746;41324
694;"25.11.2007";11;34;11679;55960;44281
694;"25.11.2007";12;42;12310;58989;46679
694;"25.11.2007";13;"39.6";12569;58767;46198
694;"25.11.2007";14;"33.8";12484;56721;44237
694;"25.11.2007";15;"27.3";12454;55285;42831
694;"25.11.2007";16;"20.1";11947;54833;42886
694;"25.11.2007";17;24;11900;57227;45327
694;"25.11.2007";18;"44.5";12023;60503;48480
694;"25.11.2007";19;"44.4";11778;61178;49400
694;"25.11.2007";20;"40.8";11534;59825;48291
694;"25.11.2007";21;"33.8";11967;58084;46117
694;"25.11.2007";22;"29.8";12286;57469;45183
694;"25.11.2007";23;"32.8";12868;58721;45853
694;"25.11.2007";24;"19.4";13041;55694;42653
695;"26.11.2007";1;21;13291;52987;39696
695;"26.11.2007";2;"17.5";13177;51282;38105
695;"26.11.2007";3;"12.7";12752;50767;38015
695;"26.11.2007";4;"11.3";12329;51134;38805
695;"26.11.2007";5;"14.4";12078;52488;40410
695;"26.11.2007";6;"24.1";11683;55753;44070
695;"26.11.2007";7;33;11301;63767;52466
695;"26.11.2007";8;"73.1";10935;70261;59326
695;"26.11.2007";9;"76.7";10571;71991;61420
695;"26.11.2007";10;"79.3";10316;71989;61673
695;"26.11.2007";11;"80.8";10655;72970;62315
695;"26.11.2007";12;"84.1";10970;74255;63285
695;"26.11.2007";13;"83.1";11552;74107;62555
695;"26.11.2007";14;"83.7";11663;73759;62096
695;"26.11.2007";15;80;11493;73137;61644
695;"26.11.2007";16;"72.6";10592;73034;62442
695;"26.11.2007";17;"83.1";9431;73968;64537
695;"26.11.2007";18;"115.1";9592;76986;67394
695;"26.11.2007";19;"111.1";9113;75754;66641
695;"26.11.2007";20;"84.6";9242;73603;64361
695;"26.11.2007";21;"58.9";9068;69540;60472
695;"26.11.2007";22;45;8790;66964;58174
695;"26.11.2007";23;"45.8";8836;65016;56180
695;"26.11.2007";24;33;8785;60368;51583
696;"27.11.2007";1;30;8341;56879;48538
696;"27.11.2007";2;27;8178;55132;46954
696;"27.11.2007";3;"26.5";7950;53926;45976
696;"27.11.2007";4;"21.2";7548;53895;46347
696;"27.11.2007";5;"20.8";7281;54707;47426
696;"27.11.2007";6;"35.3";6805;56939;50134
696;"27.11.2007";7;"47.8";6260;64398;58138
696;"27.11.2007";8;"81.2";5645;70652;65007
696;"27.11.2007";9;69;4954;72007;67053
696;"27.11.2007";10;"75.1";4443;71516;67073
696;"27.11.2007";11;"78.3";3810;72143;68333
696;"27.11.2007";12;"79.9";3312;72942;69630
696;"27.11.2007";13;85;3413;72392;68979
696;"27.11.2007";14;90;3205;72005;68800
696;"27.11.2007";15;90;2968;71411;68443
696;"27.11.2007";16;"87.1";2427;71283;68856
696;"27.11.2007";17;"90.1";2201;72771;70570
696;"27.11.2007";18;"120.6";2002;75721;73719
696;"27.11.2007";19;"115.1";1955;74997;73042
696;"27.11.2007";20;99;1963;72877;70914
696;"27.11.2007";21;"84.8";1937;69121;67184
696;"27.11.2007";22;58;2005;66018;64013
696;"27.11.2007";23;63;1781;63995;62214
696;"27.11.2007";24;"40.6";1483;59027;57544
697;"28.11.2007";1;"55.3";1357;55582;54225
697;"28.11.2007";2;41;1212;53814;52602
697;"28.11.2007";3;"35.3";1213;52720;51507
697;"28.11.2007";4;"32.4";1194;52977;51783
697;"28.11.2007";5;"32.5";1393;54096;52703
697;"28.11.2007";6;"43.9";1516;56517;55001
697;"28.11.2007";7;"55.9";1756;63567;61811
697;"28.11.2007";8;"93.9";2019;70306;68287
697;"28.11.2007";9;108;2347;71263;68916
697;"28.11.2007";10;110;2522;70968;68446
697;"28.11.2007";11;"104.5";2420;71168;68748
697;"28.11.2007";12;"106.7";2467;71977;69510
697;"28.11.2007";13;"96.6";2601;71514;68913
697;"28.11.2007";14;105;2748;70896;68148
697;"28.11.2007";15;96;2856;70283;67427
697;"28.11.2007";16;82;3067;70204;67137
697;"28.11.2007";17;"93.9";3732;72139;68407
697;"28.11.2007";18;"115.1";4296;75838;71542
697;"28.11.2007";19;"110.7";4866;75048;70182
697;"28.11.2007";20;83;5123;73121;67998
697;"28.11.2007";21;70;5462;69634;64172
697;"28.11.2007";22;"44.3";5413;66876;61463
697;"28.11.2007";23;"43.3";5677;65290;59613
697;"28.11.2007";24;"33.6";6145;60566;54421
698;"29.11.2007";1;"37.4";6266;56699;50433
698;"29.11.2007";2;"32.4";6523;54788;48265
698;"29.11.2007";3;31;6629;53593;46964
698;"29.11.2007";4;"21.7";6854;53677;46823
698;"29.11.2007";5;"26.9";7122;54316;47194
698;"29.11.2007";6;"32.9";7070;56508;49438
698;"29.11.2007";7;46;7038;63472;56434
698;"29.11.2007";8;"80.1";7312;70236;62924
698;"29.11.2007";9;"80.2";7158;71917;64759
698;"29.11.2007";10;"79.2";7049;71896;64847
698;"29.11.2007";11;80;6870;72502;65632
698;"29.11.2007";12;"84.1";6558;73567;67009
698;"29.11.2007";13;"89.4";6640;73177;66537
698;"29.11.2007";14;94;6741;72784;66043
698;"29.11.2007";15;"91.9";7246;72778;65532
698;"29.11.2007";16;"83.8";7585;73015;65430
698;"29.11.2007";17;94;8356;74743;66387
698;"29.11.2007";18;"110.8";8923;76409;67486
698;"29.11.2007";19;"100.1";8988;75542;66554
698;"29.11.2007";20;"89.9";9200;73847;64647
698;"29.11.2007";21;"65.6";9864;70172;60308
698;"29.11.2007";22;"41.8";9905;67633;57728
698;"29.11.2007";23;"42.8";9749;66013;56264
698;"29.11.2007";24;"35.3";9342;61107;51765
699;"30.11.2007";1;"35.8";9210;57150;47940
699;"30.11.2007";2;"33.1";9154;54883;45729
699;"30.11.2007";3;30;9132;53839;44707
699;"30.11.2007";4;26;9030;53980;44950
699;"30.11.2007";5;"23.2";9339;55138;45799
699;"30.11.2007";6;"35.9";8975;57731;48756
699;"30.11.2007";7;"42.2";8312;64682;56370
699;"30.11.2007";8;72;7831;70943;63112
699;"30.11.2007";9;"72.5";7663;72652;64989
699;"30.11.2007";10;"77.5";7646;72485;64839
699;"30.11.2007";11;"72.2";7320;73009;65689
699;"30.11.2007";12;"75.1";7724;73349;65625
699;"30.11.2007";13;"72.7";7836;72818;64982
699;"30.11.2007";14;"59.9";7857;71783;63926
699;"30.11.2007";15;"49.6";7294;70771;63477
699;"30.11.2007";16;"47.4";7174;70559;63385
699;"30.11.2007";17;"72.2";7169;72482;65313
699;"30.11.2007";18;"80.2";6964;74444;67480
699;"30.11.2007";19;"73.4";7385;73298;65913
699;"30.11.2007";20;"66.6";7680;70913;63233
699;"30.11.2007";21;"46.4";7813;66610;58797
699;"30.11.2007";22;"44.5";7832;64076;56244
699;"30.11.2007";23;"42.1";8159;63054;54895
699;"30.11.2007";24;"31.6";8353;58854;50501
700;"01.12.2007";1;"38.2";8613;54384;45771
700;"01.12.2007";2;"31.5";9081;52183;43102
700;"01.12.2007";3;"27.4";9569;50717;41148
700;"01.12.2007";4;"25.6";10071;50117;40046
700;"01.12.2007";5;15;10936;50738;39802
700;"01.12.2007";6;"24.3";11490;50640;39150
700;"01.12.2007";7;"10.4";12453;50908;38455
700;"01.12.2007";8;23;13515;54789;41274
700;"01.12.2007";9;"28.3";14032;58644;44612
700;"01.12.2007";10;"35.4";14720;61652;46932
700;"01.12.2007";11;"37.9";15128;63406;48278
700;"01.12.2007";12;38;15284;64454;49170
700;"01.12.2007";13;"37.2";15108;63168;48060
700;"01.12.2007";14;"32.8";14685;61656;46971
700;"01.12.2007";15;"29.9";13799;59951;46152
700;"01.12.2007";16;"29.8";12410;59491;47081
700;"01.12.2007";17;"35.8";10923;61501;50578
700;"01.12.2007";18;"55.2";10473;64833;54360
700;"01.12.2007";19;"57.6";11015;64750;53735
700;"01.12.2007";20;"39.6";11530;62754;51224
700;"01.12.2007";21;"29.2";12259;59212;46953
700;"01.12.2007";22;28;12515;57793;45278
700;"01.12.2007";23;"32.7";12576;57456;44880
700;"01.12.2007";24;"20.5";13058;54196;41138
701;"02.12.2007";1;"23.3";12636;50015;37379
701;"02.12.2007";2;"16.5";12273;47713;35440
701;"02.12.2007";3;"9.1";12294;46603;34309
701;"02.12.2007";4;"4.2";12940;46668;33728
701;"02.12.2007";5;3;13972;47108;33136
701;"02.12.2007";6;1;14108;46375;32267
701;"02.12.2007";7;0;14403;44953;30550
701;"02.12.2007";8;0;14592;46669;32077
701;"02.12.2007";9;4;14467;49305;34838
701;"02.12.2007";10;"16.1";14601;52725;38124
701;"02.12.2007";11;"29.2";14649;55346;40697
701;"02.12.2007";12;"37.5";14795;58504;43709
701;"02.12.2007";13;"36.3";14419;57787;43368
701;"02.12.2007";14;29;13772;56200;42428
701;"02.12.2007";15;"25.4";13072;54339;41267
701;"02.12.2007";16;"12.3";12766;54943;42177
701;"02.12.2007";17;"22.6";13279;58088;44809
701;"02.12.2007";18;"37.7";14518;61610;47092
701;"02.12.2007";19;"42.1";15802;62862;47060
701;"02.12.2007";20;"37.1";16676;62172;45496
701;"02.12.2007";21;"33.5";17031;60202;43171
701;"02.12.2007";22;"27.7";17211;59637;42426
701;"02.12.2007";23;"30.5";16971;60418;43447
701;"02.12.2007";24;"20.1";16404;56461;40057
702;"03.12.2007";1;10;16346;52936;36590
702;"03.12.2007";2;"4.3";16071;50149;34078
702;"03.12.2007";3;"4.1";15540;49446;33906
702;"03.12.2007";4;"4.3";14813;49973;35160
702;"03.12.2007";5;"4.6";14632;51858;37226
702;"03.12.2007";6;"16.4";14266;55646;41380
702;"03.12.2007";7;"25.1";13987;64113;50126
702;"03.12.2007";8;"47.9";13713;71655;57942
702;"03.12.2007";9;"53.7";13746;73742;59996
702;"03.12.2007";10;"57.4";13690;73554;59864
702;"03.12.2007";11;57;13364;73681;60317
702;"03.12.2007";12;57;13516;75021;61505
702;"03.12.2007";13;"57.9";14206;75006;60800
702;"03.12.2007";14;"67.7";14985;74572;59587
702;"03.12.2007";15;"69.2";15440;73893;58453
702;"03.12.2007";16;67;14797;73893;59096
702;"03.12.2007";17;"75.3";14750;75408;60658
702;"03.12.2007";18;"80.7";14557;78134;63577
702;"03.12.2007";19;"80.2";14644;77351;62707
702;"03.12.2007";20;"79.1";14252;75413;61161
702;"03.12.2007";21;"47.6";13736;71872;58136
702;"03.12.2007";22;"34.7";13299;68920;55621
702;"03.12.2007";23;"37.5";12478;66439;53961
702;"03.12.2007";24;"31.7";12000;60901;48901
703;"04.12.2007";1;"26.1";11615;56778;45163
703;"04.12.2007";2;26;10786;54486;43700
703;"04.12.2007";3;"23.8";10314;53364;43050
703;"04.12.2007";4;21;9798;53423;43625
703;"04.12.2007";5;"21.9";8997;54633;45636
703;"04.12.2007";6;"27.9";9033;56809;47776
703;"04.12.2007";7;"34.2";8905;64009;55104
703;"04.12.2007";8;75;8702;71410;62708
703;"04.12.2007";9;"72.2";8326;72396;64070
703;"04.12.2007";10;"70.1";7493;71556;64063
703;"04.12.2007";11;74;7086;71904;64818
703;"04.12.2007";12;"77.6";7020;73083;66063
703;"04.12.2007";13;"72.9";6953;72658;65705
703;"04.12.2007";14;"77.1";6437;72310;65873
703;"04.12.2007";15;70;5849;71516;65667
703;"04.12.2007";16;"64.9";5092;71614;66522
703;"04.12.2007";17;"84.4";4937;73298;68361
703;"04.12.2007";18;"99.7";4802;75660;70858
703;"04.12.2007";19;"94.3";5155;74849;69694
703;"04.12.2007";20;"79.8";5342;73018;67676
703;"04.12.2007";21;"68.4";5538;69238;63700
703;"04.12.2007";22;"54.3";5618;66101;60483
703;"04.12.2007";23;"44.7";6056;63595;57539
703;"04.12.2007";24;"34.2";6703;58189;51486
704;"05.12.2007";1;"30.2";7410;54004;46594
704;"05.12.2007";2;"25.1";7775;51518;43743
704;"05.12.2007";3;23;7847;50577;42730
704;"05.12.2007";4;"12.6";8329;50915;42586
704;"05.12.2007";5;21;8594;52053;43459
704;"05.12.2007";6;"30.1";8778;55016;46238
704;"05.12.2007";7;"31.7";8921;63035;54114
704;"05.12.2007";8;"51.7";9147;70428;61281
704;"05.12.2007";9;"54.2";9336;72181;62845
704;"05.12.2007";10;"48.3";9232;71784;62552
704;"05.12.2007";11;"56.1";9538;72431;62893
704;"05.12.2007";12;"62.8";10102;73482;63380
704;"05.12.2007";13;"62.3";10722;72705;61983
704;"05.12.2007";14;60;10865;72254;61389
704;"05.12.2007";15;"53.9";11006;71253;60247
704;"05.12.2007";16;"50.8";11159;71814;60655
704;"05.12.2007";17;"71.9";11945;73736;61791
704;"05.12.2007";18;"77.4";13048;76805;63757
704;"05.12.2007";19;"63.8";13467;76002;62535
704;"05.12.2007";20;"59.8";13824;74357;60533
704;"05.12.2007";21;"42.1";13448;70805;57357
704;"05.12.2007";22;"35.9";13445;68019;54574
704;"05.12.2007";23;"37.3";13061;65462;52401
704;"05.12.2007";24;27;12970;59842;46872
705;"06.12.2007";1;"29.5";12688;55078;42390
705;"06.12.2007";2;"25.3";12685;52501;39816
705;"06.12.2007";3;"22.9";12184;51159;38975
705;"06.12.2007";4;23;11969;51390;39421
705;"06.12.2007";5;"25.1";11558;52666;41108
705;"06.12.2007";6;"30.1";11290;55753;44463
705;"06.12.2007";7;"35.1";11364;63460;52096
705;"06.12.2007";8;"66.5";11229;70258;59029
705;"06.12.2007";9;"62.3";10671;71666;60995
705;"06.12.2007";10;"62.2";10124;71121;60997
705;"06.12.2007";11;63;10179;71565;61386
705;"06.12.2007";12;"67.1";10325;72728;62403
705;"06.12.2007";13;"58.1";10602;72325;61723
705;"06.12.2007";14;"66.5";10350;72306;61956
705;"06.12.2007";15;"66.6";9760;71900;62140
705;"06.12.2007";16;"62.1";9551;72290;62739
705;"06.12.2007";17;"75.1";10402;74158;63756
705;"06.12.2007";18;"81.4";11078;75894;64816
705;"06.12.2007";19;"72.1";12188;75282;63094
705;"06.12.2007";20;60;12430;73828;61398
705;"06.12.2007";21;"50.7";12028;70241;58213
705;"06.12.2007";22;"41.1";12011;67231;55220
705;"06.12.2007";23;36;11953;64549;52596
705;"06.12.2007";24;"26.4";12227;58514;46287
706;"07.12.2007";1;"30.4";12454;54665;42211
706;"07.12.2007";2;22;12688;52230;39542
706;"07.12.2007";3;"20.2";13854;51927;38073
706;"07.12.2007";4;7;14709;52504;37795
706;"07.12.2007";5;"6.3";15509;54016;38507
706;"07.12.2007";6;"26.8";16327;57358;41031
706;"07.12.2007";7;"32.3";17118;64974;47856
706;"07.12.2007";8;"55.1";16988;72557;55569
706;"07.12.2007";9;"47.3";16074;74559;58485
706;"07.12.2007";10;"48.2";16031;73982;57951
706;"07.12.2007";11;"50.4";15947;74836;58889
706;"07.12.2007";12;"54.2";16942;75657;58715
706;"07.12.2007";13;"50.9";17237;74773;57536
706;"07.12.2007";14;"54.3";16993;73665;56672
706;"07.12.2007";15;"43.5";16989;72705;55716
706;"07.12.2007";16;42;16055;72087;56032
706;"07.12.2007";17;60;15675;74191;58516
706;"07.12.2007";18;"80.3";15419;76734;61315
706;"07.12.2007";19;"72.1";15407;75340;59933
706;"07.12.2007";20;"61.3";15087;72816;57729
706;"07.12.2007";21;"40.1";14907;69420;54513
706;"07.12.2007";22;"33.9";14476;66714;52238
706;"07.12.2007";23;31;14167;64970;50803
706;"07.12.2007";24;"23.4";13800;60378;46578
707;"08.12.2007";1;34;13859;56607;42748
707;"08.12.2007";2;30;13883;54242;40359
707;"08.12.2007";3;"26.1";13958;52919;38961
707;"08.12.2007";4;"9.9";13842;52558;38716
707;"08.12.2007";5;"7.9";13556;52540;38984
707;"08.12.2007";6;"9.5";13274;52283;39009
707;"08.12.2007";7;"7.4";12550;52255;39705
707;"08.12.2007";8;"19.4";12015;55842;43827
707;"08.12.2007";9;"25.6";11170;58691;47521
707;"08.12.2007";10;"36.5";10743;61233;50490
707;"08.12.2007";11;"41.3";10414;62796;52382
707;"08.12.2007";12;38;10442;63390;52948
707;"08.12.2007";13;41;10477;62182;51705
707;"08.12.2007";14;"37.6";9800;60191;50391
707;"08.12.2007";15;"32.6";8784;58477;49693
707;"08.12.2007";16;"36.1";7884;58210;50326
707;"08.12.2007";17;43;7418;60997;53579
707;"08.12.2007";18;"51.9";7462;64134;56672
707;"08.12.2007";19;"61.3";7793;63280;55487
707;"08.12.2007";20;55;8476;60793;52317
707;"08.12.2007";21;"30.9";9223;57209;47986
707;"08.12.2007";22;"25.5";10285;56008;45723
707;"08.12.2007";23;"26.1";11294;56413;45119
707;"08.12.2007";24;"20.9";12191;53707;41516
708;"09.12.2007";1;"19.7";12938;50343;37405
708;"09.12.2007";2;"10.4";13280;48184;34904
708;"09.12.2007";3;5;13090;46901;33811
708;"09.12.2007";4;"4.2";12725;46605;33880
708;"09.12.2007";5;"0.7";11481;46045;34564
708;"09.12.2007";6;"0.9";10941;45281;34340
708;"09.12.2007";7;0;10387;44301;33914
708;"09.12.2007";8;"0.1";9596;45745;36149
708;"09.12.2007";9;"4.1";8517;48310;39793
708;"09.12.2007";10;"15.1";7143;51140;43997
708;"09.12.2007";11;"25.1";6722;53680;46958
708;"09.12.2007";12;"30.4";6284;56002;49718
708;"09.12.2007";13;"30.1";5751;54921;49170
708;"09.12.2007";14;"25.5";5306;53224;47918
708;"09.12.2007";15;"23.5";4262;51210;46948
708;"09.12.2007";16;"12.2";3572;51173;47601
708;"09.12.2007";17;"25.5";3400;54482;51082
708;"09.12.2007";18;38;3989;58958;54969
708;"09.12.2007";19;46;4659;60000;55341
708;"09.12.2007";20;"44.7";5128;59422;54294
708;"09.12.2007";21;"34.9";5207;57290;52083
708;"09.12.2007";22;"32.1";5411;56204;50793
708;"09.12.2007";23;"34.6";5336;56544;51208
708;"09.12.2007";24;25;5181;52631;47450
709;"10.12.2007";1;18;4754;48597;43843
709;"10.12.2007";2;"17.8";4527;46753;42226
709;"10.12.2007";3;"11.3";4401;46322;41921
709;"10.12.2007";4;"10.3";4097;46820;42723
709;"10.12.2007";5;"10.4";3701;48478;44777
709;"10.12.2007";6;"19.7";3476;51957;48481
709;"10.12.2007";7;"33.9";3393;60830;57437
709;"10.12.2007";8;"69.6";3165;68872;65707
709;"10.12.2007";9;"72.2";2874;71153;68279
709;"10.12.2007";10;"72.2";2638;70823;68185
709;"10.12.2007";11;80;2227;71691;69464
709;"10.12.2007";12;"84.9";1717;72883;71166
709;"10.12.2007";13;"80.2";1456;72449;70993
709;"10.12.2007";14;"85.1";1368;72063;70695
709;"10.12.2007";15;90;1401;71789;70388
709;"10.12.2007";16;"86.7";1512;71807;70295
709;"10.12.2007";17;"96.4";1604;73607;72003
709;"10.12.2007";18;137;1744;75120;73376
709;"10.12.2007";19;"110.1";1709;74031;72322
709;"10.12.2007";20;"85.1";1627;71936;70309
709;"10.12.2007";21;"80.1";1622;68014;66392
709;"10.12.2007";22;"60.2";1556;65148;63592
709;"10.12.2007";23;"54.3";1516;62591;61075
709;"10.12.2007";24;38;1567;57310;55743
710;"11.12.2007";1;"41.9";1531;52872;51341
710;"11.12.2007";2;36;1986;50858;48872
710;"11.12.2007";3;"35.5";2201;49586;47385
710;"11.12.2007";4;"30.4";2740;50131;47391
710;"11.12.2007";5;"25.7";2815;51720;48905
710;"11.12.2007";6;"35.8";3031;54447;51416
710;"11.12.2007";7;54;3052;61909;58857
710;"11.12.2007";8;"85.3";3378;69593;66215
710;"11.12.2007";9;85;3062;71684;68622
710;"11.12.2007";10;"83.4";2893;71757;68864
710;"11.12.2007";11;"84.1";2805;72427;69622
710;"11.12.2007";12;"81.4";2656;73200;70544
710;"11.12.2007";13;75;2718;72585;69867
710;"11.12.2007";14;73;2453;72253;69800
710;"11.12.2007";15;78;2713;71775;69062
710;"11.12.2007";16;80;2672;71984;69312
710;"11.12.2007";17;"87.1";2623;73517;70894
710;"11.12.2007";18;"110.5";2717;74995;72278
710;"11.12.2007";19;"109.9";2957;74346;71389
710;"11.12.2007";20;"88.8";3164;72456;69292
710;"11.12.2007";21;"79.8";3207;68678;65471
710;"11.12.2007";22;"68.2";3198;65757;62559
710;"11.12.2007";23;"69.8";3032;63257;60225
710;"11.12.2007";24;"54.5";3012;58245;55233
711;"12.12.2007";1;"35.4";3079;53933;50854
711;"12.12.2007";2;33;2967;51930;48963
711;"12.12.2007";3;"30.1";2963;50930;47967
711;"12.12.2007";4;"29.4";3065;51526;48461
711;"12.12.2007";5;32;2943;52745;49802
711;"12.12.2007";6;"35.4";2903;55359;52456
711;"12.12.2007";7;"54.1";2699;62507;59808
711;"12.12.2007";8;110;2243;69374;67131
711;"12.12.2007";9;"107.9";1985;71639;69654
711;"12.12.2007";10;"109.9";1959;71263;69304
711;"12.12.2007";11;108;1855;72007;70152
711;"12.12.2007";12;"110.1";1840;72842;71002
711;"12.12.2007";13;110;1840;72328;70488
711;"12.12.2007";14;111;1775;72167;70392
711;"12.12.2007";15;"103.5";1830;71793;69963
711;"12.12.2007";16;105;1853;71811;69958
711;"12.12.2007";17;"110.9";1903;73343;71440
711;"12.12.2007";18;200;1843;74690;72847
711;"12.12.2007";19;152;1737;73765;72028
711;"12.12.2007";20;"97.1";1715;71801;70086
711;"12.12.2007";21;"79.9";1693;68483;66790
711;"12.12.2007";22;"62.2";1540;65757;64217
711;"12.12.2007";23;"58.8";1549;63610;62061
711;"12.12.2007";24;"42.7";1560;58361;56801
712;"13.12.2007";1;"60.9";1597;54218;52621
712;"13.12.2007";2;"38.5";1574;51808;50234
712;"13.12.2007";3;"37.9";1478;50722;49244
712;"13.12.2007";4;"35.1";1343;50872;49529
712;"13.12.2007";5;"32.7";1277;52229;50952
712;"13.12.2007";6;50;1197;54723;53526
712;"13.12.2007";7;"64.4";1051;61937;60886
712;"13.12.2007";8;141;885;68922;68037
712;"13.12.2007";9;"120.1";740;70590;69850
712;"13.12.2007";10;"117.1";687;70314;69627
712;"13.12.2007";11;117;548;71143;70595
712;"13.12.2007";12;"142.7";489;71499;71010
712;"13.12.2007";13;"109.9";549;70972;70423
712;"13.12.2007";14;115;582;70679;70097
712;"13.12.2007";15;91;590;70009;69419
712;"13.12.2007";16;"84.9";563;70104;69541
712;"13.12.2007";17;"94.6";570;71911;71341
712;"13.12.2007";18;"149.7";778;73955;73177
712;"13.12.2007";19;"112.1";828;72982;72154
712;"13.12.2007";20;"102.1";859;71863;71004
712;"13.12.2007";21;"80.1";802;67993;67191
712;"13.12.2007";22;"61.4";652;65009;64357
712;"13.12.2007";23;"59.9";740;63014;62274
712;"13.12.2007";24;"45.9";757;58514;57757
713;"14.12.2007";1;40;723;54680;53957
713;"14.12.2007";2;"40.2";722;52196;51474
713;"14.12.2007";3;"32.6";867;50963;50096
713;"14.12.2007";4;"31.3";963;51365;50402
713;"14.12.2007";5;34;932;52506;51574
713;"14.12.2007";6;"37.9";756;54890;54134
713;"14.12.2007";7;"47.1";739;61966;61227
713;"14.12.2007";8;69;801;68944;68143
713;"14.12.2007";9;"85.1";748;70983;70235
713;"14.12.2007";10;"89.2";710;70944;70234
713;"14.12.2007";11;"91.9";659;71542;70883
713;"14.12.2007";12;"92.6";627;72164;71537
713;"14.12.2007";13;"89.9";616;71522;70906
713;"14.12.2007";14;85;743;70476;69733
713;"14.12.2007";15;"89.5";717;69331;68614
713;"14.12.2007";16;86;735;69054;68319
713;"14.12.2007";17;95;822;71026;70204
713;"14.12.2007";18;"105.1";903;72942;72039
713;"14.12.2007";19;102;1022;71402;70380
713;"14.12.2007";20;"92.9";1061;69108;68047
713;"14.12.2007";21;"78.2";1061;65365;64304
713;"14.12.2007";22;"52.1";1107;63063;61956
713;"14.12.2007";23;"56.9";1181;61886;60705
713;"14.12.2007";24;"40.6";1276;57992;56716
714;"15.12.2007";1;"51.3";1358;54746;53388
714;"15.12.2007";2;"38.6";1375;52312;50937
714;"15.12.2007";3;"35.3";1311;50665;49354
714;"15.12.2007";4;36;1176;49938;48762
714;"15.12.2007";5;35;1113;49587;48474
714;"15.12.2007";6;"35.1";1012;48665;47653
714;"15.12.2007";7;"29.7";1111;48179;47068
714;"15.12.2007";8;"34.5";1239;51878;50639
714;"15.12.2007";9;43;1376;55481;54105
714;"15.12.2007";10;"54.3";1415;58076;56661
714;"15.12.2007";11;"61.1";1381;59309;57928
714;"15.12.2007";12;63;1602;59864;58262
714;"15.12.2007";13;"43.8";1760;58983;57223
714;"15.12.2007";14;39;2081;57665;55584
714;"15.12.2007";15;"37.7";2204;56582;54378
714;"15.12.2007";16;"36.6";2263;56964;54701
714;"15.12.2007";17;"56.1";2450;60331;57881
714;"15.12.2007";18;"80.1";2843;64177;61334
714;"15.12.2007";19;80;3003;63704;60701
714;"15.12.2007";20;65;3111;61416;58305
714;"15.12.2007";21;"40.3";2972;58364;55392
714;"15.12.2007";22;35;2712;56647;53935
714;"15.12.2007";23;"48.1";2517;56710;54193
714;"15.12.2007";24;"34.4";2154;53766;51612
715;"16.12.2007";1;"35.9";1942;51063;49121
715;"16.12.2007";2;32;1715;48565;46850
715;"16.12.2007";3;"31.6";1705;47201;45496
715;"16.12.2007";4;"29.7";1639;46428;44789
715;"16.12.2007";5;"27.1";1636;45932;44296
715;"16.12.2007";6;"27.1";1491;44477;42986
715;"16.12.2007";7;"16.1";1536;42049;40513
715;"16.12.2007";8;"20.1";1493;43686;42193
715;"16.12.2007";9;"26.7";1503;46964;45461
715;"16.12.2007";10;"34.6";1499;50262;48763
715;"16.12.2007";11;41;1270;52998;51728
715;"16.12.2007";12;"48.2";974;55750;54776
715;"16.12.2007";13;"47.4";1003;55281;54278
715;"16.12.2007";14;"38.2";986;53145;52159
715;"16.12.2007";15;"34.2";1058;51773;50715
715;"16.12.2007";16;"36.1";1220;51846;50626
715;"16.12.2007";17;"46.5";1378;54951;53573
715;"16.12.2007";18;"69.2";1595;58879;57284
715;"16.12.2007";19;70;1847;60143;58296
715;"16.12.2007";20;"63.8";2072;59152;57080
715;"16.12.2007";21;"48.9";2162;57560;55398
715;"16.12.2007";22;"46.9";2115;56653;54538
715;"16.12.2007";23;"51.7";1989;57800;55811
715;"16.12.2007";24;"39.6";2056;54419;52363
716;"17.12.2007";1;"35.1";2006;51666;49660
716;"17.12.2007";2;"30.3";2178;49468;47290
716;"17.12.2007";3;"28.2";2216;48889;46673
716;"17.12.2007";4;28;2053;48791;46738
716;"17.12.2007";5;"30.5";1976;49892;47916
716;"17.12.2007";6;"37.6";1949;52788;50839
716;"17.12.2007";7;50;2153;60505;58352
716;"17.12.2007";8;100;2431;68218;65787
716;"17.12.2007";9;"107.9";2708;70251;67543
716;"17.12.2007";10;"105.5";3161;70069;66908
716;"17.12.2007";11;"104.7";3479;70463;66984
716;"17.12.2007";12;"104.4";3616;70977;67361
716;"17.12.2007";13;"100.1";4107;70553;66446
716;"17.12.2007";14;"105.2";3964;69842;65878
716;"17.12.2007";15;"100.1";3820;69032;65212
716;"17.12.2007";16;"96.7";4040;69447;65407
716;"17.12.2007";17;110;4352;71277;66925
716;"17.12.2007";18;"200.9";4574;74021;69447
716;"17.12.2007";19;190;4310;73130;68820
716;"17.12.2007";20;120;4166;71402;67236
716;"17.12.2007";21;"88.1";4042;68176;64134
716;"17.12.2007";22;58;3808;65998;62190
716;"17.12.2007";23;"51.6";3477;64177;60700
716;"17.12.2007";24;"45.3";2916;59714;56798
717;"18.12.2007";1;62;2484;56375;53891
717;"18.12.2007";2;"48.3";2312;54217;51905
717;"18.12.2007";3;"43.8";2074;52761;50687
717;"18.12.2007";4;38;1916;52454;50538
717;"18.12.2007";5;"41.4";1726;53039;51313
717;"18.12.2007";6;54;1665;55335;53670
717;"18.12.2007";7;"71.9";1670;61580;59910
717;"18.12.2007";8;"153.8";1644;68205;66561
717;"18.12.2007";9;"102.8";1485;70861;69376
717;"18.12.2007";10;"119.3";1322;70282;68960
717;"18.12.2007";11;"107.7";1179;70492;69313
717;"18.12.2007";12;"101.5";994;70807;69813
717;"18.12.2007";13;"99.2";802;70265;69463
717;"18.12.2007";14;"100.1";743;69809;69066
717;"18.12.2007";15;"100.1";786;69383;68597
717;"18.12.2007";16;"100.1";1023;69448;68425
717;"18.12.2007";17;"112.8";1201;71495;70294
717;"18.12.2007";18;150;1365;73941;72576
717;"18.12.2007";19;250;1446;73090;71644
717;"18.12.2007";20;"156.2";1488;71489;70001
717;"18.12.2007";21;"110.2";1422;68541;67119
717;"18.12.2007";22;80;1359;65881;64522
717;"18.12.2007";23;"68.1";1153;64089;62936
717;"18.12.2007";24;"47.3";1053;59886;58833
718;"19.12.2007";1;"58.1";975;56702;55727
718;"19.12.2007";2;"51.4";958;54214;53256
718;"19.12.2007";3;"40.9";965;53185;52220
718;"19.12.2007";4;"34.9";1002;52908;51906
718;"19.12.2007";5;"45.6";934;53529;52595
718;"19.12.2007";6;"57.8";870;55658;54788
718;"19.12.2007";7;"68.1";674;61779;61105
718;"19.12.2007";8;"148.6";597;68406;67809
718;"19.12.2007";9;215;551;69967;69416
718;"19.12.2007";10;"200.6";412;69515;69103
718;"19.12.2007";11;"207.6";342;69515;69173
718;"19.12.2007";12;"249.9";289;69785;69496
718;"19.12.2007";13;"199.9";257;69355;69098
718;"19.12.2007";14;195;231;68903;68672
718;"19.12.2007";15;"150.1";201;68196;67995
718;"19.12.2007";16;195;233;68274;68041
718;"19.12.2007";17;"205.8";309;70631;70322
718;"19.12.2007";18;650;350;73546;73196
718;"19.12.2007";19;"311.7";339;72732;72393
718;"19.12.2007";20;200;323;71048;70725
718;"19.12.2007";21;"105.3";329;67791;67462
718;"19.12.2007";22;81;287;65783;65496
718;"19.12.2007";23;75;302;64884;64582
718;"19.12.2007";24;"68.1";318;60434;60116
719;"20.12.2007";1;"61.7";285;57171;56886
719;"20.12.2007";2;"46.6";263;54654;54391
719;"20.12.2007";3;"43.3";259;53091;52832
719;"20.12.2007";4;"37.9";263;52737;52474
719;"20.12.2007";5;"38.9";276;53074;52798
719;"20.12.2007";6;"47.2";313;54717;54404
719;"20.12.2007";7;"63.6";294;60072;59778
719;"20.12.2007";8;"105.3";277;66762;66485
719;"20.12.2007";9;"127.4";263;68874;68611
719;"20.12.2007";10;"109.9";258;68808;68550
719;"20.12.2007";11;105;214;68641;68427
719;"20.12.2007";12;"95.7";210;68902;68692
719;"20.12.2007";13;"101.2";215;68478;68263
719;"20.12.2007";14;"101.7";202;67832;67630
719;"20.12.2007";15;85;196;67066;66870
719;"20.12.2007";16;"78.5";194;67127;66933
719;"20.12.2007";17;81;190;69206;69016
719;"20.12.2007";18;"104.9";199;71894;71695
719;"20.12.2007";19;"125.1";287;70842;70555
719;"20.12.2007";20;"93.1";355;69169;68814
719;"20.12.2007";21;85;356;66240;65884
719;"20.12.2007";22;"63.6";292;64306;64014
719;"20.12.2007";23;"63.6";270;63226;62956
719;"20.12.2007";24;"50.7";341;59382;59041
720;"21.12.2007";1;"56.5";366;56190;55824
720;"21.12.2007";2;"45.1";368;54075;53707
720;"21.12.2007";3;44;331;52543;52212
720;"21.12.2007";4;"44.2";308;51815;51507
720;"21.12.2007";5;"45.1";331;52070;51739
720;"21.12.2007";6;"53.8";351;53589;53238
720;"21.12.2007";7;"48.3";324;57863;57539
720;"21.12.2007";8;"100.1";364;63999;63635
720;"21.12.2007";9;"112.1";315;66188;65873
720;"21.12.2007";10;"119.6";366;66250;65884
720;"21.12.2007";11;"107.7";270;65839;65569
720;"21.12.2007";12;"103.2";267;65393;65126
720;"21.12.2007";13;"100.2";252;64386;64134
720;"21.12.2007";14;100;260;62587;62327
720;"21.12.2007";15;"79.7";240;61641;61401
720;"21.12.2007";16;"74.9";240;62018;61778
720;"21.12.2007";17;"88.1";266;64838;64572
720;"21.12.2007";18;120;285;68061;67776
720;"21.12.2007";19;"117.1";257;67195;66938
720;"21.12.2007";20;"98.6";286;64869;64583
720;"21.12.2007";21;"74.9";263;61922;61659
720;"21.12.2007";22;"49.6";261;59980;59719
720;"21.12.2007";23;"55.9";304;59958;59654
720;"21.12.2007";24;35;365;56848;56483
721;"22.12.2007";1;"51.1";355;53756;53401
721;"22.12.2007";2;"47.3";329;51725;51396
721;"22.12.2007";3;"39.6";371;50185;49814
721;"22.12.2007";4;"35.7";468;48681;48213
721;"22.12.2007";5;"36.3";516;47851;47335
721;"22.12.2007";6;35;539;47031;46492
721;"22.12.2007";7;"23.9";589;45458;44869
721;"22.12.2007";8;"29.2";630;49123;48493
721;"22.12.2007";9;40;683;52742;52059
721;"22.12.2007";10;"41.7";727;55627;54900
721;"22.12.2007";11;"49.7";752;56857;56105
721;"22.12.2007";12;"60.1";708;57558;56850
721;"22.12.2007";13;"72.5";636;57283;56647
721;"22.12.2007";14;"72.5";509;55893;55384
721;"22.12.2007";15;"64.6";498;55142;54644
721;"22.12.2007";16;"65.3";614;55608;54994
721;"22.12.2007";17;"73.9";771;58742;57971
721;"22.12.2007";18;"85.1";935;62769;61834
721;"22.12.2007";19;"89.5";1160;62564;61404
721;"22.12.2007";20;"72.8";1309;60630;59321
721;"22.12.2007";21;"74.7";1427;57398;55971
721;"22.12.2007";22;"58.2";1702;56015;54313
721;"22.12.2007";23;"60.1";1829;56787;54958
721;"22.12.2007";24;"38.9";1951;53539;51588
722;"23.12.2007";1;"41.7";2236;50490;48254
722;"23.12.2007";2;"31.7";2378;48486;46108
722;"23.12.2007";3;"26.2";2421;46859;44438
722;"23.12.2007";4;"27.1";2585;45529;42944
722;"23.12.2007";5;"26.1";2495;44573;42078
722;"23.12.2007";6;"27.4";2489;43084;40595
722;"23.12.2007";7;"10.5";2504;40544;38040
722;"23.12.2007";8;"17.3";2399;42276;39877
722;"23.12.2007";9;"19.4";2432;45821;43389
722;"23.12.2007";10;"30.1";2297;49594;47297
722;"23.12.2007";11;"36.4";2146;52764;50618
722;"23.12.2007";12;45;2064;55716;53652
722;"23.12.2007";13;"44.3";1836;55568;53732
722;"23.12.2007";14;38;1710;53444;51734
722;"23.12.2007";15;"31.6";1504;52149;50645
722;"23.12.2007";16;"31.1";1684;52329;50645
722;"23.12.2007";17;42;1663;55324;53661
722;"23.12.2007";18;"49.4";1491;59232;57741
722;"23.12.2007";19;"55.2";1325;59500;58175
722;"23.12.2007";20;51;1088;57982;56894
722;"23.12.2007";21;45;881;55513;54632
722;"23.12.2007";22;"40.1";764;54557;53793
722;"23.12.2007";23;"45.1";614;55092;54478
722;"23.12.2007";24;"33.7";484;52035;51551
723;"24.12.2007";1;"36.8";401;48710;48309
723;"24.12.2007";2;"30.4";428;46006;45578
723;"24.12.2007";3;"28.5";444;44595;44151
723;"24.12.2007";4;"23.5";464;43595;43131
723;"24.12.2007";5;"23.9";453;43117;42664
723;"24.12.2007";6;"23.9";482;42650;42168
723;"24.12.2007";7;"5.1";504;41921;41417
723;"24.12.2007";8;16;547;45349;44802
723;"24.12.2007";9;23;718;49098;48380
723;"24.12.2007";10;"30.1";801;51927;51126
723;"24.12.2007";11;"34.1";951;52811;51860
723;"24.12.2007";12;"36.6";977;53313;52336
723;"24.12.2007";13;"39.5";1159;53135;51976
723;"24.12.2007";14;"33.9";1267;51636;50369
723;"24.12.2007";15;"26.2";1388;49860;48472
723;"24.12.2007";16;25;1564;49212;47648
723;"24.12.2007";17;33;1861;51478;49617
723;"24.12.2007";18;"35.2";2203;54499;52296
723;"24.12.2007";19;"33.1";2512;52562;50050
723;"24.12.2007";20;27;2787;49245;46458
723;"24.12.2007";21;"29.9";3043;47630;44587
723;"24.12.2007";22;"26.3";3318;48650;45332
723;"24.12.2007";23;"35.9";3234;50794;47560
723;"24.12.2007";24;"27.3";3308;49079;45771
724;"25.12.2007";1;"36.4";3355;46582;43227
724;"25.12.2007";2;"24.6";3291;43873;40582
724;"25.12.2007";3;"22.8";3258;42108;38850
724;"25.12.2007";4;"18.3";3211;41186;37975
724;"25.12.2007";5;"15.9";3400;40777;37377
724;"25.12.2007";6;"16.4";3622;39925;36303
724;"25.12.2007";7;"4.4";3925;37515;33590
724;"25.12.2007";8;"4.3";4371;38761;34390
724;"25.12.2007";9;"6.9";4589;42244;37655
724;"25.12.2007";10;"14.7";5051;46413;41362
724;"25.12.2007";11;"30.6";5186;49185;43999
724;"25.12.2007";12;"39.1";5125;51353;46228
724;"25.12.2007";13;"38.1";5481;49524;44043
724;"25.12.2007";14;"29.9";5761;46041;40280
724;"25.12.2007";15;"22.8";6017;45296;39279
724;"25.12.2007";16;"20.7";6519;45055;38536
724;"25.12.2007";17;"26.2";7129;47646;40517
724;"25.12.2007";18;"32.8";7624;51473;43849
724;"25.12.2007";19;"37.1";7873;52314;44441
724;"25.12.2007";20;38;8293;51786;43493
724;"25.12.2007";21;"39.6";8349;50682;42333
724;"25.12.2007";22;"37.7";7937;50852;42915
724;"25.12.2007";23;40;7591;52028;44437
724;"25.12.2007";24;"34.6";7289;49599;42310
725;"26.12.2007";1;"25.1";6920;46727;39807
725;"26.12.2007";2;"17.6";6792;44627;37835
725;"26.12.2007";3;"9.2";6541;43171;36630
725;"26.12.2007";4;"9.1";6141;42208;36067
725;"26.12.2007";5;"9.2";5480;41307;35827
725;"26.12.2007";6;"9.1";4938;40086;35148
725;"26.12.2007";7;"0.3";4776;38030;33254
725;"26.12.2007";8;"0.8";4434;39327;34893
725;"26.12.2007";9;"4.8";4288;42308;38020
725;"26.12.2007";10;"10.4";3642;45709;42067
725;"26.12.2007";11;"26.2";3269;48171;44902
725;"26.12.2007";12;"32.1";3121;50672;47551
725;"26.12.2007";13;"26.2";2747;50241;47494
725;"26.12.2007";14;"22.6";2525;47928;45403
725;"26.12.2007";15;"16.1";2220;46848;44628
725;"26.12.2007";16;14;2016;46455;44439
725;"26.12.2007";17;17;2035;48598;46563
725;"26.12.2007";18;"29.8";2044;51968;49924
725;"26.12.2007";19;"37.3";2216;52970;50754
725;"26.12.2007";20;"38.4";2402;52370;49968
725;"26.12.2007";21;"33.2";2269;50618;48349
725;"26.12.2007";22;29;2438;50573;48135
725;"26.12.2007";23;"34.3";2541;51747;49206
725;"26.12.2007";24;"26.4";2557;48689;46132
726;"27.12.2007";1;18;2606;45630;43024
726;"27.12.2007";2;"10.3";2610;43171;40561
726;"27.12.2007";3;"9.1";2759;42019;39260
726;"27.12.2007";4;"5.3";2939;41560;38621
726;"27.12.2007";5;"6.8";3265;41943;38678
726;"27.12.2007";6;"7.4";3778;42660;38882
726;"27.12.2007";7;"1.9";4126;44097;39971
726;"27.12.2007";8;"16.7";4457;48619;44162
726;"27.12.2007";9;"31.2";4929;52899;47970
726;"27.12.2007";10;"40.5";5577;56016;50439
726;"27.12.2007";11;45;5898;57683;51785
726;"27.12.2007";12;"46.3";6130;59059;52929
726;"27.12.2007";13;50;6270;59637;53367
726;"27.12.2007";14;"46.3";6424;58716;52292
726;"27.12.2007";15;"43.2";6388;57914;51526
726;"27.12.2007";16;"42.9";6699;58158;51459
726;"27.12.2007";17;"45.3";7180;60981;53801
726;"27.12.2007";18;"59.7";7480;63897;56417
726;"27.12.2007";19;"59.7";7925;63845;55920
726;"27.12.2007";20;"49.6";8417;61850;53433
726;"27.12.2007";21;"44.5";8539;58330;49791
726;"27.12.2007";22;"37.1";8629;56756;48127
726;"27.12.2007";23;"38.2";8704;56266;47562
726;"27.12.2007";24;"28.5";8592;52306;43714
727;"28.12.2007";1;"29.8";8176;48863;40687
727;"28.12.2007";2;"15.3";8415;46363;37948
727;"28.12.2007";3;"9.8";8455;45316;36861
727;"28.12.2007";4;"11.2";8039;44555;36516
727;"28.12.2007";5;"12.5";7832;44808;36976
727;"28.12.2007";6;"23.8";7983;45339;37356
727;"28.12.2007";7;"5.1";8045;46469;38424
727;"28.12.2007";8;"13.5";8143;50729;42586
727;"28.12.2007";9;"27.6";8409;54382;45973
727;"28.12.2007";10;"34.2";8530;56608;48078
727;"28.12.2007";11;"29.6";8780;57789;49009
727;"28.12.2007";12;"31.2";9250;59063;49813
727;"28.12.2007";13;"30.6";9523;59130;49607
727;"28.12.2007";14;30;9480;57724;48244
727;"28.12.2007";15;"27.1";9612;56885;47273
727;"28.12.2007";16;"23.9";9600;56917;47317
727;"28.12.2007";17;"45.5";10044;60138;50094
727;"28.12.2007";18;"46.2";10667;64352;53685
727;"28.12.2007";19;45;10894;64303;53409
727;"28.12.2007";20;"34.3";10653;61723;51070
727;"28.12.2007";21;"33.5";11152;58358;47206
727;"28.12.2007";22;27;11197;57235;46038
727;"28.12.2007";23;27;10664;56812;46148
727;"28.12.2007";24;"9.2";10186;53262;43076
728;"29.12.2007";1;"31.4";10472;50334;39862
728;"29.12.2007";2;15;10449;48222;37773
728;"29.12.2007";3;"5.1";10640;46835;36195
728;"29.12.2007";4;0;11007;46345;35338
728;"29.12.2007";5;0;11181;46001;34820
728;"29.12.2007";6;0;11639;45412;33773
728;"29.12.2007";7;0;12527;44343;31816
728;"29.12.2007";8;"4.9";12958;46754;33796
728;"29.12.2007";9;"22.7";13639;50048;36409
728;"29.12.2007";10;35;14231;53123;38892
728;"29.12.2007";11;"34.5";14858;55118;40260
728;"29.12.2007";12;"38.1";14771;56246;41475
728;"29.12.2007";13;"39.4";14391;56062;41671
728;"29.12.2007";14;"36.4";13831;55264;41433
728;"29.12.2007";15;"32.5";13179;54542;41363
728;"29.12.2007";16;34;11999;54373;42374
728;"29.12.2007";17;"50.3";11205;56642;45437
728;"29.12.2007";18;"57.9";10622;60211;49589
728;"29.12.2007";19;"57.6";10391;60465;50074
728;"29.12.2007";20;"46.4";10335;58591;48256
728;"29.12.2007";21;30;10454;55384;44930
728;"29.12.2007";22;"25.5";9580;54102;44522
728;"29.12.2007";23;"30.1";8888;54257;45369
728;"29.12.2007";24;"23.5";8232;50865;42633
729;"30.12.2007";1;"10.4";8091;47305;39214
729;"30.12.2007";2;"4.2";7855;44851;36996
729;"30.12.2007";3;"3.5";7251;42767;35516
729;"30.12.2007";4;"4.9";6762;42063;35301
729;"30.12.2007";5;"5.1";6250;41855;35605
729;"30.12.2007";6;"4.4";5869;40784;34915
729;"30.12.2007";7;0;5533;38918;33385
729;"30.12.2007";8;5;5002;39854;34852
729;"30.12.2007";9;"10.1";4278;42138;37860
729;"30.12.2007";10;22;4082;45348;41266
729;"30.12.2007";11;"29.3";3874;48221;44347
729;"30.12.2007";12;38;3761;51153;47392
729;"30.12.2007";13;36;3921;51511;47590
729;"30.12.2007";14;"30.8";4074;49855;45781
729;"30.12.2007";15;"27.1";4003;48786;44783
729;"30.12.2007";16;"27.1";3619;48565;44946
729;"30.12.2007";17;"35.5";3582;50533;46951
729;"30.12.2007";18;"46.3";3612;54596;50984
729;"30.12.2007";19;"50.9";3524;55308;51784
729;"30.12.2007";20;"49.9";3876;54254;50378
729;"30.12.2007";21;"43.3";4052;52252;48200
729;"30.12.2007";22;"37.4";4131;51736;47605
729;"30.12.2007";23;"43.2";3992;52349;48357
729;"30.12.2007";24;"34.4";3902;48970;45068
730;"31.12.2007";1;"30.4";3908;45534;41626
730;"31.12.2007";2;"21.1";3828;43145;39317
730;"31.12.2007";3;10;3617;41860;38243
730;"31.12.2007";4;"9.4";3724;41385;37661
730;"31.12.2007";5;"10.4";3435;41613;38178
730;"31.12.2007";6;"16.5";3199;41237;38038
730;"31.12.2007";7;"2.3";3094;40312;37218
730;"31.12.2007";8;"7.2";2934;43042;40108
730;"31.12.2007";9;"10.4";2556;46103;43547
730;"31.12.2007";10;"30.4";2397;48636;46239
730;"31.12.2007";11;"31.6";2072;49553;47481
730;"31.12.2007";12;36;1957;50580;48623
730;"31.12.2007";13;"36.1";1797;51175;49378
730;"31.12.2007";14;"35.6";1696;50466;48770
730;"31.12.2007";15;"29.1";1698;49203;47505
730;"31.12.2007";16;"26.1";1805;48777;46972
730;"31.12.2007";17;34;2113;52019;49906
730;"31.12.2007";18;"50.9";2281;56466;54185
730;"31.12.2007";19;"49.1";2335;55926;53591
730;"31.12.2007";20;"44.5";2281;52163;49882
730;"31.12.2007";21;"36.4";2132;48383;46251
730;"31.12.2007";22;"27.1";1837;47854;46017
730;"31.12.2007";23;"38.9";1646;49622;47976
730;"31.12.2007";24;"29.2";1423;48574;47151
731;"01.01.2008";1;"32.2";1330;47488;46158
731;"01.01.2008";2;"25.1";1329;45605;44276
731;"01.01.2008";3;"21.1";1246;43701;42455
731;"01.01.2008";4;7;1202;42016;40814
731;"01.01.2008";5;"3.1";1165;40879;39714
731;"01.01.2008";6;0;1046;39283;38237
731;"01.01.2008";7;0;892;36278;35386
731;"01.01.2008";8;0;948;36362;35414
731;"01.01.2008";9;0;878;36626;35748
731;"01.01.2008";10;0;771;38587;37816
731;"01.01.2008";11;0;754;41201;40447
731;"01.01.2008";12;17;603;44198;43595
731;"01.01.2008";13;"18.4";557;45750;45193
731;"01.01.2008";14;"19.1";532;45375;44843
731;"01.01.2008";15;"17.1";516;45514;44998
731;"01.01.2008";16;"19.1";476;45913;45437
731;"01.01.2008";17;"30.1";517;48707;48190
731;"01.01.2008";18;45;501;52706;52205
731;"01.01.2008";19;"47.7";520;53722;53202
731;"01.01.2008";20;"45.1";587;53071;52484
731;"01.01.2008";21;"45.1";704;51203;50499
731;"01.01.2008";22;"40.5";800;50605;49805
731;"01.01.2008";23;"42.2";937;51419;50482
731;"01.01.2008";24;"30.1";979;48636;47657
732;"02.01.2008";1;35;1114;46067;44953
732;"02.01.2008";2;"31.1";1063;43884;42821
732;"02.01.2008";3;"28.8";1091;42909;41818
732;"02.01.2008";4;"28.3";1246;42610;41364
732;"02.01.2008";5;"33.8";1335;43187;41852
732;"02.01.2008";6;"35.9";1684;45404;43720
732;"02.01.2008";7;38;1915;49446;47531
732;"02.01.2008";8;"57.4";2000;55797;53797
732;"02.01.2008";9;"60.3";2066;59481;57415
732;"02.01.2008";10;"68.7";2210;61438;59228
732;"02.01.2008";11;"72.5";2237;62678;60441
732;"02.01.2008";12;"74.4";2388;63884;61496
732;"02.01.2008";13;75;2432;64225;61793
732;"02.01.2008";14;76;2744;63654;60910
732;"02.01.2008";15;"73.3";3273;63013;59740
732;"02.01.2008";16;"69.6";3912;63129;59217
732;"02.01.2008";17;76;4754;64986;60232
732;"02.01.2008";18;"90.2";5743;68985;63242
732;"02.01.2008";19;90;6564;68962;62398
732;"02.01.2008";20;"75.1";7026;67243;60217
732;"02.01.2008";21;69;7241;64208;56967
732;"02.01.2008";22;"51.9";7376;62328;54952
732;"02.01.2008";23;"52.2";7734;61694;53960
732;"02.01.2008";24;42;8164;58273;50109
733;"03.01.2008";1;51;8563;55065;46502
733;"03.01.2008";2;"45.1";9159;52841;43682
733;"03.01.2008";3;"40.9";9880;51628;41748
733;"03.01.2008";4;"38.9";10262;51215;40953
733;"03.01.2008";5;"40.6";10883;51664;40781
733;"03.01.2008";6;"44.8";11812;53307;41495
733;"03.01.2008";7;"43.3";12136;56565;44429
733;"03.01.2008";8;54;12347;62472;50125
733;"03.01.2008";9;"56.8";12084;65989;53905
733;"03.01.2008";10;"67.7";12036;67425;55389
733;"03.01.2008";11;"70.9";12156;68323;56167
733;"03.01.2008";12;"71.8";11882;69560;57678
733;"03.01.2008";13;"74.6";11936;69768;57832
733;"03.01.2008";14;"70.1";11802;68830;57028
733;"03.01.2008";15;"65.9";11936;68253;56317
733;"03.01.2008";16;63;12365;68177;55812
733;"03.01.2008";17;"62.4";12688;69626;56938
733;"03.01.2008";18;"74.6";12820;72743;59923
733;"03.01.2008";19;"71.7";12782;72362;59580
733;"03.01.2008";20;"53.2";12733;70617;57884
733;"03.01.2008";21;"49.4";12376;66888;54512
733;"03.01.2008";22;40;12105;64640;52535
733;"03.01.2008";23;"38.3";11688;63646;51958
733;"03.01.2008";24;"30.9";11580;60106;48526
734;"04.01.2008";1;"43.8";11485;56782;45297
734;"04.01.2008";2;"40.4";11249;54376;43127
734;"04.01.2008";3;"39.3";11237;52937;41700
734;"04.01.2008";4;"37.3";10800;52401;41601
734;"04.01.2008";5;"37.3";10577;52618;42041
734;"04.01.2008";6;"44.6";10344;53538;43194
734;"04.01.2008";7;"39.8";10191;56865;46674
734;"04.01.2008";8;"55.8";9995;62711;52716
734;"04.01.2008";9;"54.2";9733;66027;56294
734;"04.01.2008";10;"66.5";9496;67557;58061
734;"04.01.2008";11;"70.6";9469;68463;58994
734;"04.01.2008";12;"76.1";9135;69024;59889
734;"04.01.2008";13;"72.4";8796;68813;60017
734;"04.01.2008";14;"69.4";8143;67419;59276
734;"04.01.2008";15;"55.5";7834;66421;58587
734;"04.01.2008";16;"54.7";7419;65818;58399
734;"04.01.2008";17;"72.1";7886;67783;59897
734;"04.01.2008";18;"80.1";8119;71726;63607
734;"04.01.2008";19;"77.6";8557;71489;62932
734;"04.01.2008";20;"65.2";8815;69491;60676
734;"04.01.2008";21;"54.2";9037;65049;56012
734;"04.01.2008";22;"50.6";9253;63203;53950
734;"04.01.2008";23;"51.6";9473;63144;53671
734;"04.01.2008";24;"34.9";9664;59408;49744
735;"05.01.2008";1;"49.3";9631;56148;46517
735;"05.01.2008";2;45;9722;54067;44345
735;"05.01.2008";3;"43.2";10361;52396;42035
735;"05.01.2008";4;"39.1";10697;51238;40541
735;"05.01.2008";5;"31.3";11307;50751;39444
735;"05.01.2008";6;"30.1";11423;49485;38062
735;"05.01.2008";7;"0.1";11238;48215;36977
735;"05.01.2008";8;"25.3";11836;50940;39104
735;"05.01.2008";9;"39.1";11986;54601;42615
735;"05.01.2008";10;"49.5";11924;57844;45920
735;"05.01.2008";11;"51.1";11422;60253;48831
735;"05.01.2008";12;"54.8";10914;61794;50880
735;"05.01.2008";13;"51.6";10132;61662;51530
735;"05.01.2008";14;"52.8";9750;60213;50463
735;"05.01.2008";15;"49.6";9359;59405;50046
735;"05.01.2008";16;"48.2";8782;59489;50707
735;"05.01.2008";17;"50.6";8232;60765;52533
735;"05.01.2008";18;"65.1";8140;64081;55941
735;"05.01.2008";19;"63.6";7784;63912;56128
735;"05.01.2008";20;"62.5";7308;61667;54359
735;"05.01.2008";21;"44.6";7345;58061;50716
735;"05.01.2008";22;45;6864;56416;49552
735;"05.01.2008";23;"49.5";6085;56554;50469
735;"05.01.2008";24;45;5631;52718;47087
736;"06.01.2008";1;"46.9";5229;49316;44087
736;"06.01.2008";2;"45.1";4694;46746;42052
736;"06.01.2008";3;"42.1";4263;45135;40872
736;"06.01.2008";4;"37.2";3967;44785;40818
736;"06.01.2008";5;"35.4";3241;44168;40927
736;"06.01.2008";6;"36.1";3266;43116;39850
736;"06.01.2008";7;2;3099;40760;37661
736;"06.01.2008";8;"10.5";3083;41966;38883
736;"06.01.2008";9;"32.8";3112;44560;41448
736;"06.01.2008";10;42;3343;47735;44392
736;"06.01.2008";11;"45.9";3724;50724;47000
736;"06.01.2008";12;"53.7";3721;53869;50148
736;"06.01.2008";13;54;4331;53899;49568
736;"06.01.2008";14;46;4941;52468;47527
736;"06.01.2008";15;44;5277;51016;45739
736;"06.01.2008";16;"43.2";5327;50317;44990
736;"06.01.2008";17;"45.4";5146;52450;47304
736;"06.01.2008";18;54;4796;57767;52971
736;"06.01.2008";19;"64.6";4773;59238;54465
736;"06.01.2008";20;"55.7";5073;58578;53505
736;"06.01.2008";21;"51.8";4701;55978;51277
736;"06.01.2008";22;48;4540;55298;50758
736;"06.01.2008";23;"48.8";4274;56150;51876
736;"06.01.2008";24;43;4187;52623;48436
737;"07.01.2008";1;"42.3";4301;49665;45364
737;"07.01.2008";2;"40.1";4409;47790;43381
737;"07.01.2008";3;40;4718;46864;42146
737;"07.01.2008";4;39;5436;47226;41790
737;"07.01.2008";5;"42.5";6166;48352;42186
737;"07.01.2008";6;45;7170;51257;44087
737;"07.01.2008";7;"48.5";8619;59460;50841
737;"07.01.2008";8;"90.1";9170;67081;57911
737;"07.01.2008";9;"93.6";9534;70101;60567
737;"07.01.2008";10;"92.6";10130;70511;60381
737;"07.01.2008";11;"90.2";10313;70801;60488
737;"07.01.2008";12;"91.2";10675;71485;60810
737;"07.01.2008";13;"90.1";11067;70615;59548
737;"07.01.2008";14;"86.9";12265;70404;58139
737;"07.01.2008";15;"85.1";12550;70095;57545
737;"07.01.2008";16;"80.6";13244;70160;56916
737;"07.01.2008";17;"80.1";14154;71194;57040
737;"07.01.2008";18;95;15315;75076;59761
737;"07.01.2008";19;"90.2";15309;75199;59890
737;"07.01.2008";20;75;15748;73196;57448
737;"07.01.2008";21;"63.7";15706;69218;53512
737;"07.01.2008";22;"51.5";15818;66679;50861
737;"07.01.2008";23;"50.1";15101;64525;49424
737;"07.01.2008";24;"40.1";14990;59861;44871
738;"08.01.2008";1;"42.2";14963;55834;40871
738;"08.01.2008";2;"38.1";14286;53577;39291
738;"08.01.2008";3;"36.5";13666;52562;38896
738;"08.01.2008";4;"36.8";12981;52893;39912
738;"08.01.2008";5;"37.7";12206;54237;42031
738;"08.01.2008";6;"47.9";11572;56686;45114
738;"08.01.2008";7;"47.2";11083;63036;51953
738;"08.01.2008";8;84;10901;69661;58760
738;"08.01.2008";9;"81.1";10453;71348;60895
738;"08.01.2008";10;80;9851;70486;60635
738;"08.01.2008";11;"83.4";9062;70533;61471
738;"08.01.2008";12;"86.7";8482;71287;62805
738;"08.01.2008";13;"86.3";7981;70890;62909
738;"08.01.2008";14;86;7104;70449;63345
738;"08.01.2008";15;"84.8";6681;69585;62904
738;"08.01.2008";16;"82.4";5918;69106;63188
738;"08.01.2008";17;"85.9";5826;70241;64415
738;"08.01.2008";18;95;5572;73891;68319
738;"08.01.2008";19;"104.5";6139;73839;67700
738;"08.01.2008";20;"85.8";6461;71683;65222
738;"08.01.2008";21;"68.3";6653;67462;60809
738;"08.01.2008";22;"55.6";6753;64807;58054
738;"08.01.2008";23;"54.3";6648;63249;56601
738;"08.01.2008";24;"45.1";6942;58646;51704
739;"09.01.2008";1;"48.1";7286;55293;48007
739;"09.01.2008";2;"41.3";7336;53232;45896
739;"09.01.2008";3;39;7664;52392;44728
739;"09.01.2008";4;29;8190;52454;44264
739;"09.01.2008";5;"28.6";8570;53243;44673
739;"09.01.2008";6;"40.1";9448;55481;46033
739;"09.01.2008";7;"41.8";9912;62195;52283
739;"09.01.2008";8;"58.9";9693;68907;59214
739;"09.01.2008";9;"76.1";9473;71208;61735
739;"09.01.2008";10;"77.9";9221;70400;61179
739;"09.01.2008";11;79;8791;70939;62148
739;"09.01.2008";12;"81.6";8275;71639;63364
739;"09.01.2008";13;77;7628;71113;63485
739;"09.01.2008";14;"77.1";7356;70859;63503
739;"09.01.2008";15;"76.9";7068;70243;63175
739;"09.01.2008";16;"72.1";7619;70133;62514
739;"09.01.2008";17;"76.1";7431;70952;63521
739;"09.01.2008";18;"88.3";7108;73681;66573
739;"09.01.2008";19;"84.8";7131;72845;65714
739;"09.01.2008";20;"76.3";7346;70846;63500
739;"09.01.2008";21;"64.1";7779;67146;59367
739;"09.01.2008";22;"53.5";8317;64797;56480
739;"09.01.2008";23;"53.5";8532;63381;54849
739;"09.01.2008";24;"43.3";8544;58646;50102
740;"10.01.2008";1;47;8562;55036;46474
740;"10.01.2008";2;"43.8";8461;52920;44459
740;"10.01.2008";3;42;8387;52181;43794
740;"10.01.2008";4;"41.7";8872;52616;43744
740;"10.01.2008";5;"35.3";8778;53516;44738
740;"10.01.2008";6;49;8881;55649;46768
740;"10.01.2008";7;"53.6";9626;62193;52567
740;"10.01.2008";8;"77.1";11058;69601;58543
740;"10.01.2008";9;"84.6";11615;71531;59916
740;"10.01.2008";10;"84.5";11872;70663;58791
740;"10.01.2008";11;"84.5";11877;70672;58795
740;"10.01.2008";12;"84.1";11692;71087;59395
740;"10.01.2008";13;"81.5";11493;70593;59100
740;"10.01.2008";14;83;11260;70141;58881
740;"10.01.2008";15;"81.5";11068;69390;58322
740;"10.01.2008";16;"79.2";11041;69323;58282
740;"10.01.2008";17;"79.1";11636;70714;59078
740;"10.01.2008";18;"87.6";12419;74745;62326
740;"10.01.2008";19;"85.3";13174;74768;61594
740;"10.01.2008";20;"83.1";13462;72830;59368
740;"10.01.2008";21;"61.1";13974;69140;55166
740;"10.01.2008";22;"51.5";13943;66340;52397
740;"10.01.2008";23;"48.9";13974;64614;50640
740;"10.01.2008";24;36;14254;60106;45852
741;"11.01.2008";1;"44.7";13869;56626;42757
741;"11.01.2008";2;"42.1";13272;54394;41122
741;"11.01.2008";3;"38.1";12930;53165;40235
741;"11.01.2008";4;"35.7";12523;53180;40657
741;"11.01.2008";5;"31.9";12058;54280;42222
741;"11.01.2008";6;50;11960;56707;44747
741;"11.01.2008";7;"55.4";11770;62962;51192
741;"11.01.2008";8;"82.4";11094;70081;58987
741;"11.01.2008";9;"84.5";10295;71792;61497
741;"11.01.2008";10;"84.3";9740;71102;61362
741;"11.01.2008";11;"84.2";9127;71450;62323
741;"11.01.2008";12;"84.1";8522;71613;63091
741;"11.01.2008";13;"80.3";8195;70692;62497
741;"11.01.2008";14;74;7439;69083;61644
741;"11.01.2008";15;72;7426;67716;60290
741;"11.01.2008";16;"70.5";7654;67124;59470
741;"11.01.2008";17;"72.1";8334;68881;60547
741;"11.01.2008";18;"82.8";9395;73400;64005
741;"11.01.2008";19;"84.2";9711;72602;62891
741;"11.01.2008";20;"72.2";9864;69943;60079
741;"11.01.2008";21;"63.7";9817;65783;55966
741;"11.01.2008";22;"53.5";8890;63016;54126
741;"11.01.2008";23;"51.6";8271;61514;53243
741;"11.01.2008";24;"48.9";8120;57173;49053
742;"12.01.2008";1;"50.2";8149;54103;45954
742;"12.01.2008";2;46;8219;51916;43697
742;"12.01.2008";3;"41.8";8047;50257;42210
742;"12.01.2008";4;"31.4";8193;49415;41222
742;"12.01.2008";5;"32.5";8341;49761;41420
742;"12.01.2008";6;"41.9";8682;48854;40172
742;"12.01.2008";7;"25.2";9155;48444;39289
742;"12.01.2008";8;"43.8";9529;52028;42499
742;"12.01.2008";9;"56.3";9669;55616;45947
742;"12.01.2008";10;61;9640;58561;48921
742;"12.01.2008";11;"60.9";9852;60631;50779
742;"12.01.2008";12;62;9881;62001;52120
742;"12.01.2008";13;"63.1";10473;61854;51381
742;"12.01.2008";14;"54.8";10338;60278;49940
742;"12.01.2008";15;"52.4";11060;59135;48075
742;"12.01.2008";16;52;11137;59253;48116
742;"12.01.2008";17;"52.4";10856;60922;50066
742;"12.01.2008";18;"60.1";10884;64730;53846
742;"12.01.2008";19;72;10883;65068;54185
742;"12.01.2008";20;"68.5";10283;62080;51797
742;"12.01.2008";21;"55.3";9500;57947;48447
742;"12.01.2008";22;"52.1";8680;56149;47469
742;"12.01.2008";23;"50.6";8144;56582;48438
742;"12.01.2008";24;"42.7";7181;53342;46161
743;"13.01.2008";1;"42.1";6644;50368;43724
743;"13.01.2008";2;"35.7";6117;48009;41892
743;"13.01.2008";3;"35.7";5357;46746;41389
743;"13.01.2008";4;"35.3";5141;46265;41124
743;"13.01.2008";5;30;5073;45991;40918
743;"13.01.2008";6;35;4774;44729;39955
743;"13.01.2008";7;"4.1";4940;42303;37363
743;"13.01.2008";8;"24.6";5287;43790;38503
743;"13.01.2008";9;"36.5";5754;46825;41071
743;"13.01.2008";10;"45.6";5498;49853;44355
743;"13.01.2008";11;51;4921;52113;47192
743;"13.01.2008";12;"55.4";4528;54541;50013
743;"13.01.2008";13;"53.1";4350;53427;49077
743;"13.01.2008";14;"50.8";4199;51143;46944
743;"13.01.2008";15;"44.5";3985;49375;45390
743;"13.01.2008";16;"37.2";3814;48954;45140
743;"13.01.2008";17;"44.7";4272;50853;46581
743;"13.01.2008";18;"57.7";5014;57392;52378
743;"13.01.2008";19;62;5719;59665;53946
743;"13.01.2008";20;"59.5";6219;58696;52477
743;"13.01.2008";21;54;6477;56594;50117
743;"13.01.2008";22;"51.6";6628;55899;49271
743;"13.01.2008";23;"50.9";6527;57306;50779
743;"13.01.2008";24;46;6493;54166;47673
744;"14.01.2008";1;"39.8";6657;51219;44562
744;"14.01.2008";2;"34.6";6679;49430;42751
744;"14.01.2008";3;"32.2";7493;48852;41359
744;"14.01.2008";4;"31.2";7456;48574;41118
744;"14.01.2008";5;"32.2";7465;50200;42735
744;"14.01.2008";6;"39.5";7824;53559;45735
744;"14.01.2008";7;"48.7";8191;61412;53221
744;"14.01.2008";8;"82.1";8400;69075;60675
744;"14.01.2008";9;"84.1";8297;71511;63214
744;"14.01.2008";10;"84.6";8640;71116;62476
744;"14.01.2008";11;"85.8";8067;71667;63600
744;"14.01.2008";12;"85.4";7610;72029;64419
744;"14.01.2008";13;"84.1";7304;71841;64537
744;"14.01.2008";14;"84.1";6854;71455;64601
744;"14.01.2008";15;"83.6";6988;71141;64153
744;"14.01.2008";16;"82.4";7107;70518;63411
744;"14.01.2008";17;"81.5";7661;70924;63263
744;"14.01.2008";18;"89.7";8297;74541;66244
744;"14.01.2008";19;89;9396;74508;65112
744;"14.01.2008";20;87;9923;72259;62336
744;"14.01.2008";21;"71.8";10337;68158;57821
744;"14.01.2008";22;"56.2";10751;65620;54869
744;"14.01.2008";23;"53.5";10471;63624;53153
744;"14.01.2008";24;49;10081;58682;48601
745;"15.01.2008";1;"48.4";10268;55453;45185
745;"15.01.2008";2;"45.3";10331;53139;42808
745;"15.01.2008";3;"44.4";10648;52216;41568
745;"15.01.2008";4;"38.8";10585;52139;41554
745;"15.01.2008";5;"36.6";10536;53445;42909
745;"15.01.2008";6;"50.1";10909;55981;45072
745;"15.01.2008";7;"54.8";10811;62776;51965
745;"15.01.2008";8;"84.5";11053;70084;59031
745;"15.01.2008";9;"83.8";11622;72527;60905
745;"15.01.2008";10;"81.4";11799;71495;59696
745;"15.01.2008";11;81;11968;71751;59783
745;"15.01.2008";12;"78.9";12394;72402;60008
745;"15.01.2008";13;"77.1";12702;71931;59229
745;"15.01.2008";14;77;13501;71632;58131
745;"15.01.2008";15;"76.1";14004;71370;57366
745;"15.01.2008";16;"72.1";14693;71556;56863
745;"15.01.2008";17;"72.2";15744;72810;57066
745;"15.01.2008";18;"77.2";16911;76648;59737
745;"15.01.2008";19;"80.4";17714;76763;59049
745;"15.01.2008";20;"70.1";17830;74852;57022
745;"15.01.2008";21;"62.3";17787;70579;52792
745;"15.01.2008";22;"51.5";17268;67585;50317
745;"15.01.2008";23;"51.5";16885;65441;48556
745;"15.01.2008";24;"41.7";16749;60492;43743
746;"16.01.2008";1;"37.8";16400;56607;40207
746;"16.01.2008";2;"35.6";16259;54195;37936
746;"16.01.2008";3;"25.6";16336;53239;36903
746;"16.01.2008";4;"6.5";16201;53539;37338
746;"16.01.2008";5;"25.7";15740;54640;38900
746;"16.01.2008";6;"41.8";14983;56687;41704
746;"16.01.2008";7;"50.1";14181;63410;49229
746;"16.01.2008";8;"74.8";13110;70163;57053
746;"16.01.2008";9;"81.1";12057;72489;60432
746;"16.01.2008";10;"82.1";11224;72104;60880
746;"16.01.2008";11;84;10975;72677;61702
746;"16.01.2008";12;"84.1";11108;73615;62507
746;"16.01.2008";13;"85.9";10810;72615;61805
746;"16.01.2008";14;"82.1";10194;71507;61313
746;"16.01.2008";15;"81.9";9077;70240;61163
746;"16.01.2008";16;"83.9";7894;69727;61833
746;"16.01.2008";17;"81.7";6768;69872;63104
746;"16.01.2008";18;90;6065;73692;67627
746;"16.01.2008";19;"100.1";5835;73714;67879
746;"16.01.2008";20;90;5766;71673;65907
746;"16.01.2008";21;86;5538;67321;61783
746;"16.01.2008";22;"75.3";5091;64598;59507
746;"16.01.2008";23;"70.1";4724;62502;57778
746;"16.01.2008";24;"51.6";4025;57817;53792
747;"17.01.2008";1;"55.6";3656;53627;49971
747;"17.01.2008";2;"49.1";3120;51257;48137
747;"17.01.2008";3;"46.1";2917;50471;47554
747;"17.01.2008";4;"45.9";2903;50739;47836
747;"17.01.2008";5;"46.4";2834;51743;48909
747;"17.01.2008";6;"51.5";2977;54034;51057
747;"17.01.2008";7;68;3086;60805;57719
747;"17.01.2008";8;"98.9";3246;68223;64977
747;"17.01.2008";9;"95.1";3409;70387;66978
747;"17.01.2008";10;"94.7";3447;69717;66270
747;"17.01.2008";11;93;3379;70156;66777
747;"17.01.2008";12;"91.1";3590;70572;66982
747;"17.01.2008";13;"88.7";3995;69801;65806
747;"17.01.2008";14;88;4441;69656;65215
747;"17.01.2008";15;"88.1";4754;69365;64611
747;"17.01.2008";16;"85.1";5336;69360;64024
747;"17.01.2008";17;"84.1";6168;69866;63698
747;"17.01.2008";18;"90.1";7428;73802;66374
747;"17.01.2008";19;"89.1";8726;73852;65126
747;"17.01.2008";20;84;10044;72022;61978
747;"17.01.2008";21;72;10753;68198;57445
747;"17.01.2008";22;"53.6";11658;66045;54387
747;"17.01.2008";23;"51.6";12290;63933;51643
747;"17.01.2008";24;42;12147;59026;46879
748;"18.01.2008";1;"44.6";12355;55442;43087
748;"18.01.2008";2;42;12229;53344;41115
748;"18.01.2008";3;"37.9";12081;52403;40322
748;"18.01.2008";4;"36.4";11802;52735;40933
748;"18.01.2008";5;"36.3";11013;53063;42050
748;"18.01.2008";6;"42.1";10828;55274;44446
748;"18.01.2008";7;"51.4";10415;61397;50982
748;"18.01.2008";8;74;9729;68285;58556
748;"18.01.2008";9;"80.2";9258;70787;61529
748;"18.01.2008";10;"80.1";8688;70245;61557
748;"18.01.2008";11;"81.1";9073;70918;61845
748;"18.01.2008";12;"82.9";9247;71953;62706
748;"18.01.2008";13;"78.1";9559;71068;61509
748;"18.01.2008";14;"73.7";9818;69738;59920
748;"18.01.2008";15;68;9291;67987;58696
748;"18.01.2008";16;"61.7";9308;67795;58487
748;"18.01.2008";17;59;9586;69072;59486
748;"18.01.2008";18;"72.9";10126;72768;62642
748;"18.01.2008";19;"74.6";11232;72514;61282
748;"18.01.2008";20;"70.7";12617;69815;57198
748;"18.01.2008";21;"53.4";13575;65776;52201
748;"18.01.2008";22;"50.1";15132;64074;48942
748;"18.01.2008";23;50;16052;63059;47007
748;"18.01.2008";24;38;16862;59227;42365
749;"19.01.2008";1;"48.9";17369;55918;38549
749;"19.01.2008";2;"33.2";17492;53091;35599
749;"19.01.2008";3;"30.1";17530;51836;34306
749;"19.01.2008";4;"25.1";17331;51652;34321
749;"19.01.2008";5;10;17163;51736;34573
749;"19.01.2008";6;"18.1";16915;51562;34647
749;"19.01.2008";7;0;16909;51662;34753
749;"19.01.2008";8;"28.6";16746;54974;38228
749;"19.01.2008";9;"36.3";15758;58215;42457
749;"19.01.2008";10;"52.9";15254;61180;45926
749;"19.01.2008";11;"56.1";14241;62899;48658
749;"19.01.2008";12;"59.7";13713;63778;50065
749;"19.01.2008";13;"54.7";13067;62630;49563
749;"19.01.2008";14;55;12200;60098;47898
749;"19.01.2008";15;"49.9";11776;58157;46381
749;"19.01.2008";16;"47.1";11250;57350;46100
749;"19.01.2008";17;"49.2";10728;58228;47500
749;"19.01.2008";18;"59.9";9628;62227;52599
749;"19.01.2008";19;"67.7";8504;62467;53963
749;"19.01.2008";20;"58.1";7284;59664;52380
749;"19.01.2008";21;48;6715;55678;48963
749;"19.01.2008";22;"42.6";5380;53653;48273
749;"19.01.2008";23;"48.1";4710;53527;48817
749;"19.01.2008";24;"36.4";4309;49762;45453
750;"20.01.2008";1;"42.1";4166;46229;42063
750;"20.01.2008";2;"37.9";4007;43419;39412
750;"20.01.2008";3;"37.9";3892;41981;38089
750;"20.01.2008";4;32;4188;41916;37728
750;"20.01.2008";5;"31.9";4681;42529;37848
750;"20.01.2008";6;"28.7";5246;41876;36630
750;"20.01.2008";7;"9.7";5827;40187;34360
750;"20.01.2008";8;22;6661;42298;35637
750;"20.01.2008";9;"30.1";8029;45729;37700
750;"20.01.2008";10;"38.1";9012;49548;40536
750;"20.01.2008";11;44;9862;52605;42743
750;"20.01.2008";12;"48.8";10991;56102;45111
750;"20.01.2008";13;"48.3";11881;55946;44065
750;"20.01.2008";14;"39.4";12445;54067;41622
750;"20.01.2008";15;34;13262;52831;39569
750;"20.01.2008";16;28;13825;52896;39071
750;"20.01.2008";17;"31.4";14109;54766;40657
750;"20.01.2008";18;"48.1";13953;59467;45514
750;"20.01.2008";19;"53.7";13654;61443;47789
750;"20.01.2008";20;"53.6";13164;60114;46950
750;"20.01.2008";21;"51.8";13030;57787;44757
750;"20.01.2008";22;"46.1";12408;56488;44080
750;"20.01.2008";23;"48.5";11965;57410;45445
750;"20.01.2008";24;38;11505;53529;42024
751;"21.01.2008";1;"27.9";11039;49524;38485
751;"21.01.2008";2;"27.1";11386;47357;35971
751;"21.01.2008";3;"27.9";11113;46810;35697
751;"21.01.2008";4;"23.1";11082;47703;36621
751;"21.01.2008";5;"17.1";10780;49534;38754
751;"21.01.2008";6;30;10476;52569;42093
751;"21.01.2008";7;41;10537;60698;50161
751;"21.01.2008";8;"70.5";10539;68604;58065
751;"21.01.2008";9;"66.8";10042;71239;61197
751;"21.01.2008";10;"66.1";9775;70989;61214
751;"21.01.2008";11;"66.1";9853;71546;61693
751;"21.01.2008";12;"68.1";10145;72961;62816
751;"21.01.2008";13;"68.1";10319;72664;62345
751;"21.01.2008";14;"66.9";10238;72365;62127
751;"21.01.2008";15;65;10505;71789;61284
751;"21.01.2008";16;"59.9";10683;71537;60854
751;"21.01.2008";17;62;10648;71353;60705
751;"21.01.2008";18;"76.7";11116;74950;63834
751;"21.01.2008";19;84;11085;74334;63249
751;"21.01.2008";20;"72.1";11563;72321;60758
751;"21.01.2008";21;"64.8";12089;68327;56238
751;"21.01.2008";22;"54.2";12490;65560;53070
751;"21.01.2008";23;"53.8";13464;63703;50239
751;"21.01.2008";24;"44.3";13540;58694;45154
752;"22.01.2008";1;"49.3";13394;54909;41515
752;"22.01.2008";2;"41.8";13167;52647;39480
752;"22.01.2008";3;36;11730;51362;39632
752;"22.01.2008";4;35;10404;51568;41164
752;"22.01.2008";5;"36.8";10055;52986;42931
752;"22.01.2008";6;"51.6";9784;55272;45488
752;"22.01.2008";7;"49.5";9221;61917;52696
752;"22.01.2008";8;"73.9";8904;69342;60438
752;"22.01.2008";9;"71.9";8619;71451;62832
752;"22.01.2008";10;72;8020;71422;63402
752;"22.01.2008";11;"72.1";7958;72406;64448
752;"22.01.2008";12;"74.1";8035;73397;65362
752;"22.01.2008";13;"72.1";8006;72504;64498
752;"22.01.2008";14;"72.2";7927;71809;63882
752;"22.01.2008";15;70;7524;70373;62849
752;"22.01.2008";16;"65.9";6700;69808;63108
752;"22.01.2008";17;"71.7";5740;68982;63242
752;"22.01.2008";18;"88.1";5363;72876;67513
752;"22.01.2008";19;"90.5";4975;73952;68977
752;"22.01.2008";20;"82.1";4374;71857;67483
752;"22.01.2008";21;"76.1";4140;67563;63423
752;"22.01.2008";22;"63.7";3898;64828;60930
752;"22.01.2008";23;65;3595;63065;59470
752;"22.01.2008";24;"51.5";3731;58603;54872
753;"23.01.2008";1;"42.2";3900;55032;51132
753;"23.01.2008";2;"41.5";4010;52829;48819
753;"23.01.2008";3;"38.3";4271;52067;47796
753;"23.01.2008";4;"35.4";4168;52139;47971
753;"23.01.2008";5;"35.5";4048;52720;48672
753;"23.01.2008";6;42;4099;54863;50764
753;"23.01.2008";7;"52.2";4298;61569;57271
753;"23.01.2008";8;"76.2";4571;68982;64411
753;"23.01.2008";9;79;4909;70615;65706
753;"23.01.2008";10;"76.8";5296;70164;64868
753;"23.01.2008";11;"76.2";5452;70168;64716
753;"23.01.2008";12;78;5919;70593;64674
753;"23.01.2008";13;74;6360;69994;63634
753;"23.01.2008";14;"68.8";7067;70247;63180
753;"23.01.2008";15;"64.1";7103;69634;62531
753;"23.01.2008";16;"59.7";7211;69264;62053
753;"23.01.2008";17;"60.1";8042;70120;62078
753;"23.01.2008";18;72;8876;74194;65318
753;"23.01.2008";19;"76.1";9443;74776;65333
753;"23.01.2008";20;68;9765;72628;62863
753;"23.01.2008";21;60;9941;68376;58435
753;"23.01.2008";22;"51.2";9995;65250;55255
753;"23.01.2008";23;"50.1";9680;63231;53551
753;"23.01.2008";24;"44.4";9613;58504;48891
754;"24.01.2008";1;50;9739;54716;44977
754;"24.01.2008";2;"42.5";9570;52186;42616
754;"24.01.2008";3;"39.6";9291;51072;41781
754;"24.01.2008";4;"34.4";9159;51379;42220
754;"24.01.2008";5;34;9161;52626;43465
754;"24.01.2008";6;"45.7";9066;55094;46028
754;"24.01.2008";7;"51.3";9114;61986;52872
754;"24.01.2008";8;75;9177;69202;60025
754;"24.01.2008";9;80;8815;71031;62216
754;"24.01.2008";10;78;8552;70622;62070
754;"24.01.2008";11;78;8066;70802;62736
754;"24.01.2008";12;79;7814;71183;63369
754;"24.01.2008";13;"76.5";8045;70747;62702
754;"24.01.2008";14;75;8084;70365;62281
754;"24.01.2008";15;"68.1";7847;69941;62094
754;"24.01.2008";16;"62.9";7700;69954;62254
754;"24.01.2008";17;"62.9";8138;70234;62096
754;"24.01.2008";18;"71.9";9085;74048;64963
754;"24.01.2008";19;83;9951;74677;64726
754;"24.01.2008";20;"74.9";11473;72690;61217
754;"24.01.2008";21;61;12144;68574;56430
754;"24.01.2008";22;"52.4";13089;66682;53593
754;"24.01.2008";23;"52.2";13547;65425;51878
754;"24.01.2008";24;"44.2";12765;60739;47974
755;"25.01.2008";1;"40.5";12078;57114;45036
755;"25.01.2008";2;"38.3";11122;54803;43681
755;"25.01.2008";3;"37.9";10063;53443;43380
755;"25.01.2008";4;"33.4";9258;53302;44044
755;"25.01.2008";5;"33.4";9275;54549;45274
755;"25.01.2008";6;"40.8";10214;57056;46842
755;"25.01.2008";7;48;11304;63493;52189
755;"25.01.2008";8;"67.9";12323;70751;58428
755;"25.01.2008";9;"64.2";13220;72677;59457
755;"25.01.2008";10;"59.3";14074;72797;58723
755;"25.01.2008";11;57;14836;73113;58277
755;"25.01.2008";12;"56.9";15631;73560;57929
755;"25.01.2008";13;"53.7";16278;72634;56356
755;"25.01.2008";14;"51.5";16695;71661;54966
755;"25.01.2008";15;48;16851;70593;53742
755;"25.01.2008";16;"47.5";16455;70050;53595
755;"25.01.2008";17;"49.9";16306;70457;54151
755;"25.01.2008";18;"56.8";16251;74656;58405
755;"25.01.2008";19;"55.5";16655;75920;59265
755;"25.01.2008";20;"51.5";16647;73138;56491
755;"25.01.2008";21;"51.2";16744;68609;51865
755;"25.01.2008";22;"45.9";16546;66505;49959
755;"25.01.2008";23;"46.7";16305;65630;49325
755;"25.01.2008";24;37;15976;61912;45936
756;"26.01.2008";1;51;15427;58125;42698
756;"26.01.2008";2;45;14984;55700;40716
756;"26.01.2008";3;"39.3";14871;54201;39330
756;"26.01.2008";4;"37.7";15048;53532;38484
756;"26.01.2008";5;38;15233;53520;38287
756;"26.01.2008";6;"37.7";15814;52951;37137
756;"26.01.2008";7;"25.7";16092;52851;36759
756;"26.01.2008";8;"37.5";16465;56377;39912
756;"26.01.2008";9;"41.6";16877;59660;42783
756;"26.01.2008";10;"52.3";16916;62186;45270
756;"26.01.2008";11;"54.7";17007;63393;46386
756;"26.01.2008";12;"54.8";17210;63866;46656
756;"26.01.2008";13;"51.5";17438;62507;45069
756;"26.01.2008";14;"46.8";17719;60807;43088
756;"26.01.2008";15;"44.9";17924;59477;41553
756;"26.01.2008";16;"38.6";18022;59375;41353
756;"26.01.2008";17;40;17701;60106;42405
756;"26.01.2008";18;"54.1";17317;64701;47384
756;"26.01.2008";19;63;16774;66060;49286
756;"26.01.2008";20;"55.7";16604;63752;47148
756;"26.01.2008";21;"42.3";16100;60216;44116
756;"26.01.2008";22;"43.3";15993;58644;42651
756;"26.01.2008";23;"51.2";15161;58372;43211
756;"26.01.2008";24;38;14302;55413;41111
757;"27.01.2008";1;"34.7";13892;51939;38047
757;"27.01.2008";2;"27.6";12767;49240;36473
757;"27.01.2008";3;"24.1";12224;47625;35401
757;"27.01.2008";4;"23.5";11624;46056;34432
757;"27.01.2008";5;"18.9";11613;45404;33791
757;"27.01.2008";6;"3.6";12311;44581;32270
757;"27.01.2008";7;0;13934;43265;29331
757;"27.01.2008";8;0;14819;45222;30403
757;"27.01.2008";9;20;15653;49181;33528
757;"27.01.2008";10;"30.8";16377;53419;37042
757;"27.01.2008";11;35;17083;56965;39882
757;"27.01.2008";12;47;17136;60322;43186
757;"27.01.2008";13;"45.5";16576;59770;43194
757;"27.01.2008";14;"38.8";15714;57793;42079
757;"27.01.2008";15;"29.7";15122;55925;40803
757;"27.01.2008";16;"28.1";13824;54881;41057
757;"27.01.2008";17;"34.5";12256;55202;42946
757;"27.01.2008";18;"52.3";10704;59041;48337
757;"27.01.2008";19;"54.4";9181;61205;52024
757;"27.01.2008";20;55;7664;59486;51822
757;"27.01.2008";21;"52.1";5852;56152;50300
757;"27.01.2008";22;"48.1";4945;54809;49864
757;"27.01.2008";23;"52.6";4177;56043;51866
757;"27.01.2008";24;"46.5";3343;52514;49171
758;"28.01.2008";1;"41.2";2969;48759;45790
758;"28.01.2008";2;"35.9";2559;46744;44185
758;"28.01.2008";3;"35.3";2291;46092;43801
758;"28.01.2008";4;"33.1";2064;46585;44521
758;"28.01.2008";5;"34.1";1855;48216;46361
758;"28.01.2008";6;"41.3";1506;51789;50283
758;"28.01.2008";7;"46.1";1468;59809;58341
758;"28.01.2008";8;"70.9";1474;67382;65908
758;"28.01.2008";9;"71.1";1702;69838;68136
758;"28.01.2008";10;"70.3";1847;70080;68233
758;"28.01.2008";11;"73.4";1861;70694;68833
758;"28.01.2008";12;75;1764;71463;69699
758;"28.01.2008";13;"74.9";1782;70953;69171
758;"28.01.2008";14;"75.2";1805;70470;68665
758;"28.01.2008";15;"72.6";1859;69561;67702
758;"28.01.2008";16;"70.1";1918;69041;67123
758;"28.01.2008";17;"68.1";1932;68761;66829
758;"28.01.2008";18;"79.4";2040;72138;70098
758;"28.01.2008";19;80;2172;73155;70983
758;"28.01.2008";20;75;2236;70987;68751
758;"28.01.2008";21;"66.5";2290;66665;64375
758;"28.01.2008";22;"52.4";2379;63963;61584
758;"28.01.2008";23;"50.5";2376;61897;59521
758;"28.01.2008";24;47;2334;57151;54817
759;"29.01.2008";1;52;2136;52770;50634
759;"29.01.2008";2;"49.9";2102;50680;48578
759;"29.01.2008";3;"48.3";2136;49545;47409
759;"29.01.2008";4;"47.2";2076;49960;47884
759;"29.01.2008";5;"44.5";2151;51251;49100
759;"29.01.2008";6;52;2039;53936;51897
759;"29.01.2008";7;"64.9";1968;61129;59161
759;"29.01.2008";8;"92.3";1951;68255;66304
759;"29.01.2008";9;"87.1";2110;70041;67931
759;"29.01.2008";10;"86.4";2075;69760;67685
759;"29.01.2008";11;"87.6";1965;70235;68270
759;"29.01.2008";12;"86.8";2101;70699;68598
759;"29.01.2008";13;"83.5";2282;69933;67651
759;"29.01.2008";14;"80.2";2294;69347;67053
759;"29.01.2008";15;"79.1";2170;68815;66645
759;"29.01.2008";16;77;2080;68442;66362
759;"29.01.2008";17;"78.1";1964;68134;66170
759;"29.01.2008";18;"80.7";1870;71681;69811
759;"29.01.2008";19;87;1970;73135;71165
759;"29.01.2008";20;"82.6";2293;71296;69003
759;"29.01.2008";21;"77.3";2442;67324;64882
759;"29.01.2008";22;"62.1";2566;64543;61977
759;"29.01.2008";23;"59.4";2446;62327;59881
759;"29.01.2008";24;"50.2";2308;57844;55536
760;"30.01.2008";1;"52.6";2510;53452;50942
760;"30.01.2008";2;"50.3";2559;51281;48722
760;"30.01.2008";3;"47.3";2707;50346;47639
760;"30.01.2008";4;"42.1";2771;50343;47572
760;"30.01.2008";5;"42.9";2935;51402;48467
760;"30.01.2008";6;50;3114;53925;50811
760;"30.01.2008";7;"51.7";3253;61039;57786
760;"30.01.2008";8;"79.1";3415;68454;65039
760;"30.01.2008";9;"79.6";3405;70438;67033
760;"30.01.2008";10;"82.9";3538;70455;66917
760;"30.01.2008";11;"82.1";3558;70953;67395
760;"30.01.2008";12;"91.1";3905;72447;68542
760;"30.01.2008";13;"82.1";4355;71848;67493
760;"30.01.2008";14;"80.1";4974;71678;66704
760;"30.01.2008";15;"73.9";5320;71041;65721
760;"30.01.2008";16;"71.9";5313;70610;65297
760;"30.01.2008";17;72;5237;70325;65088
760;"30.01.2008";18;"79.9";5265;72893;67628
760;"30.01.2008";19;"93.1";5390;73604;68214
760;"30.01.2008";20;"82.5";5448;71917;66469
760;"30.01.2008";21;"75.1";5496;68061;62565
760;"30.01.2008";22;62;5650;65488;59838
760;"30.01.2008";23;"55.6";5690;63687;57997
760;"30.01.2008";24;"48.1";5495;59163;53668
761;"31.01.2008";1;"53.1";5640;55248;49608
761;"31.01.2008";2;"48.2";5669;53050;47381
761;"31.01.2008";3;44;5736;51928;46192
761;"31.01.2008";4;"40.3";5785;51872;46087
761;"31.01.2008";5;"41.9";5861;52847;46986
761;"31.01.2008";6;50;6315;55135;48820
761;"31.01.2008";7;"55.3";7057;61604;54547
761;"31.01.2008";8;"74.1";8210;68518;60308
761;"31.01.2008";9;"76.2";9234;70307;61073
761;"31.01.2008";10;"76.1";10254;70543;60289
761;"31.01.2008";11;75;11350;71342;59992
761;"31.01.2008";12;"72.1";13052;72566;59514
761;"31.01.2008";13;"72.4";14699;72651;57952
761;"31.01.2008";14;"66.5";15468;72321;56853
761;"31.01.2008";15;"60.1";15856;71698;55842
761;"31.01.2008";16;"51.5";16603;71611;55008
761;"31.01.2008";17;"51.5";17208;71670;54462
761;"31.01.2008";18;"66.2";17841;75292;57451
761;"31.01.2008";19;"68.3";18732;76623;57891
761;"31.01.2008";20;"62.1";18845;74499;55654
761;"31.01.2008";21;"58.3";18786;70529;51743
761;"31.01.2008";22;"48.3";18695;67752;49057
761;"31.01.2008";23;"49.1";18471;66429;47958
761;"31.01.2008";24;"37.3";17925;62368;44443
762;"01.02.2008";1;33;17373;60345;42972
762;"01.02.2008";2;"29.1";16704;58537;41833
762;"01.02.2008";3;26;16754;56852;40098
762;"01.02.2008";4;"26.9";16671;57170;40499
762;"01.02.2008";5;"28.5";16681;57743;41062
762;"01.02.2008";6;"35.1";16610;58344;41734
762;"01.02.2008";7;"42.5";16535;63758;47223
762;"01.02.2008";8;"66.7";16822;69620;52798
762;"01.02.2008";9;54;16875;72393;55518
762;"01.02.2008";10;"59.2";16830;72789;55959
762;"01.02.2008";11;"53.2";17049;73832;56783
762;"01.02.2008";12;"55.1";17155;74767;57612
762;"01.02.2008";13;"53.1";17575;74395;56820
762;"01.02.2008";14;"51.9";16973;72862;55889
762;"01.02.2008";15;"50.7";16246;71119;54873
762;"01.02.2008";16;"50.3";15430;70045;54615
762;"01.02.2008";17;"49.3";14309;69592;55283
762;"01.02.2008";18;"65.1";13532;72883;59351
762;"01.02.2008";19;71;13025;73597;60572
762;"01.02.2008";20;"58.8";13289;70981;57692
762;"01.02.2008";21;"55.9";13352;66838;53486
762;"01.02.2008";22;"47.6";13629;64457;50828
762;"01.02.2008";23;"45.4";14061;64107;50046
762;"01.02.2008";24;"33.5";14282;60476;46194
763;"02.02.2008";1;"46.1";14686;57534;42848
763;"02.02.2008";2;"42.6";15122;56459;41337
763;"02.02.2008";3;47;14792;55001;40209
763;"02.02.2008";4;42;14180;54496;40316
763;"02.02.2008";5;"34.5";12753;53864;41111
763;"02.02.2008";6;"41.9";11890;52793;40903
763;"02.02.2008";7;26;10600;51217;40617
763;"02.02.2008";8;"39.7";8738;52987;44249
763;"02.02.2008";9;"40.1";7987;55591;47604
763;"02.02.2008";10;"50.6";7888;57926;50038
763;"02.02.2008";11;"55.7";7645;59825;52180
763;"02.02.2008";12;57;6900;60585;53685
763;"02.02.2008";13;"57.3";7696;59648;51952
763;"02.02.2008";14;"50.9";7997;57845;49848
763;"02.02.2008";15;"44.5";7905;56230;48325
763;"02.02.2008";16;"43.2";7379;55451;48072
763;"02.02.2008";17;"42.1";6983;55683;48700
763;"02.02.2008";18;"55.6";6561;60021;53460
763;"02.02.2008";19;"62.1";6408;62919;56511
763;"02.02.2008";20;"56.3";6691;61027;54336
763;"02.02.2008";21;"47.7";7592;57264;49672
763;"02.02.2008";22;"37.1";7681;55868;48187
763;"02.02.2008";23;40;8095;56381;48286
763;"02.02.2008";24;"33.2";8687;54339;45652
764;"03.02.2008";1;44;8495;51956;43461
764;"03.02.2008";2;"41.7";8189;50470;42281
764;"03.02.2008";3;"40.2";7780;49504;41724
764;"03.02.2008";4;"39.8";7473;49004;41531
764;"03.02.2008";5;"39.6";7195;48244;41049
764;"03.02.2008";6;39;6894;46771;39877
764;"03.02.2008";7;"25.9";6761;44892;38131
764;"03.02.2008";8;"32.3";6977;45848;38871
764;"03.02.2008";9;"38.3";7039;47743;40704
764;"03.02.2008";10;"43.2";6665;49461;42796
764;"03.02.2008";11;49;5780;50862;45082
764;"03.02.2008";12;"55.1";5866;52909;47043
764;"03.02.2008";13;"50.9";5765;51219;45454
764;"03.02.2008";14;"45.6";5592;48746;43154
764;"03.02.2008";15;"42.5";5425;47057;41632
764;"03.02.2008";16;"39.5";5175;46522;41347
764;"03.02.2008";17;"41.1";5854;47786;41932
764;"03.02.2008";18;"48.2";7354;53476;46122
764;"03.02.2008";19;"52.9";8584;58142;49558
764;"03.02.2008";20;"49.5";9795;57808;48013
764;"03.02.2008";21;"47.1";10276;56179;45903
764;"03.02.2008";22;"46.3";10199;56069;45870
764;"03.02.2008";23;"50.2";9516;57177;47661
764;"03.02.2008";24;"42.1";9147;55255;46108
765;"04.02.2008";1;40;8647;52465;43818
765;"04.02.2008";2;"38.9";8371;50977;42606
765;"04.02.2008";3;"37.4";8523;49808;41285
765;"04.02.2008";4;34;8638;50222;41584
765;"04.02.2008";5;"34.1";8864;50703;41839
765;"04.02.2008";6;"41.2";8664;51817;43153
765;"04.02.2008";7;"46.2";8524;56767;48243
765;"04.02.2008";8;"66.4";8755;62803;54048
765;"04.02.2008";9;"69.3";8604;65266;56662
765;"04.02.2008";10;73;8297;66753;58456
765;"04.02.2008";11;74;7786;67863;60077
765;"04.02.2008";12;75;7153;69412;62259
765;"04.02.2008";13;"73.8";6876;68627;61751
765;"04.02.2008";14;"72.9";6239;67344;61105
765;"04.02.2008";15;"68.9";5422;65909;60487
765;"04.02.2008";16;62;4950;65388;60438
765;"04.02.2008";17;"62.5";4649;65150;60501
765;"04.02.2008";18;"72.1";4351;68289;63938
765;"04.02.2008";19;"80.6";4623;70187;65564
765;"04.02.2008";20;77;5133;68182;63049
765;"04.02.2008";21;"64.8";5373;64444;59071
765;"04.02.2008";22;"51.5";5412;62211;56799
765;"04.02.2008";23;"50.5";5372;61170;55798
765;"04.02.2008";24;"46.5";5574;57623;52049
766;"05.02.2008";1;"47.2";5565;54239;48674
766;"05.02.2008";2;"40.8";5725;52822;47097
766;"05.02.2008";3;"38.4";5719;51787;46068
766;"05.02.2008";4;"37.5";5936;52118;46182
766;"05.02.2008";5;"37.5";6249;53145;46896
766;"05.02.2008";6;"45.5";6646;55080;48434
766;"05.02.2008";7;"53.9";7198;59764;52566
766;"05.02.2008";8;72;8159;65272;57113
766;"05.02.2008";9;"75.9";9242;67505;58263
766;"05.02.2008";10;76;9599;68164;58565
766;"05.02.2008";11;"77.9";10140;69336;59196
766;"05.02.2008";12;79;10880;70841;59961
766;"05.02.2008";13;"73.9";12002;70730;58728
766;"05.02.2008";14;69;12086;69683;57597
766;"05.02.2008";15;"58.5";12408;68647;56239
766;"05.02.2008";16;"54.5";12704;68482;55778
766;"05.02.2008";17;"53.3";13398;68141;54743
766;"05.02.2008";18;"57.8";13857;71522;57665
766;"05.02.2008";19;"70.6";13701;73226;59525
766;"05.02.2008";20;"67.1";13743;71294;57551
766;"05.02.2008";21;"57.7";13527;67069;53542
766;"05.02.2008";22;"47.6";13330;64257;50927
766;"05.02.2008";23;"46.9";13093;62628;49535
766;"05.02.2008";24;"37.6";13507;58820;45313
767;"06.02.2008";1;"38.8";13116;55810;42694
767;"06.02.2008";2;"34.8";13124;53792;40668
767;"06.02.2008";3;34;13407;53180;39773
767;"06.02.2008";4;"24.5";12692;53287;40595
767;"06.02.2008";5;29;12632;54528;41896
767;"06.02.2008";6;"37.6";12035;56144;44109
767;"06.02.2008";7;"45.7";10866;61589;50723
767;"06.02.2008";8;67;10273;67841;57568
767;"06.02.2008";9;"69.9";10017;69932;59915
767;"06.02.2008";10;"70.6";9425;70121;60696
767;"06.02.2008";11;"70.1";9411;71463;62052
767;"06.02.2008";12;"70.6";9198;72481;63283
767;"06.02.2008";13;"70.6";9812;71649;61837
767;"06.02.2008";14;"70.1";10643;71115;60472
767;"06.02.2008";15;68;10775;70258;59483
767;"06.02.2008";16;62;11040;69463;58423
767;"06.02.2008";17;"61.8";11283;68867;57584
767;"06.02.2008";18;"69.1";10875;71810;60935
767;"06.02.2008";19;"83.4";10824;74108;63284
767;"06.02.2008";20;76;11194;72373;61179
767;"06.02.2008";21;63;11225;68479;57254
767;"06.02.2008";22;50;11235;66304;55069
767;"06.02.2008";23;50;10906;65014;54108
767;"06.02.2008";24;45;10825;61047;50222
768;"07.02.2008";1;"46.1";10507;57945;47438
768;"07.02.2008";2;"40.9";10615;56167;45552
768;"07.02.2008";3;41;10469;55579;45110
768;"07.02.2008";4;"37.8";10068;55750;45682
768;"07.02.2008";5;"38.6";9944;56958;47014
768;"07.02.2008";6;"48.4";9640;59092;49452
768;"07.02.2008";7;"55.2";9243;64194;54951
768;"07.02.2008";8;"77.8";9047;69459;60412
768;"07.02.2008";9;"75.3";8500;70721;62221
768;"07.02.2008";10;"77.8";8159;70529;62370
768;"07.02.2008";11;"77.9";7915;70943;63028
768;"07.02.2008";12;"75.1";7890;71420;63530
768;"07.02.2008";13;"73.9";8024;70644;62620
768;"07.02.2008";14;73;7980;69793;61813
768;"07.02.2008";15;"67.5";7419;68464;61045
768;"07.02.2008";16;64;6376;67555;61179
768;"07.02.2008";17;"61.9";4719;66245;61526
768;"07.02.2008";18;"73.8";4029;69702;65673
768;"07.02.2008";19;"85.1";3935;73234;69299
768;"07.02.2008";20;"78.8";3924;71480;67556
768;"07.02.2008";21;"73.7";3937;67408;63471
768;"07.02.2008";22;"57.9";3798;64399;60601
768;"07.02.2008";23;58;3619;62544;58925
768;"07.02.2008";24;"49.9";3606;58881;55275
769;"08.02.2008";1;"52.9";3423;55448;52025
769;"08.02.2008";2;"50.2";3184;53892;50708
769;"08.02.2008";3;"49.1";3043;53258;50215
769;"08.02.2008";4;"40.5";2864;53533;50669
769;"08.02.2008";5;43;2455;54571;52116
769;"08.02.2008";6;"51.6";2226;55677;53451
769;"08.02.2008";7;62;2265;61174;58909
769;"08.02.2008";8;"80.8";2212;67087;64875
769;"08.02.2008";9;"80.1";2235;68596;66361
769;"08.02.2008";10;"83.9";1898;68405;66507
769;"08.02.2008";11;84;1284;68598;67314
769;"08.02.2008";12;"81.9";964;68723;67759
769;"08.02.2008";13;76;934;67528;66594
769;"08.02.2008";14;"70.6";804;65981;65177
769;"08.02.2008";15;"67.9";747;64413;63666
769;"08.02.2008";16;59;699;63810;63111
769;"08.02.2008";17;59;736;63679;62943
769;"08.02.2008";18;70;1118;67349;66231
769;"08.02.2008";19;"82.5";1627;71107;69480
769;"08.02.2008";20;80;2084;68945;66861
769;"08.02.2008";21;72;2532;64500;61968
769;"08.02.2008";22;"62.1";2751;61522;58771
769;"08.02.2008";23;"63.4";2808;60679;57871
769;"08.02.2008";24;"56.3";2772;56540;53768
770;"09.02.2008";1;52;2757;53848;51091
770;"09.02.2008";2;"51.6";2679;52058;49379
770;"09.02.2008";3;"49.5";2494;51077;48583
770;"09.02.2008";4;"48.9";2360;51117;48757
770;"09.02.2008";5;"46.2";2399;51324;48925
770;"09.02.2008";6;48;2538;50510;47972
770;"09.02.2008";7;"41.5";2683;48847;46164
770;"09.02.2008";8;"50.3";2531;50828;48297
770;"09.02.2008";9;"55.7";2658;53938;51280
770;"09.02.2008";10;"66.5";2545;56468;53923
770;"09.02.2008";11;69;1688;57746;56058
770;"09.02.2008";12;"67.9";952;58076;57124
770;"09.02.2008";13;62;761;56479;55718
770;"09.02.2008";14;"58.5";687;54494;53807
770;"09.02.2008";15;"53.4";553;52712;52159
770;"09.02.2008";16;"48.5";535;52275;51740
770;"09.02.2008";17;47;648;52579;51931
770;"09.02.2008";18;"57.9";916;56881;55965
770;"09.02.2008";19;"75.1";1399;61713;60314
770;"09.02.2008";20;"72.1";1921;59664;57743
770;"09.02.2008";21;"62.1";2198;56048;53850
770;"09.02.2008";22;"53.3";2362;54298;51936
770;"09.02.2008";23;"55.7";2112;54418;52306
770;"09.02.2008";24;"53.7";1889;51153;49264
771;"10.02.2008";1;"47.3";1825;48324;46499
771;"10.02.2008";2;"43.2";1828;46116;44288
771;"10.02.2008";3;"42.4";1780;45478;43698
771;"10.02.2008";4;"41.6";1927;45822;43895
771;"10.02.2008";5;"41.2";1875;45905;44030
771;"10.02.2008";6;"40.3";1726;44720;42994
771;"10.02.2008";7;"33.1";1660;42738;41078
771;"10.02.2008";8;"33.6";1579;43955;42376
771;"10.02.2008";9;"40.9";1455;46199;44744
771;"10.02.2008";10;"48.6";1305;48228;46923
771;"10.02.2008";11;"52.1";1026;50051;49025
771;"10.02.2008";12;"57.1";738;52196;51458
771;"10.02.2008";13;"53.8";588;50581;49993
771;"10.02.2008";14;"44.8";605;48047;47442
771;"10.02.2008";15;"41.9";633;46197;45564
771;"10.02.2008";16;39;692;45851;45159
771;"10.02.2008";17;"39.1";691;46761;46070
771;"10.02.2008";18;"50.5";866;51745;50879
771;"10.02.2008";19;"69.1";1118;57915;56797
771;"10.02.2008";20;"68.4";1296;57311;56015
771;"10.02.2008";21;65;1434;54739;53305
771;"10.02.2008";22;"56.1";1610;53669;52059
771;"10.02.2008";23;"62.1";1610;54655;53045
771;"10.02.2008";24;"52.6";1507;51158;49651
772;"11.02.2008";1;"43.4";1562;49163;47601
772;"11.02.2008";2;42;1534;48465;46931
772;"11.02.2008";3;"41.7";1479;48301;46822
772;"11.02.2008";4;"38.8";1429;48973;47544
772;"11.02.2008";5;"40.8";1419;50410;48991
772;"11.02.2008";6;45;1272;52301;51029
772;"11.02.2008";7;"53.2";1122;59645;58523
772;"11.02.2008";8;"82.1";1047;66586;65539
772;"11.02.2008";9;"80.1";1009;68122;67113
772;"11.02.2008";10;81;894;68032;67138
772;"11.02.2008";11;"81.8";673;68001;67328
772;"11.02.2008";12;90;454;68660;68206
772;"11.02.2008";13;83;487;67910;67423
772;"11.02.2008";14;81;426;67073;66647
772;"11.02.2008";15;"77.6";396;66109;65713
772;"11.02.2008";16;"72.1";421;65662;65241
772;"11.02.2008";17;"73.1";517;64935;64418
772;"11.02.2008";18;"79.9";631;68147;67516
772;"11.02.2008";19;100;928;72361;71433
772;"11.02.2008";20;85;1113;70883;69770
772;"11.02.2008";21;79;1148;66564;65416
772;"11.02.2008";22;"65.1";1123;63432;62309
772;"11.02.2008";23;62;1041;61264;60223
772;"11.02.2008";24;"52.1";929;57076;56147
773;"12.02.2008";1;"51.3";763;53136;52373
773;"12.02.2008";2;50;753;51934;51181
773;"12.02.2008";3;"48.1";712;51701;50989
773;"12.02.2008";4;"48.6";658;52366;51708
773;"12.02.2008";5;"43.1";623;53484;52861
773;"12.02.2008";6;"50.7";631;55022;54391
773;"12.02.2008";7;61;732;61763;61031
773;"12.02.2008";8;"85.7";726;67769;67043
773;"12.02.2008";9;"78.1";649;69105;68456
773;"12.02.2008";10;"79.3";542;68651;68109
773;"12.02.2008";11;"77.1";447;68820;68373
773;"12.02.2008";12;78;331;69456;69125
773;"12.02.2008";13;"74.1";310;68736;68426
773;"12.02.2008";14;"74.1";338;68412;68074
773;"12.02.2008";15;69;338;67336;66998
773;"12.02.2008";16;"64.7";396;66802;66406
773;"12.02.2008";17;"62.6";520;66220;65700
773;"12.02.2008";18;"74.9";635;68876;68241
773;"12.02.2008";19;"87.3";857;72647;71790
773;"12.02.2008";20;83;946;71062;70116
773;"12.02.2008";21;"82.1";934;66800;65866
773;"12.02.2008";22;"66.6";867;63600;62733
773;"12.02.2008";23;65;794;61515;60721
773;"12.02.2008";24;"57.4";786;57575;56789
774;"13.02.2008";1;"52.2";696;54258;53562
774;"13.02.2008";2;"48.1";596;52946;52350
774;"13.02.2008";3;"48.1";509;52336;51827
774;"13.02.2008";4;"44.1";463;52677;52214
774;"13.02.2008";5;"49.5";447;54084;53637
774;"13.02.2008";6;"51.9";457;56201;55744
774;"13.02.2008";7;"61.4";478;62455;61977
774;"13.02.2008";8;"78.6";432;68163;67731
774;"13.02.2008";9;"83.1";471;69645;69174
774;"13.02.2008";10;"84.9";483;69544;69061
774;"13.02.2008";11;"85.1";408;70027;69619
774;"13.02.2008";12;"83.1";379;70642;70263
774;"13.02.2008";13;"80.1";396;69800;69404
774;"13.02.2008";14;"75.1";500;68956;68456
774;"13.02.2008";15;"74.1";604;67720;67116
774;"13.02.2008";16;"70.9";695;66995;66300
774;"13.02.2008";17;"66.9";778;66322;65544
774;"13.02.2008";18;"78.5";814;69043;68229
774;"13.02.2008";19;"85.1";883;73399;72516
774;"13.02.2008";20;80;872;71770;70898
774;"13.02.2008";21;"75.1";841;67709;66868
774;"13.02.2008";22;"63.6";824;64614;63790
774;"13.02.2008";23;60;635;62632;61997
774;"13.02.2008";24;53;485;58962;58477
775;"14.02.2008";1;"51.7";451;55651;55200
775;"14.02.2008";2;"50.8";417;54296;53879
775;"14.02.2008";3;"49.6";387;53277;52890
775;"14.02.2008";4;"49.1";368;53570;53202
775;"14.02.2008";5;"48.1";375;54480;54105
775;"14.02.2008";6;"51.7";374;56150;55776
775;"14.02.2008";7;"65.1";373;62403;62030
775;"14.02.2008";8;"79.8";295;67917;67622
775;"14.02.2008";9;80;317;69663;69346
775;"14.02.2008";10;"80.3";290;69620;69330
775;"14.02.2008";11;"81.9";287;70114;69827
775;"14.02.2008";12;"83.2";313;70954;70641
775;"14.02.2008";13;"76.8";339;70647;70308
775;"14.02.2008";14;"73.8";403;70279;69876
775;"14.02.2008";15;"69.6";463;69637;69174
775;"14.02.2008";16;"60.1";520;69254;68734
775;"14.02.2008";17;58;598;68680;68082
775;"14.02.2008";18;"69.9";734;70689;69955
775;"14.02.2008";19;"85.1";1035;73135;72100
775;"14.02.2008";20;"80.4";1175;71369;70194
775;"14.02.2008";21;"75.1";1377;67374;65997
775;"14.02.2008";22;67;1649;65060;63411
775;"14.02.2008";23;"60.2";1885;63087;61202
775;"14.02.2008";24;"51.8";2038;58869;56831
776;"15.02.2008";1;"54.9";2264;56450;54186
776;"15.02.2008";2;"52.5";2497;54969;52472
776;"15.02.2008";3;"50.1";2735;54170;51435
776;"15.02.2008";4;"46.7";2792;54023;51231
776;"15.02.2008";5;46;2852;55062;52210
776;"15.02.2008";6;"52.7";2756;57347;54591
776;"15.02.2008";7;"59.9";2656;62846;60190
776;"15.02.2008";8;"79.1";2620;67909;65289
776;"15.02.2008";9;"82.5";2418;69738;67320
776;"15.02.2008";10;"86.3";1930;69680;67750
776;"15.02.2008";11;"83.9";1875;69888;68013
776;"15.02.2008";12;"82.1";2306;70150;67844
776;"15.02.2008";13;"74.5";2938;69687;66749
776;"15.02.2008";14;"73.1";3107;68209;65102
776;"15.02.2008";15;"68.9";3287;66608;63321
776;"15.02.2008";16;"65.1";3581;65860;62279
776;"15.02.2008";17;"63.9";3264;65213;61949
776;"15.02.2008";18;"68.9";2684;67534;64850
776;"15.02.2008";19;"79.9";2724;72066;69342
776;"15.02.2008";20;"76.1";2901;70048;67147
776;"15.02.2008";21;"68.9";3072;65926;62854
776;"15.02.2008";22;"58.3";2977;63073;60096
776;"15.02.2008";23;"59.1";2877;62487;59610
776;"15.02.2008";24;"52.3";2590;59378;56788
777;"16.02.2008";1;"57.3";2407;56733;54326
777;"16.02.2008";2;"52.1";2131;54964;52833
777;"16.02.2008";3;"52.5";1990;54320;52330
777;"16.02.2008";4;"50.5";1854;53608;51754
777;"16.02.2008";5;"49.8";1786;53125;51339
777;"16.02.2008";6;"48.9";1790;52014;50224
777;"16.02.2008";7;"39.1";1686;50367;48681
777;"16.02.2008";8;"49.2";1493;52092;50599
777;"16.02.2008";9;"51.2";1223;55159;53936
777;"16.02.2008";10;"56.4";782;57458;56676
777;"16.02.2008";11;"62.1";644;58535;57891
777;"16.02.2008";12;66;647;58916;58269
777;"16.02.2008";13;"67.6";664;57600;56936
777;"16.02.2008";14;"58.2";645;55347;54702
777;"16.02.2008";15;51;571;53657;53086
777;"16.02.2008";16;48;511;53415;52904
777;"16.02.2008";17;"48.8";511;53938;53427
777;"16.02.2008";18;"61.9";516;57394;56878
777;"16.02.2008";19;"75.9";691;62556;61865
777;"16.02.2008";20;69;905;60460;59555
777;"16.02.2008";21;"59.3";1285;56748;55463
777;"16.02.2008";22;52;1678;55042;53364
777;"16.02.2008";23;"54.1";2244;55658;53414
777;"16.02.2008";24;43;2642;53020;50378
778;"17.02.2008";1;"50.8";2912;51368;48456
778;"17.02.2008";2;"48.3";3161;49354;46193
778;"17.02.2008";3;"47.7";3565;48882;45317
778;"17.02.2008";4;"46.2";3775;48808;45033
778;"17.02.2008";5;"44.3";3795;47999;44204
778;"17.02.2008";6;"43.1";4076;46873;42797
778;"17.02.2008";7;"33.2";4469;44678;40209
778;"17.02.2008";8;"37.7";4664;45296;40632
778;"17.02.2008";9;"41.9";4959;47534;42575
778;"17.02.2008";10;"48.8";4682;49078;44396
778;"17.02.2008";11;"55.1";4220;50543;46323
778;"17.02.2008";12;"63.5";4150;52560;48410
778;"17.02.2008";13;"56.3";4578;51527;46949
778;"17.02.2008";14;"46.1";5149;49795;44646
778;"17.02.2008";15;"40.4";5558;48603;43045
778;"17.02.2008";16;"39.3";5849;48042;42193
778;"17.02.2008";17;"39.7";6005;48522;42517
778;"17.02.2008";18;"50.1";6672;52038;45366
778;"17.02.2008";19;"68.8";7497;59217;51720
778;"17.02.2008";20;65;8623;59498;50875
778;"17.02.2008";21;"55.1";8823;57402;48579
778;"17.02.2008";22;"53.1";8604;56440;47836
778;"17.02.2008";23;57;8298;57744;49446
778;"17.02.2008";24;"48.9";8161;55104;46943
779;"18.02.2008";1;44;8068;53906;45838
779;"18.02.2008";2;"42.6";8043;52506;44463
779;"18.02.2008";3;"41.8";7948;51673;43725
779;"18.02.2008";4;"41.9";8255;52239;43984
779;"18.02.2008";5;"43.5";8511;53658;45147
779;"18.02.2008";6;"51.4";8718;55559;46841
779;"18.02.2008";7;57;8431;62772;54341
779;"18.02.2008";8;"80.3";8344;68045;59701
779;"18.02.2008";9;76;8212;69727;61515
779;"18.02.2008";10;"77.7";7799;69817;62018
779;"18.02.2008";11;"79.1";7395;70367;62972
779;"18.02.2008";12;"82.3";7209;71203;63994
779;"18.02.2008";13;"80.5";7262;70769;63507
779;"18.02.2008";14;80;7255;70347;63092
779;"18.02.2008";15;"77.1";6939;69954;63015
779;"18.02.2008";16;"73.7";6545;69257;62712
779;"18.02.2008";17;"70.6";6441;68130;61689
779;"18.02.2008";18;"80.1";6121;69989;63868
779;"18.02.2008";19;"89.5";5886;74046;68160
779;"18.02.2008";20;"82.6";5672;72964;67292
779;"18.02.2008";21;"74.1";5695;69072;63377
779;"18.02.2008";22;65;5517;66445;60928
779;"18.02.2008";23;59;5408;64375;58967
779;"18.02.2008";24;"53.8";5164;60244;55080
780;"19.02.2008";1;"53.8";5129;57708;52579
780;"19.02.2008";2;"53.2";5101;56377;51276
780;"19.02.2008";3;"52.1";4709;55311;50602
780;"19.02.2008";4;"52.4";4153;55382;51229
780;"19.02.2008";5;53;3862;56415;52553
780;"19.02.2008";6;60;3446;57720;54274
780;"19.02.2008";7;"81.9";2968;63360;60392
780;"19.02.2008";8;"119.9";2646;68041;65395
780;"19.02.2008";9;92;2231;69616;67385
780;"19.02.2008";10;"93.8";1954;69518;67564
780;"19.02.2008";11;94;1797;70049;68252
780;"19.02.2008";12;"94.4";1611;70792;69181
780;"19.02.2008";13;88;1573;69830;68257
780;"19.02.2008";14;85;1402;68927;67525
780;"19.02.2008";15;"79.2";1215;68091;66876
780;"19.02.2008";16;"76.1";1079;67247;66168
780;"19.02.2008";17;"75.9";956;66265;65309
780;"19.02.2008";18;"78.2";839;67969;67130
780;"19.02.2008";19;"112.4";845;72674;71829
780;"19.02.2008";20;107;929;71609;70680
780;"19.02.2008";21;88;943;67814;66871
780;"19.02.2008";22;74;1082;64713;63631
780;"19.02.2008";23;74;1114;62595;61481
780;"19.02.2008";24;65;1161;58585;57424
781;"20.02.2008";1;"56.1";1195;55895;54700
781;"20.02.2008";2;"52.1";1269;54413;53144
781;"20.02.2008";3;"51.3";1203;53746;52543
781;"20.02.2008";4;50;1239;54033;52794
781;"20.02.2008";5;"49.8";1197;55102;53905
781;"20.02.2008";6;52;1216;56799;55583
781;"20.02.2008";7;"63.7";1193;62902;61709
781;"20.02.2008";8;"82.2";1374;67700;66326
781;"20.02.2008";9;82;1459;69414;67955
781;"20.02.2008";10;"86.4";1459;69486;68027
781;"20.02.2008";11;"88.8";1034;69965;68931
781;"20.02.2008";12;97;804;70694;69890
781;"20.02.2008";13;95;728;70034;69306
781;"20.02.2008";14;"88.5";765;69659;68894
781;"20.02.2008";15;"84.9";843;69178;68335
781;"20.02.2008";16;"81.6";1063;68564;67501
781;"20.02.2008";17;"79.1";1290;67853;66563
781;"20.02.2008";18;"84.9";1617;70025;68408
781;"20.02.2008";19;"149.9";2129;73229;71100
781;"20.02.2008";20;"94.1";2535;71503;68968
781;"20.02.2008";21;"80.3";2651;67478;64827
781;"20.02.2008";22;"69.1";2794;64508;61714
781;"20.02.2008";23;62;2846;62527;59681
781;"20.02.2008";24;"51.7";2853;58078;55225
782;"21.02.2008";1;"53.9";3093;54713;51620
782;"21.02.2008";2;"53.1";3449;53239;49790
782;"21.02.2008";3;"51.9";3609;52357;48748
782;"21.02.2008";4;46;3792;52722;48930
782;"21.02.2008";5;"45.2";4110;54026;49916
782;"21.02.2008";6;"53.9";4814;56380;51566
782;"21.02.2008";7;"58.6";5129;62855;57726
782;"21.02.2008";8;"79.2";5359;67775;62416
782;"21.02.2008";9;"79.9";5754;69858;64104
782;"21.02.2008";10;"79.1";6075;70057;63982
782;"21.02.2008";11;"78.9";6596;70826;64230
782;"21.02.2008";12;"76.8";7318;71462;64144
782;"21.02.2008";13;"74.1";8398;71036;62638
782;"21.02.2008";14;"75.8";9326;71159;61833
782;"21.02.2008";15;"72.1";9841;70566;60725
782;"21.02.2008";16;"62.1";10306;69832;59526
782;"21.02.2008";17;"62.8";10779;68893;58114
782;"21.02.2008";18;"58.3";11490;70938;59448
782;"21.02.2008";19;76;12471;74725;62254
782;"21.02.2008";20;"75.9";13284;73144;59860
782;"21.02.2008";21;"67.9";14294;69255;54961
782;"21.02.2008";22;"53.9";14938;66711;51773
782;"21.02.2008";23;"52.9";15552;64945;49393
782;"21.02.2008";24;"45.5";15831;61090;45259
783;"22.02.2008";1;"40.7";15953;58083;42130
783;"22.02.2008";2;"31.5";15937;56489;40552
783;"22.02.2008";3;"28.3";15924;55670;39746
783;"22.02.2008";4;"31.9";16007;56034;40027
783;"22.02.2008";5;32;15969;56715;40746
783;"22.02.2008";6;"37.3";15987;58434;42447
783;"22.02.2008";7;"54.2";15941;64602;48661
783;"22.02.2008";8;"69.5";15810;70089;54279
783;"22.02.2008";9;"64.9";15531;72112;56581
783;"22.02.2008";10;"66.2";15597;72502;56905
783;"22.02.2008";11;"70.5";15768;73357;57589
783;"22.02.2008";12;"70.6";16389;74223;57834
783;"22.02.2008";13;"66.5";16430;72866;56436
783;"22.02.2008";14;"58.1";16817;71540;54723
783;"22.02.2008";15;"53.1";17155;70437;53282
783;"22.02.2008";16;"51.6";17440;70243;52803
783;"22.02.2008";17;"51.6";18145;70227;52082
783;"22.02.2008";18;"58.1";18149;72023;53874
783;"22.02.2008";19;"72.8";18466;75364;56898
783;"22.02.2008";20;"70.5";18694;73626;54932
783;"22.02.2008";21;69;18562;69346;50784
783;"22.02.2008";22;53;18138;66579;48441
783;"22.02.2008";23;"51.1";17591;64771;47180
783;"22.02.2008";24;"39.6";17237;60888;43651
784;"23.02.2008";1;"47.6";17132;58162;41030
784;"23.02.2008";2;"40.8";16737;55552;38815
784;"23.02.2008";3;"41.2";16083;54605;38522
784;"23.02.2008";4;"40.5";15235;54610;39375
784;"23.02.2008";5;"37.9";14512;54721;40209
784;"23.02.2008";6;"39.2";13173;53598;40425
784;"23.02.2008";7;"35.3";11862;52664;40802
784;"23.02.2008";8;"45.8";10952;53959;43007
784;"23.02.2008";9;"51.6";10196;57329;47133
784;"23.02.2008";10;"62.2";10049;60175;50126
784;"23.02.2008";11;64;9837;61829;51992
784;"23.02.2008";12;"65.8";9649;61964;52315
784;"23.02.2008";13;"65.9";10097;60753;50656
784;"23.02.2008";14;"61.9";10548;58558;48010
784;"23.02.2008";15;"55.1";10534;56617;46083
784;"23.02.2008";16;"51.5";9706;55550;45844
784;"23.02.2008";17;"48.1";8445;54468;46023
784;"23.02.2008";18;"55.9";7445;56579;49134
784;"23.02.2008";19;"68.2";7694;62390;54696
784;"23.02.2008";20;"70.1";8461;61829;53368
784;"23.02.2008";21;64;8972;58053;49081
784;"23.02.2008";22;"57.1";9535;56499;46964
784;"23.02.2008";23;"57.8";9483;56210;46727
784;"23.02.2008";24;45;9455;53011;43556
785;"24.02.2008";1;"43.5";9005;49568;40563
785;"24.02.2008";2;"36.6";8093;47180;39087
785;"24.02.2008";3;"36.5";7414;46421;39007
785;"24.02.2008";4;"35.8";7061;46329;39268
785;"24.02.2008";5;"36.7";6856;46854;39998
785;"24.02.2008";6;"36.9";6760;46186;39426
785;"24.02.2008";7;"27.1";6735;44365;37630
785;"24.02.2008";8;"34.3";6817;44976;38159
785;"24.02.2008";9;"42.8";6169;47250;41081
785;"24.02.2008";10;"50.6";5850;49110;43260
785;"24.02.2008";11;"59.1";6034;51157;45123
785;"24.02.2008";12;"65.9";6306;52880;46574
785;"24.02.2008";13;"60.1";6275;51734;45459
785;"24.02.2008";14;51;6236;49396;43160
785;"24.02.2008";15;"43.1";5899;47525;41626
785;"24.02.2008";16;"33.5";5378;46588;41210
785;"24.02.2008";17;"33.7";4597;46654;42057
785;"24.02.2008";18;"47.1";4342;49999;45657
785;"24.02.2008";19;70;4371;57342;52971
785;"24.02.2008";20;"70.5";4339;57627;53288
785;"24.02.2008";21;65;4428;55008;50580
785;"24.02.2008";22;"58.8";4423;53929;49506
785;"24.02.2008";23;"60.1";4469;54322;49853
785;"24.02.2008";24;"51.7";4610;50625;46015
786;"25.02.2008";1;"41.1";4716;48115;43399
786;"25.02.2008";2;"36.8";4930;46581;41651
786;"25.02.2008";3;"36.2";5464;46198;40734
786;"25.02.2008";4;"39.3";6379;47968;41589
786;"25.02.2008";5;"40.8";6488;49688;43200
786;"25.02.2008";6;"45.3";6684;52690;46006
786;"25.02.2008";7;"58.6";7415;60685;53270
786;"25.02.2008";8;"74.6";8060;67078;59018
786;"25.02.2008";9;"75.4";8113;69947;61834
786;"25.02.2008";10;"77.1";8262;70625;62363
786;"25.02.2008";11;77;7551;71324;63773
786;"25.02.2008";12;"79.8";6851;71759;64908
786;"25.02.2008";13;79;5638;70568;64930
786;"25.02.2008";14;77;4961;69880;64919
786;"25.02.2008";15;"75.3";4920;68515;63595
786;"25.02.2008";16;"73.9";4724;67371;62647
786;"25.02.2008";17;"68.1";3851;65593;61742
786;"25.02.2008";18;"73.8";2615;66616;64001
786;"25.02.2008";19;90;2195;71605;69410
786;"25.02.2008";20;"80.1";2432;71106;68674
786;"25.02.2008";21;"73.5";2850;66678;63828
786;"25.02.2008";22;"60.3";3707;63612;59905
786;"25.02.2008";23;"55.1";4617;61141;56524
786;"25.02.2008";24;48;5606;56632;51026
787;"26.02.2008";1;"48.3";6553;53473;46920
787;"26.02.2008";2;"42.1";7364;52088;44724
787;"26.02.2008";3;"35.6";7429;50855;43426
787;"26.02.2008";4;"24.4";8276;52286;44010
787;"26.02.2008";5;"24.2";8722;53061;44339
787;"26.02.2008";6;"39.9";9711;55124;45413
787;"26.02.2008";7;"53.7";10708;62469;51761
787;"26.02.2008";8;"66.5";12041;67699;55658
787;"26.02.2008";9;61;12947;69469;56522
787;"26.02.2008";10;"62.1";13460;69645;56185
787;"26.02.2008";11;63;14786;70671;55885
787;"26.02.2008";12;"62.1";15630;72064;56434
787;"26.02.2008";13;68;16222;71639;55417
787;"26.02.2008";14;67;16430;71467;55037
787;"26.02.2008";15;"59.9";16010;70829;54819
787;"26.02.2008";16;"56.2";15795;70592;54797
787;"26.02.2008";17;"55.8";15422;69914;54492
787;"26.02.2008";18;"58.6";14401;71135;56734
787;"26.02.2008";19;"70.6";13639;74011;60372
787;"26.02.2008";20;"73.9";13282;72689;59407
787;"26.02.2008";21;"68.9";13132;68630;55498
787;"26.02.2008";22;"55.6";12876;65925;53049
787;"26.02.2008";23;"54.4";12305;63057;50752
787;"26.02.2008";24;"40.7";11662;58105;46443
788;"27.02.2008";1;"31.3";11639;53878;42239
788;"27.02.2008";2;"25.3";12289;52200;39911
788;"27.02.2008";3;"27.4";12860;52714;39854
788;"27.02.2008";4;"25.7";13166;53573;40407
788;"27.02.2008";5;"26.2";13885;55329;41444
788;"27.02.2008";6;"37.3";14271;57703;43432
788;"27.02.2008";7;54;14615;64420;49805
788;"27.02.2008";8;"66.2";14393;69141;54748
788;"27.02.2008";9;"66.2";14484;71275;56791
788;"27.02.2008";10;"63.2";14774;71616;56842
788;"27.02.2008";11;"66.3";15234;72621;57387
788;"27.02.2008";12;"68.6";15253;73814;58561
788;"27.02.2008";13;64;15571;73168;57597
788;"27.02.2008";14;"64.8";15646;72877;57231
788;"27.02.2008";15;"59.4";15421;71740;56319
788;"27.02.2008";16;"55.1";14849;70675;55826
788;"27.02.2008";17;"55.6";14172;69232;55060
788;"27.02.2008";18;"61.6";12634;69613;56979
788;"27.02.2008";19;"75.9";11027;73346;62319
788;"27.02.2008";20;"75.6";10182;72684;62502
788;"27.02.2008";21;"65.1";9891;68692;58801
788;"27.02.2008";22;"55.6";9725;65673;55948
788;"27.02.2008";23;"54.3";9293;63773;54480
788;"27.02.2008";24;"43.2";9069;60166;51097
789;"28.02.2008";1;"44.7";8740;56033;47293
789;"28.02.2008";2;"41.3";8174;54711;46537
789;"28.02.2008";3;"39.4";7743;54010;46267
789;"28.02.2008";4;"41.9";7347;54212;46865
789;"28.02.2008";5;44;6600;54944;48344
789;"28.02.2008";6;"53.2";6096;56006;49910
789;"28.02.2008";7;"60.1";5571;61683;56112
789;"28.02.2008";8;76;4939;65877;60938
789;"28.02.2008";9;"77.5";4188;67335;63147
789;"28.02.2008";10;"77.5";3228;67164;63936
789;"28.02.2008";11;"76.3";2736;67552;64816
789;"28.02.2008";12;"79.9";2990;68309;65319
789;"28.02.2008";13;79;3528;67887;64359
789;"28.02.2008";14;79;3922;67650;63728
789;"28.02.2008";15;"77.7";3800;66682;62882
789;"28.02.2008";16;74;3430;66010;62580
789;"28.02.2008";17;72;2589;65165;62576
789;"28.02.2008";18;"73.9";1809;66457;64648
789;"28.02.2008";19;"90.4";1750;71181;69431
789;"28.02.2008";20;"86.6";2029;70689;68660
789;"28.02.2008";21;"79.5";2351;66362;64011
789;"28.02.2008";22;68;2602;63295;60693
789;"28.02.2008";23;"65.1";2810;60823;58013
789;"28.02.2008";24;"52.2";2792;56159;53367
790;"29.02.2008";1;"51.9";2745;53016;50271
790;"29.02.2008";2;47;2663;51184;48521
790;"29.02.2008";3;"44.2";2498;50156;47658
790;"29.02.2008";4;"40.5";2307;50370;48063
790;"29.02.2008";5;"43.6";1947;51908;49961
790;"29.02.2008";6;"50.1";1787;54205;52418
790;"29.02.2008";7;"64.6";1684;60734;59050
790;"29.02.2008";8;80;1802;65654;63852
790;"29.02.2008";9;"83.9";1777;68373;66596
790;"29.02.2008";10;"84.8";1482;68783;67301
790;"29.02.2008";11;85;1247;69588;68341
790;"29.02.2008";12;"86.2";1693;70320;68627
790;"29.02.2008";13;"81.4";2732;69202;66470
790;"29.02.2008";14;75;3952;67874;63922
790;"29.02.2008";15;"71.4";4751;66526;61775
790;"29.02.2008";16;"62.1";5180;65735;60555
790;"29.02.2008";17;"57.8";5817;64895;59078
790;"29.02.2008";18;"57.6";6796;66471;59675
790;"29.02.2008";19;"66.1";8538;69972;61434
790;"29.02.2008";20;65;10227;68675;58448
790;"29.02.2008";21;"55.7";12585;64903;52318
790;"29.02.2008";22;46;13939;62621;48682
790;"29.02.2008";23;44;14670;61046;46376
790;"29.02.2008";24;"26.6";16187;58176;41989
791;"01.03.2008";1;"42.9";17352;54630;37278
791;"01.03.2008";2;"36.1";18173;53870;35697
791;"01.03.2008";3;"26.9";18295;53275;34980
791;"01.03.2008";4;"16.1";18072;53391;35319
791;"01.03.2008";5;12;17474;53751;36277
791;"01.03.2008";6;"6.8";16464;52726;36262
791;"01.03.2008";7;"3.7";16720;51662;34942
791;"01.03.2008";8;"18.5";16374;53738;37364
791;"01.03.2008";9;"45.8";17429;57926;40497
791;"01.03.2008";10;"59.3";18277;61109;42832
791;"01.03.2008";11;"60.3";18760;62978;44218
791;"01.03.2008";12;"60.9";18685;63804;45119
791;"01.03.2008";13;62;18546;62371;43825
791;"01.03.2008";14;"54.1";18002;60281;42279
791;"01.03.2008";15;45;17459;58261;40802
791;"01.03.2008";16;"29.6";17019;57382;40363
791;"01.03.2008";17;24;17078;57001;39923
791;"01.03.2008";18;"26.4";16847;58265;41418
791;"01.03.2008";19;"59.9";16980;62787;45807
791;"01.03.2008";20;"62.5";17251;62719;45468
791;"01.03.2008";21;"45.9";17157;59143;41986
791;"01.03.2008";22;27;17229;57129;39900
791;"01.03.2008";23;"40.1";17002;57498;40496
791;"01.03.2008";24;"26.2";16467;53941;37474
792;"02.03.2008";1;"3.8";16184;50895;34711
792;"02.03.2008";2;0;16206;48269;32063
792;"02.03.2008";3;0;16071;47643;31572
792;"02.03.2008";4;0;15374;47170;31796
792;"02.03.2008";5;0;15255;47495;32240
792;"02.03.2008";6;0;14744;46380;31636
792;"02.03.2008";7;0;15209;45017;29808
792;"02.03.2008";8;0;15382;46199;30817
792;"02.03.2008";9;"2.1";15348;49108;33760
792;"02.03.2008";10;21;15833;51933;36100
792;"02.03.2008";11;"29.4";16795;54974;38179
792;"02.03.2008";12;"40.4";17670;58132;40462
792;"02.03.2008";13;35;17966;57704;39738
792;"02.03.2008";14;"29.4";18240;56139;37899
792;"02.03.2008";15;"12.4";18293;54038;35745
792;"02.03.2008";16;"13.2";17829;53228;35399
792;"02.03.2008";17;"25.4";16951;52895;35944
792;"02.03.2008";18;"36.9";16188;55242;39054
792;"02.03.2008";19;"63.1";14726;60045;45319
792;"02.03.2008";20;65;13547;60463;46916
792;"02.03.2008";21;"52.7";12788;57974;45186
792;"02.03.2008";22;46;11781;56588;44807
792;"02.03.2008";23;"53.8";10733;56849;46116
792;"02.03.2008";24;"37.3";10012;52781;42769
793;"03.03.2008";1;"15.7";9387;49623;40236
793;"03.03.2008";2;"19.2";8451;48035;39584
793;"03.03.2008";3;"20.1";7504;46931;39427
793;"03.03.2008";4;"25.1";7180;47242;40062
793;"03.03.2008";5;27;7012;48381;41369
793;"03.03.2008";6;"34.2";6483;51030;44547
793;"03.03.2008";7;49;6631;58816;52185
793;"03.03.2008";8;"70.5";6913;64986;58073
793;"03.03.2008";9;"76.5";7429;67695;60266
793;"03.03.2008";10;"74.1";8466;68352;59886
793;"03.03.2008";11;"74.1";9967;69892;59925
793;"03.03.2008";12;"75.1";11113;71094;59981
793;"03.03.2008";13;"70.6";12131;71227;59096
793;"03.03.2008";14;"70.5";12412;70748;58336
793;"03.03.2008";15;"62.7";12897;70042;57145
793;"03.03.2008";16;"58.2";13399;69749;56350
793;"03.03.2008";17;"54.8";13160;68275;55115
793;"03.03.2008";18;"56.9";12375;68569;56194
793;"03.03.2008";19;"70.5";11590;71984;60394
793;"03.03.2008";20;"70.5";10551;72177;61626
793;"03.03.2008";21;60;10574;68006;57432
793;"03.03.2008";22;"50.2";10854;65554;54700
793;"03.03.2008";23;"44.6";10595;63950;53355
793;"03.03.2008";24;"28.6";10633;59828;49195
794;"04.03.2008";1;"40.1";10166;57293;47127
794;"04.03.2008";2;39;9669;56320;46651
794;"04.03.2008";3;36;8651;54794;46143
794;"04.03.2008";4;"34.1";7737;54686;46949
794;"04.03.2008";5;"34.4";6965;55694;48729
794;"04.03.2008";6;"52.2";6349;57389;51040
794;"04.03.2008";7;"58.4";5698;62740;57042
794;"04.03.2008";8;70;5062;66230;61168
794;"04.03.2008";9;74;4711;67915;63204
794;"04.03.2008";10;"76.1";5053;68421;63368
794;"04.03.2008";11;"76.1";5087;68536;63449
794;"04.03.2008";12;"77.1";5612;70054;64442
794;"04.03.2008";13;"79.4";6449;69600;63151
794;"04.03.2008";14;77;7072;69277;62205
794;"04.03.2008";15;"74.1";7775;68758;60983
794;"04.03.2008";16;"68.5";7664;68315;60651
794;"04.03.2008";17;"61.7";7223;67097;59874
794;"04.03.2008";18;64;6949;67748;60799
794;"04.03.2008";19;77;5606;71338;65732
794;"04.03.2008";20;79;5677;71687;66010
794;"04.03.2008";21;"72.2";5814;67457;61643
794;"04.03.2008";22;"57.2";6276;64303;58027
794;"04.03.2008";23;"52.1";7146;62708;55562
794;"04.03.2008";24;44;7269;58496;51227
795;"05.03.2008";1;"51.1";7130;55945;48815
795;"05.03.2008";2;"45.8";7239;54112;46873
795;"05.03.2008";3;"41.2";7020;53211;46191
795;"05.03.2008";4;"41.5";6619;53421;46802
795;"05.03.2008";5;"42.2";6090;54335;48245
795;"05.03.2008";6;"52.4";5906;56332;50426
795;"05.03.2008";7;"58.1";5121;61830;56709
795;"05.03.2008";8;"76.9";4871;65803;60932
795;"05.03.2008";9;"77.1";4300;67284;62984
795;"05.03.2008";10;"79.2";4271;67449;63178
795;"05.03.2008";11;82;4443;68044;63601
795;"05.03.2008";12;87;4680;68993;64313
795;"05.03.2008";13;"77.1";4395;68354;63959
795;"05.03.2008";14;"78.5";4422;67694;63272
795;"05.03.2008";15;"74.5";4402;66703;62301
795;"05.03.2008";16;"69.5";4513;66346;61833
795;"05.03.2008";17;"63.9";4456;66492;62036
795;"05.03.2008";18;"65.1";3932;65567;61635
795;"05.03.2008";19;"78.1";4151;70150;65999
795;"05.03.2008";20;77;5293;71310;66017
795;"05.03.2008";21;"76.5";6685;67544;60859
795;"05.03.2008";22;"60.5";8552;65226;56674
795;"05.03.2008";23;"54.9";9849;64271;54422
795;"05.03.2008";24;"43.4";11161;60749;49588
796;"06.03.2008";1;"43.3";11887;58010;46123
796;"06.03.2008";2;"34.2";12619;56887;44268
796;"06.03.2008";3;"29.5";12743;55982;43239
796;"06.03.2008";4;"28.5";12678;55917;43239
796;"06.03.2008";5;"33.8";13087;56990;43903
796;"06.03.2008";6;"39.5";13240;58319;45079
796;"06.03.2008";7;"48.7";13456;64215;50759
796;"06.03.2008";8;69;13511;68165;54654
796;"06.03.2008";9;"59.1";13112;69457;56345
796;"06.03.2008";10;62;12555;69731;57176
796;"06.03.2008";11;64;12319;70289;57970
796;"06.03.2008";12;"66.9";12444;71911;59467
796;"06.03.2008";13;70;12481;71469;58988
796;"06.03.2008";14;"70.6";12450;70916;58466
796;"06.03.2008";15;"66.1";11796;70055;58259
796;"06.03.2008";16;"64.1";10628;69448;58820
796;"06.03.2008";17;"57.3";10074;68105;58031
796;"06.03.2008";18;69;9359;68707;59348
796;"06.03.2008";19;"87.5";8599;72451;63852
796;"06.03.2008";20;"90.1";8271;72347;64076
796;"06.03.2008";21;"70.9";7983;68341;60358
796;"06.03.2008";22;"58.8";7331;65149;57818
796;"06.03.2008";23;"58.8";6639;62881;56242
796;"06.03.2008";24;"48.5";6240;58220;51980
797;"07.03.2008";1;"51.8";5300;54660;49360
797;"07.03.2008";2;"41.3";4620;52546;47926
797;"07.03.2008";3;"49.2";4228;51909;47681
797;"07.03.2008";4;"49.4";3669;52107;48438
797;"07.03.2008";5;"49.9";3324;53003;49679
797;"07.03.2008";6;54;3237;54573;51336
797;"07.03.2008";7;"63.9";3240;60711;57471
797;"07.03.2008";8;"77.9";3081;65216;62135
797;"07.03.2008";9;80;2859;67465;64606
797;"07.03.2008";10;"83.9";2465;67757;65292
797;"07.03.2008";11;"80.1";1966;68333;66367
797;"07.03.2008";12;"78.5";1791;68996;67205
797;"07.03.2008";13;77;1752;68232;66480
797;"07.03.2008";14;"71.7";1799;66928;65129
797;"07.03.2008";15;"58.5";1931;65495;63564
797;"07.03.2008";16;57;1933;65122;63189
797;"07.03.2008";17;"58.4";1944;64433;62489
797;"07.03.2008";18;"65.2";2063;65577;63514
797;"07.03.2008";19;"79.9";2274;68351;66077
797;"07.03.2008";20;"86.9";2524;68226;65702
797;"07.03.2008";21;"78.9";2623;64087;61464
797;"07.03.2008";22;"64.7";2296;61493;59197
797;"07.03.2008";23;"64.4";2044;59937;57893
797;"07.03.2008";24;"55.4";1787;55729;53942
798;"08.03.2008";1;"57.9";1707;52342;50635
798;"08.03.2008";2;52;1742;49951;48209
798;"08.03.2008";3;"51.4";1720;48805;47085
798;"08.03.2008";4;"51.4";1685;49136;47451
798;"08.03.2008";5;"51.5";1699;49645;47946
798;"08.03.2008";6;"51.2";1687;49092;47405
798;"08.03.2008";7;"44.5";1726;48623;46897
798;"08.03.2008";8;"53.1";1798;50686;48888
798;"08.03.2008";9;"60.8";1733;54363;52630
798;"08.03.2008";10;75;1560;57220;55660
798;"08.03.2008";11;"77.1";1754;58325;56571
798;"08.03.2008";12;76;2211;58807;56596
798;"08.03.2008";13;"74.7";3206;57391;54185
798;"08.03.2008";14;"61.5";3975;55299;51324
798;"08.03.2008";15;"55.1";4104;53633;49529
798;"08.03.2008";16;"53.9";3846;53156;49310
798;"08.03.2008";17;"53.2";3328;53021;49693
798;"08.03.2008";18;"56.6";2845;54553;51708
798;"08.03.2008";19;"74.9";3049;59021;55972
798;"08.03.2008";20;"74.5";4025;59523;55498
798;"08.03.2008";21;"58.7";5000;55627;50627
798;"08.03.2008";22;50;5602;53716;48114
798;"08.03.2008";23;"53.7";6579;54073;47494
798;"08.03.2008";24;"40.1";6981;51057;44076
799;"09.03.2008";1;"49.1";6877;48579;41702
799;"09.03.2008";2;"37.2";7087;46437;39350
799;"09.03.2008";3;34;6934;45118;38184
799;"09.03.2008";4;"31.1";6790;45123;38333
799;"09.03.2008";5;"34.3";6965;46306;39341
799;"09.03.2008";6;"33.5";7091;45591;38500
799;"09.03.2008";7;"1.6";7328;43579;36251
799;"09.03.2008";8;"2.3";7251;43943;36692
799;"09.03.2008";9;"32.1";6879;46621;39742
799;"09.03.2008";10;"40.5";7103;48402;41299
799;"09.03.2008";11;"53.9";7636;50418;42782
799;"09.03.2008";12;"57.8";7962;52875;44913
799;"09.03.2008";13;"54.9";7783;51986;44203
799;"09.03.2008";14;"44.1";7331;49749;42418
799;"09.03.2008";15;"38.4";6796;48137;41341
799;"09.03.2008";16;35;6457;47304;40847
799;"09.03.2008";17;"35.2";5819;47155;41336
799;"09.03.2008";18;"46.1";5242;49425;44183
799;"09.03.2008";19;"64.2";5382;55167;49785
799;"09.03.2008";20;71;5878;57182;51304
799;"09.03.2008";21;"67.9";6744;54743;47999
799;"09.03.2008";22;"56.8";7173;53933;46760
799;"09.03.2008";23;"58.9";7250;54526;47276
799;"09.03.2008";24;"49.3";6695;50840;44145
800;"10.03.2008";1;"43.9";6631;48250;41619
800;"10.03.2008";2;36;6738;47890;41152
800;"10.03.2008";3;"34.8";6615;47417;40802
800;"10.03.2008";4;"34.5";6239;47878;41639
800;"10.03.2008";5;"37.3";6203;49672;43469
800;"10.03.2008";6;"45.7";6191;51970;45779
800;"10.03.2008";7;57;6059;58528;52469
800;"10.03.2008";8;"72.8";6038;63316;57278
800;"10.03.2008";9;"76.2";6152;65645;59493
800;"10.03.2008";10;"74.7";7388;65637;58249
800;"10.03.2008";11;"72.9";9519;66583;57064
800;"10.03.2008";12;"72.2";11056;68147;57091
800;"10.03.2008";13;"70.7";12402;67965;55563
800;"10.03.2008";14;"69.4";13452;68231;54779
800;"10.03.2008";15;"63.6";14299;68191;53892
800;"10.03.2008";16;"59.5";14715;68383;53668
800;"10.03.2008";17;"57.2";14142;67063;52921
800;"10.03.2008";18;"57.4";12600;67283;54683
800;"10.03.2008";19;"71.9";12778;70519;57741
800;"10.03.2008";20;"71.4";12898;71142;58244
800;"10.03.2008";21;"65.1";13378;66968;53590
800;"10.03.2008";22;"57.9";12939;63907;50968
800;"10.03.2008";23;"56.4";12450;61563;49113
800;"10.03.2008";24;"48.4";11855;57450;45595
801;"11.03.2008";1;"38.6";11215;53498;42283
801;"11.03.2008";2;"28.6";10884;50799;39915
801;"11.03.2008";3;"29.4";10990;50628;39638
801;"11.03.2008";4;"30.2";11141;51696;40555
801;"11.03.2008";5;"31.9";11056;53272;42216
801;"11.03.2008";6;"53.9";11597;56395;44798
801;"11.03.2008";7;"58.5";12426;61991;49565
801;"11.03.2008";8;"73.7";12409;65784;53375
801;"11.03.2008";9;"71.8";12842;68260;55418
801;"11.03.2008";10;"71.8";13555;69095;55540
801;"11.03.2008";11;"72.2";14150;70600;56450
801;"11.03.2008";12;"73.3";14593;72017;57424
801;"11.03.2008";13;"71.8";14780;71142;56362
801;"11.03.2008";14;"71.5";14653;70478;55825
801;"11.03.2008";15;"67.8";14400;69769;55369
801;"11.03.2008";16;"66.5";13900;68804;54904
801;"11.03.2008";17;"60.6";12624;66942;54318
801;"11.03.2008";18;"63.8";11216;67264;56048
801;"11.03.2008";19;"80.6";10110;70327;60217
801;"11.03.2008";20;"82.6";10295;71026;60731
801;"11.03.2008";21;"74.3";10911;66748;55837
801;"11.03.2008";22;"59.9";11642;63821;52179
801;"11.03.2008";23;"55.3";12239;62166;49927
801;"11.03.2008";24;"36.8";12835;57708;44873
802;"12.03.2008";1;"39.4";13245;54459;41214
802;"12.03.2008";2;"28.1";13635;52535;38900
802;"12.03.2008";3;"21.5";13700;51916;38216
802;"12.03.2008";4;"19.2";13692;52638;38946
802;"12.03.2008";5;"27.1";13455;54184;40729
802;"12.03.2008";6;"30.3";13281;55880;42599
802;"12.03.2008";7;"39.4";13149;61752;48603
802;"12.03.2008";8;"57.2";13823;65947;52124
802;"12.03.2008";9;"58.1";15076;69418;54342
802;"12.03.2008";10;"58.6";15261;69932;54671
802;"12.03.2008";11;60;15784;71621;55837
802;"12.03.2008";12;"60.6";15869;72064;56195
802;"12.03.2008";13;"55.7";16521;71785;55264
802;"12.03.2008";14;"57.9";16435;71377;54942
802;"12.03.2008";15;"55.4";16213;70654;54441
802;"12.03.2008";16;"53.4";16949;70386;53437
802;"12.03.2008";17;"51.9";17733;69801;52068
802;"12.03.2008";18;"52.6";17890;70082;52192
802;"12.03.2008";19;58;18295;73043;54748
802;"12.03.2008";20;"55.6";18373;73518;55145
802;"12.03.2008";21;"58.5";18578;69902;51324
802;"12.03.2008";22;"49.6";18392;66911;48519
802;"12.03.2008";23;"50.8";18763;65164;46401
802;"12.03.2008";24;"30.3";19040;61655;42615
803;"13.03.2008";1;"40.3";18981;58849;39868
803;"13.03.2008";2;"28.1";18929;57573;38644
803;"13.03.2008";3;"27.1";18780;56683;37903
803;"13.03.2008";4;28;18119;56707;38588
803;"13.03.2008";5;"30.4";17432;57107;39675
803;"13.03.2008";6;"39.5";17786;59248;41462
803;"13.03.2008";7;"52.8";17567;64067;46500
803;"13.03.2008";8;"70.9";17568;67821;50253
803;"13.03.2008";9;"58.2";17326;70018;52692
803;"13.03.2008";10;"58.5";17080;70558;53478
803;"13.03.2008";11;"57.7";17322;71542;54220
803;"13.03.2008";12;"61.8";17470;72725;55255
803;"13.03.2008";13;"59.8";17363;72431;55068
803;"13.03.2008";14;"60.1";17420;72301;54881
803;"13.03.2008";15;"58.7";16932;71146;54214
803;"13.03.2008";16;"55.4";16378;70123;53745
803;"13.03.2008";17;"53.2";15024;68194;53170
803;"13.03.2008";18;"55.4";12945;67904;54959
803;"13.03.2008";19;"75.1";11176;70512;59336
803;"13.03.2008";20;82;10402;71587;61185
803;"13.03.2008";21;75;9052;67461;58409
803;"13.03.2008";22;"58.9";8216;64402;56186
803;"13.03.2008";23;"54.6";7261;62225;54964
803;"13.03.2008";24;45;6535;57488;50953
804;"14.03.2008";1;"40.9";6078;53606;47528
804;"14.03.2008";2;"37.4";5653;51502;45849
804;"14.03.2008";3;"38.7";5162;50864;45702
804;"14.03.2008";4;"34.6";4567;51841;47274
804;"14.03.2008";5;"34.1";4297;52501;48204
804;"14.03.2008";6;52;4659;54070;49411
804;"14.03.2008";7;"54.6";4980;59810;54830
804;"14.03.2008";8;"67.1";5144;64715;59571
804;"14.03.2008";9;"68.3";5635;67733;62098
804;"14.03.2008";10;69;6250;68562;62312
804;"14.03.2008";11;"68.6";7877;69813;61936
804;"14.03.2008";12;"68.8";9618;70926;61308
804;"14.03.2008";13;"66.3";11494;70186;58692
804;"14.03.2008";14;59;13213;69293;56080
804;"14.03.2008";15;"55.6";14290;68416;54126
804;"14.03.2008";16;"53.6";14350;67587;53237
804;"14.03.2008";17;"52.2";13542;66867;53325
804;"14.03.2008";18;53;12274;66994;54720
804;"14.03.2008";19;"59.8";10265;69287;59022
804;"14.03.2008";20;"65.9";8775;70133;61358
804;"14.03.2008";21;"66.1";7923;65865;57942
804;"14.03.2008";22;"57.9";7141;62699;55558
804;"14.03.2008";23;"57.3";6162;60869;54707
804;"14.03.2008";24;"50.4";4948;56592;51644
805;"15.03.2008";1;"39.8";4311;53240;48929
805;"15.03.2008";2;"36.1";3587;50804;47217
805;"15.03.2008";3;"34.2";2975;49714;46739
805;"15.03.2008";4;"34.1";2296;50502;48206
805;"15.03.2008";5;"34.9";1805;50556;48751
805;"15.03.2008";6;"37.3";1541;49827;48286
805;"15.03.2008";7;"34.1";1427;48131;46704
805;"15.03.2008";8;"49.9";1247;50075;48828
805;"15.03.2008";9;"58.1";1000;53937;52937
805;"15.03.2008";10;68;685;56203;55518
805;"15.03.2008";11;"68.2";681;57079;56398
805;"15.03.2008";12;65;653;57506;56853
805;"15.03.2008";13;66;559;56077;55518
805;"15.03.2008";14;60;463;53950;53487
805;"15.03.2008";15;"50.1";380;52292;51912
805;"15.03.2008";16;"46.1";408;51788;51380
805;"15.03.2008";17;44;473;52055;51582
805;"15.03.2008";18;48;537;53382;52845
805;"15.03.2008";19;68;889;57876;56987
805;"15.03.2008";20;"75.1";1534;59770;58236
805;"15.03.2008";21;"64.1";1718;55660;53942
805;"15.03.2008";22;"46.5";1948;53209;51261
805;"15.03.2008";23;"50.1";2283;52789;50506
805;"15.03.2008";24;"34.2";2255;48743;46488
806;"16.03.2008";1;35;2280;45541;43261
806;"16.03.2008";2;"31.3";2641;43151;40510
806;"16.03.2008";3;"28.4";2937;42562;39625
806;"16.03.2008";4;27;3416;42837;39421
806;"16.03.2008";5;"26.6";3518;43439;39921
806;"16.03.2008";6;"28.8";3726;43413;39687
806;"16.03.2008";7;"5.3";4120;41661;37541
806;"16.03.2008";8;"14.3";4267;42857;38590
806;"16.03.2008";9;"32.1";4044;45934;41890
806;"16.03.2008";10;"35.2";3625;48163;44538
806;"16.03.2008";11;"47.6";3594;50615;47021
806;"16.03.2008";12;"55.9";3717;53626;49909
806;"16.03.2008";13;"52.8";3337;52656;49319
806;"16.03.2008";14;"44.3";3096;50336;47240
806;"16.03.2008";15;"35.2";2923;48690;45767
806;"16.03.2008";16;"32.3";2797;48222;45425
806;"16.03.2008";17;"32.9";2777;48264;45487
806;"16.03.2008";18;35;2681;49900;47219
806;"16.03.2008";19;"60.9";2611;54289;51678
806;"16.03.2008";20;"65.5";2626;56421;53795
806;"16.03.2008";21;"55.2";2719;53920;51201
806;"16.03.2008";22;"49.5";2710;53013;50303
806;"16.03.2008";23;"54.3";2835;53821;50986
806;"16.03.2008";24;"36.2";3018;50098;47080
807;"17.03.2008";1;38;3460;47963;44503
807;"17.03.2008";2;"31.5";3878;46738;42860
807;"17.03.2008";3;"30.4";4311;46213;41902
807;"17.03.2008";4;"29.2";5199;47359;42160
807;"17.03.2008";5;"30.7";5846;49282;43436
807;"17.03.2008";6;"42.1";6347;51832;45485
807;"17.03.2008";7;52;6945;56995;50050
807;"17.03.2008";8;"68.4";6817;62620;55803
807;"17.03.2008";9;63;7432;66019;58587
807;"17.03.2008";10;"67.6";8946;68180;59234
807;"17.03.2008";11;"69.1";10061;70005;59944
807;"17.03.2008";12;"68.8";11383;71993;60610
807;"17.03.2008";13;"69.1";12224;71687;59463
807;"17.03.2008";14;"64.9";12420;71277;58857
807;"17.03.2008";15;"60.7";12911;70171;57260
807;"17.03.2008";16;58;13154;69430;56276
807;"17.03.2008";17;"54.3";12543;68088;55545
807;"17.03.2008";18;"55.6";11553;67905;56352
807;"17.03.2008";19;70;10869;70298;59429
807;"17.03.2008";20;"72.2";9907;71035;61128
807;"17.03.2008";21;"73.7";9558;67815;58257
807;"17.03.2008";22;"56.5";8959;64685;55726
807;"17.03.2008";23;"53.3";8991;62817;53826
807;"17.03.2008";24;"45.8";9214;59354;50140
808;"18.03.2008";1;"39.9";8947;56802;47855
808;"18.03.2008";2;"35.3";8974;55327;46353
808;"18.03.2008";3;"30.3";9204;54718;45514
808;"18.03.2008";4;"27.3";8884;54824;45940
808;"18.03.2008";5;"27.8";8386;55330;46944
808;"18.03.2008";6;"36.8";8225;56491;48266
808;"18.03.2008";7;"47.2";8577;60514;51937
808;"18.03.2008";8;"61.8";8733;64471;55738
808;"18.03.2008";9;"68.3";8810;66922;58112
808;"18.03.2008";10;"68.2";9173;67419;58246
808;"18.03.2008";11;"66.2";9623;68461;58838
808;"18.03.2008";12;"69.1";9747;69611;59864
808;"18.03.2008";13;"69.6";9975;68813;58838
808;"18.03.2008";14;69;9898;68096;58198
808;"18.03.2008";15;"63.3";10138;67301;57163
808;"18.03.2008";16;"61.2";9559;66107;56548
808;"18.03.2008";17;56;8194;64283;56089
808;"18.03.2008";18;"57.8";7079;64216;57137
808;"18.03.2008";19;"75.1";5051;66512;61461
808;"18.03.2008";20;"87.1";4063;69844;65781
808;"18.03.2008";21;"74.4";3862;66087;62225
808;"18.03.2008";22;"62.1";3752;63198;59446
808;"18.03.2008";23;"56.3";3876;61464;57588
808;"18.03.2008";24;"48.4";3857;57484;53627
809;"19.03.2008";1;"50.3";3837;54726;50889
809;"19.03.2008";2;"48.7";3582;53494;49912
809;"19.03.2008";3;"48.1";3530;52556;49026
809;"19.03.2008";4;"43.9";3668;52484;48816
809;"19.03.2008";5;47;3794;53758;49964
809;"19.03.2008";6;"52.1";3999;55884;51885
809;"19.03.2008";7;"54.8";3927;59243;55316
809;"19.03.2008";8;73;3740;63209;59469
809;"19.03.2008";9;"76.6";3799;66035;62236
809;"19.03.2008";10;77;3912;67122;63210
809;"19.03.2008";11;"78.3";4720;68423;63703
809;"19.03.2008";12;"78.8";5269;69346;64077
809;"19.03.2008";13;"75.9";5491;68572;63081
809;"19.03.2008";14;"74.8";5639;68044;62405
809;"19.03.2008";15;"72.1";5781;67028;61247
809;"19.03.2008";16;"67.8";6409;66103;59694
809;"19.03.2008";17;"62.2";6039;64551;58512
809;"19.03.2008";18;"64.8";4813;64673;59860
809;"19.03.2008";19;"75.7";4097;67196;63099
809;"19.03.2008";20;"81.3";3530;70054;66524
809;"19.03.2008";21;"76.2";3252;66384;63132
809;"19.03.2008";22;"64.4";3051;63408;60357
809;"19.03.2008";23;"58.5";3176;61867;58691
809;"19.03.2008";24;"51.5";3256;57939;54683
810;"20.03.2008";1;"57.5";3362;55621;52259
810;"20.03.2008";2;"51.5";3255;54058;50803
810;"20.03.2008";3;"47.2";3307;52788;49481
810;"20.03.2008";4;"40.7";3132;53022;49890
810;"20.03.2008";5;"43.2";3148;53404;50256
810;"20.03.2008";6;"53.2";3211;54812;51601
810;"20.03.2008";7;"59.9";3286;58148;54862
810;"20.03.2008";8;77;3094;62575;59481
810;"20.03.2008";9;"84.3";2849;65520;62671
810;"20.03.2008";10;"87.1";3094;66762;63668
810;"20.03.2008";11;"88.5";3793;67999;64206
810;"20.03.2008";12;"88.8";4671;69611;64940
810;"20.03.2008";13;"78.7";4933;68705;63772
810;"20.03.2008";14;"76.8";5835;67466;61631
810;"20.03.2008";15;"70.4";6746;66404;59658
810;"20.03.2008";16;61;7413;65750;58337
810;"20.03.2008";17;59;7727;64352;56625
810;"20.03.2008";18;"58.8";8234;64795;56561
810;"20.03.2008";19;66;9425;66989;57564
810;"20.03.2008";20;"66.6";11023;68205;57182
810;"20.03.2008";21;60;12962;64579;51617
810;"20.03.2008";22;50;14545;62093;47548
810;"20.03.2008";23;"48.5";15321;60974;45653
810;"20.03.2008";24;"31.4";15224;58121;42897
811;"21.03.2008";1;"34.1";14180;55694;41514
811;"21.03.2008";2;"27.3";13513;53927;40414
811;"21.03.2008";3;"27.2";12349;52414;40065
811;"21.03.2008";4;"28.2";11510;52084;40574
811;"21.03.2008";5;"29.4";10811;51416;40605
811;"21.03.2008";6;"28.5";9780;49444;39664
811;"21.03.2008";7;"17.2";8006;45822;37816
811;"21.03.2008";8;"29.6";6348;45411;39063
811;"21.03.2008";9;"37.5";5521;46954;41433
811;"21.03.2008";10;"50.1";5279;49527;44248
811;"21.03.2008";11;"55.5";4979;51656;46677
811;"21.03.2008";12;67;5086;54471;49385
811;"21.03.2008";13;"66.8";5131;54317;49186
811;"21.03.2008";14;"58.5";5103;52770;47667
811;"21.03.2008";15;"52.3";5034;51139;46105
811;"21.03.2008";16;43;4945;50476;45531
811;"21.03.2008";17;"42.3";4713;49744;45031
811;"21.03.2008";18;"47.7";4382;51023;46641
811;"21.03.2008";19;"58.4";3907;53564;49657
811;"21.03.2008";20;"77.1";3503;55895;52392
811;"21.03.2008";21;"72.9";3563;53480;49917
811;"21.03.2008";22;66;3711;52402;48691
811;"21.03.2008";23;64;3620;52860;49240
811;"21.03.2008";24;"52.5";3422;49930;46508
812;"22.03.2008";1;"49.6";3749;47599;43850
812;"22.03.2008";2;"40.4";3753;45844;42091
812;"22.03.2008";3;"41.1";3983;45482;41499
812;"22.03.2008";4;"41.9";4024;45628;41604
812;"22.03.2008";5;"41.2";4075;45997;41922
812;"22.03.2008";6;"38.8";4487;45262;40775
812;"22.03.2008";7;"27.5";5013;43630;38617
812;"22.03.2008";8;34;5606;45191;39585
812;"22.03.2008";9;52;6182;48734;42552
812;"22.03.2008";10;"57.1";6614;51347;44733
812;"22.03.2008";11;"60.6";7346;53368;46022
812;"22.03.2008";12;"65.4";7607;54581;46974
812;"22.03.2008";13;"61.5";7774;54336;46562
812;"22.03.2008";14;"58.8";7591;52930;45339
812;"22.03.2008";15;"54.2";7477;51945;44468
812;"22.03.2008";16;50;7588;52248;44660
812;"22.03.2008";17;"46.2";7477;52008;44531
812;"22.03.2008";18;"55.1";7185;53404;46219
812;"22.03.2008";19;"65.7";6461;55731;49270
812;"22.03.2008";20;"71.6";5872;57023;51151
812;"22.03.2008";21;"60.4";5296;53617;48321
812;"22.03.2008";22;"53.1";4702;51820;47118
812;"22.03.2008";23;"58.4";4126;52286;48160
812;"22.03.2008";24;"38.6";3545;49161;45616
813;"23.03.2008";1;"44.1";3108;47008;43900
813;"23.03.2008";2;"35.1";2725;44632;41907
813;"23.03.2008";3;"32.9";2352;43575;41223
813;"23.03.2008";4;"34.5";2024;43805;41781
813;"23.03.2008";5;35;1727;44262;42535
813;"23.03.2008";6;35;1429;43099;41670
813;"23.03.2008";7;"10.6";1152;39738;38586
813;"23.03.2008";8;"24.2";892;41158;40266
813;"23.03.2008";9;34;671;43306;42635
813;"23.03.2008";10;"46.1";609;45563;44954
813;"23.03.2008";11;"55.6";574;47452;46878
813;"23.03.2008";12;"59.7";569;49549;48980
813;"23.03.2008";13;"57.8";758;47776;47018
813;"23.03.2008";14;"47.4";1052;45071;44019
813;"23.03.2008";15;"41.5";1314;43386;42072
813;"23.03.2008";16;"38.7";1574;42421;40847
813;"23.03.2008";17;"37.2";1826;41850;40024
813;"23.03.2008";18;43;1832;43442;41610
813;"23.03.2008";19;"55.4";1706;46890;45184
813;"23.03.2008";20;"68.2";1922;50543;48621
813;"23.03.2008";21;62;2556;49256;46700
813;"23.03.2008";22;"58.5";2970;48758;45788
813;"23.03.2008";23;63;3214;49670;46456
813;"23.03.2008";24;43;3246;47485;44239
814;"24.03.2008";1;43;3170;45583;42413
814;"24.03.2008";2;"34.2";3143;43792;40649
814;"24.03.2008";3;"30.1";3103;42860;39757
814;"24.03.2008";4;"28.1";3109;43037;39928
814;"24.03.2008";5;"32.7";3143;43448;40305
814;"24.03.2008";6;36;3079;43044;39965
814;"24.03.2008";7;25;3007;39865;36858
814;"24.03.2008";8;"29.2";2868;40837;37969
814;"24.03.2008";9;29;2534;42843;40309
814;"24.03.2008";10;"35.3";2718;44722;42004
814;"24.03.2008";11;"42.1";3461;47159;43698
814;"24.03.2008";12;52;3657;49551;45894
814;"24.03.2008";13;"50.5";3643;48815;45172
814;"24.03.2008";14;"39.3";3797;46776;42979
814;"24.03.2008";15;"29.7";4014;45458;41444
814;"24.03.2008";16;"27.8";4456;45213;40757
814;"24.03.2008";17;"27.3";3993;44767;40774
814;"24.03.2008";18;"33.2";3623;46092;42469
814;"24.03.2008";19;"41.4";3257;49920;46663
814;"24.03.2008";20;"55.2";3264;53714;50450
814;"24.03.2008";21;"60.8";3248;52153;48905
814;"24.03.2008";22;"59.3";3115;51289;48174
814;"24.03.2008";23;64;2908;52343;49435
814;"24.03.2008";24;"51.1";3046;49787;46741
815;"25.03.2008";1;"36.7";3117;48028;44911
815;"25.03.2008";2;"32.7";3256;47158;43902
815;"25.03.2008";3;"34.1";3441;46579;43138
815;"25.03.2008";4;34;3562;47245;43683
815;"25.03.2008";5;36;3572;47560;43988
815;"25.03.2008";6;"45.3";3521;49597;46076
815;"25.03.2008";7;"52.5";3818;53974;50156
815;"25.03.2008";8;"70.6";4088;60353;56265
815;"25.03.2008";9;"72.8";4769;64461;59692
815;"25.03.2008";10;"76.9";5309;66340;61031
815;"25.03.2008";11;"77.1";6103;68032;61929
815;"25.03.2008";12;"80.3";6505;69685;63180
815;"25.03.2008";13;"76.5";7395;68894;61499
815;"25.03.2008";14;"77.2";8501;68141;59640
815;"25.03.2008";15;75;8861;67752;58891
815;"25.03.2008";16;"71.1";8715;67201;58486
815;"25.03.2008";17;"63.5";7602;65337;57735
815;"25.03.2008";18;65;7148;64868;57720
815;"25.03.2008";19;"68.7";6196;66367;60171
815;"25.03.2008";20;77;5501;69056;63555
815;"25.03.2008";21;"72.1";6248;65423;59175
815;"25.03.2008";22;63;6876;63106;56230
815;"25.03.2008";23;"58.5";7410;61889;54479
815;"25.03.2008";24;"47.7";7889;58472;50583
816;"26.03.2008";1;"48.5";7948;56873;48925
816;"26.03.2008";2;"38.8";8425;55728;47303
816;"26.03.2008";3;"30.4";8913;55018;46105
816;"26.03.2008";4;"30.3";8937;55202;46265
816;"26.03.2008";5;"36.9";8754;55951;47197
816;"26.03.2008";6;"42.1";8549;56620;48071
816;"26.03.2008";7;"55.2";8557;59493;50936
816;"26.03.2008";8;"72.9";8038;63513;55475
816;"26.03.2008";9;"70.6";7609;66985;59376
816;"26.03.2008";10;71;7603;68590;60987
816;"26.03.2008";11;"75.8";7676;70238;62562
816;"26.03.2008";12;"77.5";7803;71619;63816
816;"26.03.2008";13;79;7515;70952;63437
816;"26.03.2008";14;"78.9";6999;70053;63054
816;"26.03.2008";15;80;6428;69049;62621
816;"26.03.2008";16;76;5273;67504;62231
816;"26.03.2008";17;"71.2";3663;65922;62259
816;"26.03.2008";18;70;2521;65668;63147
816;"26.03.2008";19;"91.7";1614;67164;65550
816;"26.03.2008";20;"110.1";1208;69789;68581
816;"26.03.2008";21;92;939;66298;65359
816;"26.03.2008";22;"79.6";774;63264;62490
816;"26.03.2008";23;"72.7";714;61823;61109
816;"26.03.2008";24;"58.3";592;58055;57463
817;"27.03.2008";1;"53.8";424;55236;54812
817;"27.03.2008";2;"54.3";346;53500;53154
817;"27.03.2008";3;"51.6";359;52605;52246
817;"27.03.2008";4;48;340;53024;52684
817;"27.03.2008";5;"47.1";369;53881;53512
817;"27.03.2008";6;"55.9";417;54886;54469
817;"27.03.2008";7;71;539;57908;57369
817;"27.03.2008";8;"82.6";710;62228;61518
817;"27.03.2008";9;"84.4";738;65454;64716
817;"27.03.2008";10;"90.1";612;66576;65964
817;"27.03.2008";11;"96.3";616;67701;67085
817;"27.03.2008";12;"96.9";683;69200;68517
817;"27.03.2008";13;"90.1";792;68433;67641
817;"27.03.2008";14;"81.3";883;67996;67113
817;"27.03.2008";15;79;915;67122;66207
817;"27.03.2008";16;"73.7";914;66591;65677
817;"27.03.2008";17;"68.7";1030;65119;64089
817;"27.03.2008";18;"67.1";1102;65321;64219
817;"27.03.2008";19;"75.8";1220;66803;65583
817;"27.03.2008";20;"82.8";1668;69607;67939
817;"27.03.2008";21;"79.6";2091;65901;63810
817;"27.03.2008";22;"71.1";2414;63013;60599
817;"27.03.2008";23;"68.1";2606;61475;58869
817;"27.03.2008";24;"57.3";2649;57335;54686
818;"28.03.2008";1;"54.2";2642;54280;51638
818;"28.03.2008";2;"53.6";2370;52679;50309
818;"28.03.2008";3;52;1982;51810;49828
818;"28.03.2008";4;"49.9";1949;52053;50104
818;"28.03.2008";5;"51.1";2119;53174;51055
818;"28.03.2008";6;"53.9";2473;54554;52081
818;"28.03.2008";7;"64.9";2757;57405;54648
818;"28.03.2008";8;"84.2";2768;62108;59340
818;"28.03.2008";9;"90.1";2349;64998;62649
818;"28.03.2008";10;90;2765;66043;63278
818;"28.03.2008";11;"94.9";3767;67252;63485
818;"28.03.2008";12;95;4912;68246;63334
818;"28.03.2008";13;"85.5";5950;66965;61015
818;"28.03.2008";14;"76.6";6907;65190;58283
818;"28.03.2008";15;68;7609;63580;55971
818;"28.03.2008";16;"60.5";7834;62833;54999
818;"28.03.2008";17;"55.9";7758;62257;54499
818;"28.03.2008";18;54;7108;62472;55364
818;"28.03.2008";19;"55.1";7212;63941;56729
818;"28.03.2008";20;"60.3";8219;67057;58838
818;"28.03.2008";21;"57.7";9237;63750;54513
818;"28.03.2008";22;"45.2";10755;61466;50711
818;"28.03.2008";23;"45.2";11329;60611;49282
818;"28.03.2008";24;"27.7";11585;56844;45259
819;"29.03.2008";1;"51.9";11374;53084;41710
819;"29.03.2008";2;48;11272;51526;40254
819;"29.03.2008";3;"42.4";10950;50392;39442
819;"29.03.2008";4;"39.9";11130;50084;38954
819;"29.03.2008";5;"41.2";11323;50639;39316
819;"29.03.2008";6;"41.5";11628;50017;38389
819;"29.03.2008";7;"28.2";12214;48851;36637
819;"29.03.2008";8;"33.3";12616;50951;38335
819;"29.03.2008";9;"37.3";13877;54831;40954
819;"29.03.2008";10;"49.7";14662;58109;43447
819;"29.03.2008";11;"56.9";14801;59394;44593
819;"29.03.2008";12;"58.5";14999;59900;44901
819;"29.03.2008";13;"52.4";15068;58753;43685
819;"29.03.2008";14;"52.1";14150;56670;42520
819;"29.03.2008";15;"44.7";12422;53966;41544
819;"29.03.2008";16;"43.8";11043;52728;41685
819;"29.03.2008";17;"45.6";8192;51564;43372
819;"29.03.2008";18;"49.9";5239;52007;46768
819;"29.03.2008";19;"61.9";2958;54312;51354
819;"29.03.2008";20;"74.6";2849;58188;55339
819;"29.03.2008";21;"59.9";3735;55587;51852
819;"29.03.2008";22;"50.6";4971;53295;48324
819;"29.03.2008";23;"47.4";5787;52978;47191
819;"29.03.2008";24;"42.4";6344;49626;43282
820;"30.03.2008";1;"33.2";7052;46921;39869
820;"30.03.2008";2;"27.2";7968;44818;36850
820;"30.03.2008";3;"27.2";7968;44818;36850
820;"30.03.2008";4;"23.6";8813;44777;35964
820;"30.03.2008";5;"20.1";9499;44990;35491
820;"30.03.2008";6;"26.3";10106;45591;35485
820;"30.03.2008";7;0;10950;44459;33509
820;"30.03.2008";8;0;11414;44070;32656
820;"30.03.2008";9;"27.1";11798;45667;33869
820;"30.03.2008";10;"29.5";11686;46724;35038
820;"30.03.2008";11;"34.7";11626;49018;37392
820;"30.03.2008";12;"47.8";11727;51582;39855
820;"30.03.2008";13;37;12027;51233;39206
820;"30.03.2008";14;"32.1";11996;49688;37692
820;"30.03.2008";15;"25.1";12455;48287;35832
820;"30.03.2008";16;22;11865;47567;35702
820;"30.03.2008";17;"20.6";11293;47436;36143
820;"30.03.2008";18;29;9941;48633;38692
820;"30.03.2008";19;"42.1";8741;50442;41701
820;"30.03.2008";20;54;8141;52766;44625
820;"30.03.2008";21;"47.3";7775;55810;48035
820;"30.03.2008";22;"48.1";6624;55035;48411
820;"30.03.2008";23;"58.9";5919;54914;48995
820;"30.03.2008";24;"41.9";5348;51252;45904
821;"31.03.2008";1;"27.8";5042;47288;42246
821;"31.03.2008";2;"11.3";4836;45546;40710
821;"31.03.2008";3;"6.9";5034;44570;39536
821;"31.03.2008";4;"17.1";5014;45097;40083
821;"31.03.2008";5;"28.5";4935;47007;42072
821;"31.03.2008";6;"39.2";4812;50362;45550
821;"31.03.2008";7;"54.5";4688;57949;53261
821;"31.03.2008";8;"86.6";4163;63095;58932
821;"31.03.2008";9;"80.2";3264;65758;62494
821;"31.03.2008";10;84;2278;66072;63794
821;"31.03.2008";11;"86.4";2136;67104;64968
821;"31.03.2008";12;"90.1";2037;68208;66171
821;"31.03.2008";13;"87.1";1935;67569;65634
821;"31.03.2008";14;"84.9";1647;67205;65558
821;"31.03.2008";15;"80.1";1559;65855;64296
821;"31.03.2008";16;"77.1";1438;64682;63244
821;"31.03.2008";17;"58.8";1397;62936;61539
821;"31.03.2008";18;"55.9";1223;62165;60942
821;"31.03.2008";19;"59.9";1017;62449;61432
821;"31.03.2008";20;"75.2";909;63335;62426
821;"31.03.2008";21;"88.1";961;64966;64005
821;"31.03.2008";22;"72.8";993;62666;61673
821;"31.03.2008";23;"63.9";995;59919;58924
821;"31.03.2008";24;"50.5";993;55541;54548
822;"01.04.2008";1;"55.2";868;51842;50974
822;"01.04.2008";2;"50.1";790;49421;48631
822;"01.04.2008";3;"46.5";772;48757;47985
822;"01.04.2008";4;"42.3";854;49597;48743
822;"01.04.2008";5;"46.4";1001;51519;50518
822;"01.04.2008";6;"58.9";1084;54807;53723
822;"01.04.2008";7;"70.6";1273;60637;59364
822;"01.04.2008";8;"104.5";1580;64688;63108
822;"01.04.2008";9;"105.1";1642;67107;65465
822;"01.04.2008";10;"94.6";1220;67168;65948
822;"01.04.2008";11;"93.6";1463;67548;66085
822;"01.04.2008";12;"94.1";2524;68239;65715
822;"01.04.2008";13;80;4182;67335;63153
822;"01.04.2008";14;"74.7";5623;66897;61274
822;"01.04.2008";15;64;6245;65733;59488
822;"01.04.2008";16;"57.7";6901;65085;58184
822;"01.04.2008";17;"54.3";6897;63921;57024
822;"01.04.2008";18;"54.2";6995;64319;57324
822;"01.04.2008";19;"53.6";6513;64474;57961
822;"01.04.2008";20;"52.9";6240;65065;58825
822;"01.04.2008";21;"70.6";6249;65818;59569
822;"01.04.2008";22;"61.9";6234;63290;57056
822;"01.04.2008";23;"54.5";6210;60190;53980
822;"01.04.2008";24;"46.4";6242;55481;49239
823;"02.04.2008";1;"51.9";5822;51252;45430
823;"02.04.2008";2;"43.4";5484;49111;43627
823;"02.04.2008";3;"41.5";5258;47972;42714
823;"02.04.2008";4;37;5342;48496;43154
823;"02.04.2008";5;"41.6";5609;50441;44832
823;"02.04.2008";6;50;6053;53780;47727
823;"02.04.2008";7;64;6183;60393;54210
823;"02.04.2008";8;86;6202;64971;58769
823;"02.04.2008";9;"81.9";5884;67506;61622
823;"02.04.2008";10;"82.1";6051;68327;62276
823;"02.04.2008";11;"85.9";6223;69377;63154
823;"02.04.2008";12;90;6840;70756;63916
823;"02.04.2008";13;82;7253;69895;62642
823;"02.04.2008";14;"80.1";7456;69398;61942
823;"02.04.2008";15;"78.1";8014;68425;60411
823;"02.04.2008";16;"70.8";8518;67298;58780
823;"02.04.2008";17;65;8978;65747;56769
823;"02.04.2008";18;"61.7";8573;65493;56920
823;"02.04.2008";19;"68.9";7701;65214;57513
823;"02.04.2008";20;"75.9";7010;65767;58757
823;"02.04.2008";21;"81.1";6151;65837;59686
823;"02.04.2008";22;"70.2";5842;63320;57478
823;"02.04.2008";23;"57.8";5530;60774;55244
823;"02.04.2008";24;"50.5";5183;56218;51035
824;"03.04.2008";1;"48.5";4807;52516;47709
824;"03.04.2008";2;"44.2";4593;50080;45487
824;"03.04.2008";3;"41.6";4481;49388;44907
824;"03.04.2008";4;"41.5";4413;49948;45535
824;"03.04.2008";5;"43.5";4295;51479;47184
824;"03.04.2008";6;"50.4";4140;54276;50136
824;"03.04.2008";7;"66.2";4020;60314;56294
824;"03.04.2008";8;"81.8";3510;65105;61595
824;"03.04.2008";9;"80.1";3239;68021;64782
824;"03.04.2008";10;"82.1";3037;68676;65639
824;"03.04.2008";11;84;2975;69628;66653
824;"03.04.2008";12;"88.9";2771;70939;68168
824;"03.04.2008";13;"85.1";2900;70035;67135
824;"03.04.2008";14;"84.5";2792;69195;66403
824;"03.04.2008";15;84;2992;68153;65161
824;"03.04.2008";16;"79.1";2799;67414;64615
824;"03.04.2008";17;"68.2";2646;65688;63042
824;"03.04.2008";18;"66.7";2496;64833;62337
824;"03.04.2008";19;76;2211;64699;62488
824;"03.04.2008";20;"78.1";1980;64928;62948
824;"03.04.2008";21;87;1873;65731;63858
824;"03.04.2008";22;"74.9";1700;63357;61657
824;"03.04.2008";23;68;1657;60829;59172
824;"03.04.2008";24;"53.5";1448;56221;54773
825;"04.04.2008";1;"55.6";1332;52867;51535
825;"04.04.2008";2;"50.3";1363;50269;48906
825;"04.04.2008";3;"48.1";1303;49211;47908
825;"04.04.2008";4;"46.3";1168;49727;48559
825;"04.04.2008";5;"48.2";1190;51334;50144
825;"04.04.2008";6;"54.4";1102;54370;53268
825;"04.04.2008";7;"70.8";1050;60526;59476
825;"04.04.2008";8;"87.5";1067;65287;64220
825;"04.04.2008";9;"97.9";1035;68297;67262
825;"04.04.2008";10;"99.9";955;68622;67667
825;"04.04.2008";11;"94.4";991;69321;68330
825;"04.04.2008";12;98;987;70006;69019
825;"04.04.2008";13;90;1090;68901;67811
825;"04.04.2008";14;"82.5";1177;67055;65878
825;"04.04.2008";15;"74.5";1384;65456;64072
825;"04.04.2008";16;"67.1";1617;64668;63051
825;"04.04.2008";17;64;1858;63738;61880
825;"04.04.2008";18;"62.6";1934;63351;61417
825;"04.04.2008";19;"64.2";1672;63267;61595
825;"04.04.2008";20;"65.6";1728;63462;61734
825;"04.04.2008";21;78;1874;63393;61519
825;"04.04.2008";22;"67.4";2020;60859;58839
825;"04.04.2008";23;"61.1";2164;58899;56735
825;"04.04.2008";24;"48.6";2167;55168;53001
826;"05.04.2008";1;59;2218;51506;49288
826;"05.04.2008";2;"52.8";2309;49473;47164
826;"05.04.2008";3;"49.9";2323;48170;45847
826;"05.04.2008";4;"48.2";2259;48211;45952
826;"05.04.2008";5;"47.7";2175;48477;46302
826;"05.04.2008";6;"48.9";2111;48349;46238
826;"05.04.2008";7;"35.3";2127;48235;46108
826;"05.04.2008";8;"45.2";2253;49766;47513
826;"05.04.2008";9;"50.6";2103;53507;51404
826;"05.04.2008";10;"57.6";1967;56765;54798
826;"05.04.2008";11;"65.2";1920;58851;56931
826;"05.04.2008";12;"70.1";2000;60123;58123
826;"05.04.2008";13;"60.6";2336;59256;56920
826;"05.04.2008";14;"56.3";2400;57084;54684
826;"05.04.2008";15;48;2495;55242;52747
826;"05.04.2008";16;"46.5";2555;54357;51802
826;"05.04.2008";17;"43.1";2514;53604;51090
826;"05.04.2008";18;"45.5";2551;54257;51706
826;"05.04.2008";19;51;2528;55110;52582
826;"05.04.2008";20;"51.9";2211;55197;52986
826;"05.04.2008";21;"56.1";2276;55411;53135
826;"05.04.2008";22;"56.6";1926;54040;52114
826;"05.04.2008";23;"56.2";1671;53921;52250
826;"05.04.2008";24;"45.9";1566;50967;49401
827;"06.04.2008";1;"52.8";1545;47325;45780
827;"06.04.2008";2;"46.2";1468;44972;43504
827;"06.04.2008";3;"43.8";1559;43643;42084
827;"06.04.2008";4;"43.3";1490;43469;41979
827;"06.04.2008";5;"41.1";1498;44074;42576
827;"06.04.2008";6;"44.2";1414;43530;42116
827;"06.04.2008";7;"30.3";1354;41620;40266
827;"06.04.2008";8;"32.3";1252;42107;40855
827;"06.04.2008";9;"42.6";997;45287;44290
827;"06.04.2008";10;"50.3";1071;47959;46888
827;"06.04.2008";11;"58.2";1165;50658;49493
827;"06.04.2008";12;"68.2";1138;53486;52348
827;"06.04.2008";13;"65.5";1231;52649;51418
827;"06.04.2008";14;"52.8";1318;50286;48968
827;"06.04.2008";15;48;1320;48422;47102
827;"06.04.2008";16;"35.8";1240;47148;45908
827;"06.04.2008";17;"35.3";1233;46618;45385
827;"06.04.2008";18;"41.6";844;47535;46691
827;"06.04.2008";19;54;760;49531;48771
827;"06.04.2008";20;"62.9";580;50877;50297
827;"06.04.2008";21;"66.7";488;53613;53125
827;"06.04.2008";22;"60.1";449;53551;53102
827;"06.04.2008";23;"63.5";549;54054;53505
827;"06.04.2008";24;"51.7";582;50796;50214
828;"07.04.2008";1;"50.4";577;48647;48070
828;"07.04.2008";2;"43.4";617;46621;46004
828;"07.04.2008";3;"38.2";558;46040;45482
828;"07.04.2008";4;"38.2";617;46800;46183
828;"07.04.2008";5;"43.7";630;48279;47649
828;"07.04.2008";6;"51.4";705;51711;51006
828;"07.04.2008";7;"64.5";768;59445;58677
828;"07.04.2008";8;"85.6";908;64386;63478
828;"07.04.2008";9;92;853;67300;66447
828;"07.04.2008";10;95;748;67717;66969
828;"07.04.2008";11;97;758;68663;67905
828;"07.04.2008";12;"109.3";867;69713;68846
828;"07.04.2008";13;"94.5";996;69038;68042
828;"07.04.2008";14;"95.1";1215;68427;67212
828;"07.04.2008";15;"87.9";1533;67319;65786
828;"07.04.2008";16;90;1861;66365;64504
828;"07.04.2008";17;"76.5";2129;64702;62573
828;"07.04.2008";18;"73.1";2243;63997;61754
828;"07.04.2008";19;"79.2";2032;63882;61850
828;"07.04.2008";20;"84.3";2040;64272;62232
828;"07.04.2008";21;96;2122;64969;62847
828;"07.04.2008";22;"82.2";1998;63433;61435
828;"07.04.2008";23;71;2045;61200;59155
828;"07.04.2008";24;"57.2";2130;57429;55299
829;"08.04.2008";1;"54.1";2084;54226;52142
829;"08.04.2008";2;"48.9";2159;52178;50019
829;"08.04.2008";3;"46.2";2377;51568;49191
829;"08.04.2008";4;"48.3";2548;52004;49456
829;"08.04.2008";5;"52.7";2527;53185;50658
829;"08.04.2008";6;"60.4";2374;56068;53694
829;"08.04.2008";7;"74.4";2020;61779;59759
829;"08.04.2008";8;"97.8";1856;65201;63345
829;"08.04.2008";9;140;1724;67067;65343
829;"08.04.2008";10;"185.8";1525;66576;65051
829;"08.04.2008";11;"199.9";1627;66910;65283
829;"08.04.2008";12;"181.8";1597;68054;66457
829;"08.04.2008";13;"123.9";1482;67442;65960
829;"08.04.2008";14;"122.9";1411;66918;65507
829;"08.04.2008";15;"116.9";1352;65804;64452
829;"08.04.2008";16;100;1192;65004;63812
829;"08.04.2008";17;"85.1";1028;63498;62470
829;"08.04.2008";18;"79.3";805;63029;62224
829;"08.04.2008";19;79;716;62863;62147
829;"08.04.2008";20;"83.7";518;63342;62824
829;"08.04.2008";21;"92.5";552;64798;64246
829;"08.04.2008";22;"82.9";529;62906;62377
829;"08.04.2008";23;"68.6";528;60338;59810
829;"08.04.2008";24;"53.5";602;55742;55140
830;"09.04.2008";1;"57.8";703;52229;51526
830;"09.04.2008";2;"52.1";722;49740;49018
830;"09.04.2008";3;"49.5";735;48909;48174
830;"09.04.2008";4;"49.6";710;49479;48769
830;"09.04.2008";5;"50.1";708;51247;50539
830;"09.04.2008";6;"57.8";744;54421;53677
830;"09.04.2008";7;"73.3";722;61162;60440
830;"09.04.2008";8;"116.9";861;65195;64334
830;"09.04.2008";9;"130.1";728;67345;66617
830;"09.04.2008";10;"157.8";517;67221;66704
830;"09.04.2008";11;170;418;67756;67338
830;"09.04.2008";12;191;381;68687;68306
830;"09.04.2008";13;"166.1";409;67995;67586
830;"09.04.2008";14;"155.8";469;67958;67489
830;"09.04.2008";15;"129.7";503;67284;66781
830;"09.04.2008";16;110;677;66374;65697
830;"09.04.2008";17;"90.1";703;65111;64408
830;"09.04.2008";18;"84.3";757;64708;63951
830;"09.04.2008";19;"82.8";841;64898;64057
830;"09.04.2008";20;"82.7";1011;64729;63718
830;"09.04.2008";21;"100.1";1123;64768;63645
830;"09.04.2008";22;"88.3";1351;62601;61250
830;"09.04.2008";23;68;1461;60152;58691
830;"09.04.2008";24;"54.6";1479;56006;54527
831;"10.04.2008";1;56;1164;52396;51232
831;"10.04.2008";2;"49.3";878;49996;49118
831;"10.04.2008";3;"47.8";777;49221;48444
831;"10.04.2008";4;48;712;49749;49037
831;"10.04.2008";5;51;742;51470;50728
831;"10.04.2008";6;"58.2";770;54943;54173
831;"10.04.2008";7;"75.1";721;61139;60418
831;"10.04.2008";8;"99.9";655;64957;64302
831;"10.04.2008";9;"128.1";576;67196;66620
831;"10.04.2008";10;"123.2";439;67919;67480
831;"10.04.2008";11;"125.4";466;68418;67952
831;"10.04.2008";12;"121.2";545;69414;68869
831;"10.04.2008";13;110;496;68910;68414
831;"10.04.2008";14;"102.1";524;68421;67897
831;"10.04.2008";15;"104.1";513;67173;66660
831;"10.04.2008";16;"94.9";509;66302;65793
831;"10.04.2008";17;92;647;64634;63987
831;"10.04.2008";18;"84.4";835;64404;63569
831;"10.04.2008";19;"81.6";966;64438;63472
831;"10.04.2008";20;79;1106;64306;63200
831;"10.04.2008";21;"98.8";1320;64164;62844
831;"10.04.2008";22;"83.9";1518;62484;60966
831;"10.04.2008";23;"73.3";1593;60762;59169
831;"10.04.2008";24;"54.7";1574;56314;54740
832;"11.04.2008";1;"58.2";1499;52302;50803
832;"11.04.2008";2;"51.1";1479;49642;48163
832;"11.04.2008";3;"46.1";1541;48611;47070
832;"11.04.2008";4;"37.5";1628;49141;47513
832;"11.04.2008";5;44;1687;50861;49174
832;"11.04.2008";6;"58.8";1815;53836;52021
832;"11.04.2008";7;"67.1";2009;60022;58013
832;"11.04.2008";8;"95.1";2090;64913;62823
832;"11.04.2008";9;"110.1";2050;67602;65552
832;"11.04.2008";10;"115.1";2227;67660;65433
832;"11.04.2008";11;124;2382;68020;65638
832;"11.04.2008";12;128;2316;68769;66453
832;"11.04.2008";13;"117.9";2163;68025;65862
832;"11.04.2008";14;"100.1";2068;66856;64788
832;"11.04.2008";15;"90.5";1845;65429;63584
832;"11.04.2008";16;"82.8";1738;64554;62816
832;"11.04.2008";17;"73.4";1559;63528;61969
832;"11.04.2008";18;"71.9";1511;63486;61975
832;"11.04.2008";19;"73.2";1332;63556;62224
832;"11.04.2008";20;"73.2";1069;63024;61955
832;"11.04.2008";21;"79.3";958;62549;61591
832;"11.04.2008";22;66;1305;60445;59140
832;"11.04.2008";23;"61.8";2225;58451;56226
832;"11.04.2008";24;"51.6";3078;55045;51967
833;"12.04.2008";1;"55.9";3917;51440;47523
833;"12.04.2008";2;"50.6";4256;48859;44603
833;"12.04.2008";3;"46.4";4686;47623;42937
833;"12.04.2008";4;"46.4";4664;47871;43207
833;"12.04.2008";5;46;4633;48503;43870
833;"12.04.2008";6;"46.1";4321;48572;44251
833;"12.04.2008";7;"49.7";4337;48449;44112
833;"12.04.2008";8;55;4167;49680;45513
833;"12.04.2008";9;"67.9";3217;53061;49844
833;"12.04.2008";10;"77.9";3035;55850;52815
833;"12.04.2008";11;80;3686;56795;53109
833;"12.04.2008";12;"78.7";4925;57115;52190
833;"12.04.2008";13;"75.9";6020;56023;50003
833;"12.04.2008";14;56;6325;54091;47766
833;"12.04.2008";15;"53.5";6250;52566;46316
833;"12.04.2008";16;"49.5";5691;51713;46022
833;"12.04.2008";17;"48.5";4995;51372;46377
833;"12.04.2008";18;"49.3";4224;52034;47810
833;"12.04.2008";19;"59.9";3186;52862;49676
833;"12.04.2008";20;62;2010;52685;50675
833;"12.04.2008";21;"69.1";1339;52685;51346
833;"12.04.2008";22;65;1612;52433;50821
833;"12.04.2008";23;67;1747;51578;49831
833;"12.04.2008";24;55;2054;48179;46125
834;"13.04.2008";1;"49.1";2438;45271;42833
834;"13.04.2008";2;"42.6";2612;42577;39965
834;"13.04.2008";3;38;2894;41395;38501
834;"13.04.2008";4;38;3034;42075;39041
834;"13.04.2008";5;"37.5";3136;42693;39557
834;"13.04.2008";6;"41.3";3119;42418;39299
834;"13.04.2008";7;"28.6";2904;40666;37762
834;"13.04.2008";8;"30.7";2744;41509;38765
834;"13.04.2008";9;"41.1";2055;44336;42281
834;"13.04.2008";10;"47.9";1474;46462;44988
834;"13.04.2008";11;"54.6";1483;48889;47406
834;"13.04.2008";12;55;2008;51676;49668
834;"13.04.2008";13;"58.5";2848;50485;47637
834;"13.04.2008";14;"48.9";2774;48094;45320
834;"13.04.2008";15;"43.2";2534;46608;44074
834;"13.04.2008";16;"46.8";3016;46231;43215
834;"13.04.2008";17;"43.4";2421;45741;43320
834;"13.04.2008";18;"42.9";2156;46959;44803
834;"13.04.2008";19;"52.2";1581;48945;47364
834;"13.04.2008";20;"62.1";1010;49671;48661
834;"13.04.2008";21;"65.9";815;52003;51188
834;"13.04.2008";22;"68.6";819;52485;51666
834;"13.04.2008";23;"65.3";828;52390;51562
834;"13.04.2008";24;"54.7";892;48942;48050
835;"14.04.2008";1;"45.1";757;45473;44716
835;"14.04.2008";2;40;726;43826;43100
835;"14.04.2008";3;"38.3";743;43338;42595
835;"14.04.2008";4;"37.3";609;44264;43655
835;"14.04.2008";5;"42.5";600;46292;45692
835;"14.04.2008";6;"51.8";693;50348;49655
835;"14.04.2008";7;"65.7";874;57948;57074
835;"14.04.2008";8;100;1111;63749;62638
835;"14.04.2008";9;"100.1";1218;67023;65805
835;"14.04.2008";10;"110.9";1299;67844;66545
835;"14.04.2008";11;"126.6";1247;68675;67428
835;"14.04.2008";12;138;1143;69631;68488
835;"14.04.2008";13;"116.4";1163;68949;67786
835;"14.04.2008";14;105;1341;68292;66951
835;"14.04.2008";15;"93.9";1276;67492;66216
835;"14.04.2008";16;"82.3";1393;66962;65569
835;"14.04.2008";17;"77.1";1565;65440;63875
835;"14.04.2008";18;"73.6";1696;65230;63534
835;"14.04.2008";19;"74.2";1867;65337;63470
835;"14.04.2008";20;"81.5";1921;65386;63465
835;"14.04.2008";21;95;1523;64796;63273
835;"14.04.2008";22;"83.9";1477;62964;61487
835;"14.04.2008";23;"69.4";1372;60082;58710
835;"14.04.2008";24;"55.1";1440;55405;53965
836;"15.04.2008";1;"56.9";1556;51822;50266
836;"15.04.2008";2;"53.2";1430;49644;48214
836;"15.04.2008";3;48;1433;48754;47321
836;"15.04.2008";4;"44.9";1384;49397;48013
836;"15.04.2008";5;"46.1";1287;51089;49802
836;"15.04.2008";6;"58.2";1225;54329;53104
836;"15.04.2008";7;"77.9";1220;60733;59513
836;"15.04.2008";8;"107.9";1288;64829;63541
836;"15.04.2008";9;126;1249;67712;66463
836;"15.04.2008";10;"119.3";1192;68096;66904
836;"15.04.2008";11;"118.6";1298;69331;68033
836;"15.04.2008";12;"110.9";1310;70431;69121
836;"15.04.2008";13;"97.7";1380;69618;68238
836;"15.04.2008";14;"92.9";1552;68732;67180
836;"15.04.2008";15;90;1840;67776;65936
836;"15.04.2008";16;"79.1";2069;66701;64632
836;"15.04.2008";17;"73.7";2307;65116;62809
836;"15.04.2008";18;"67.4";2219;64713;62494
836;"15.04.2008";19;"73.5";2153;64479;62326
836;"15.04.2008";20;"74.5";1898;64079;62181
836;"15.04.2008";21;"85.6";1605;64044;62439
836;"15.04.2008";22;"81.1";1480;63034;61554
836;"15.04.2008";23;"66.2";1530;60619;59089
836;"15.04.2008";24;54;1639;56172;54533
837;"16.04.2008";1;"55.3";1669;52549;50880
837;"16.04.2008";2;"50.5";1734;50315;48581
837;"16.04.2008";3;"47.1";1727;49468;47741
837;"16.04.2008";4;"45.9";1758;50102;48344
837;"16.04.2008";5;"45.1";1827;51690;49863
837;"16.04.2008";6;"52.9";1907;54855;52948
837;"16.04.2008";7;"58.3";1792;59948;58156
837;"16.04.2008";8;"82.3";1540;64620;63080
837;"16.04.2008";9;"109.1";1158;66698;65540
837;"16.04.2008";10;115;1122;66867;65745
837;"16.04.2008";11;"129.5";1390;67911;66521
837;"16.04.2008";12;153;1482;68847;67365
837;"16.04.2008";13;"105.1";1605;68187;66582
837;"16.04.2008";14;"93.5";1840;67591;65751
837;"16.04.2008";15;94;1956;66162;64206
837;"16.04.2008";16;"83.5";2137;65555;63418
837;"16.04.2008";17;"83.5";2229;64122;61893
837;"16.04.2008";18;"80.5";1971;63452;61481
837;"16.04.2008";19;"78.4";1780;63272;61492
837;"16.04.2008";20;"83.5";1471;63136;61665
837;"16.04.2008";21;91;1390;63371;61981
837;"16.04.2008";22;"71.2";1407;62557;61150
837;"16.04.2008";23;"65.9";1433;60219;58786
837;"16.04.2008";24;"53.8";1391;56149;54758
838;"17.04.2008";1;"63.9";1271;52768;51497
838;"17.04.2008";2;"55.9";1233;50411;49178
838;"17.04.2008";3;"52.3";1205;49731;48526
838;"17.04.2008";4;"49.2";1077;49953;48876
838;"17.04.2008";5;"50.4";1055;51764;50709
838;"17.04.2008";6;"58.6";1133;54623;53490
838;"17.04.2008";7;70;1123;59838;58715
838;"17.04.2008";8;"93.8";941;64320;63379
838;"17.04.2008";9;"108.9";859;66660;65801
838;"17.04.2008";10;"120.1";822;66805;65983
838;"17.04.2008";11;129;1167;67595;66428
838;"17.04.2008";12;129;1559;68716;67157
838;"17.04.2008";13;"109.9";1698;67454;65756
838;"17.04.2008";14;"100.1";1941;66992;65051
838;"17.04.2008";15;"95.6";2280;65746;63466
838;"17.04.2008";16;89;2516;64597;62081
838;"17.04.2008";17;82;2877;63190;60313
838;"17.04.2008";18;"75.2";3242;62619;59377
838;"17.04.2008";19;"83.5";3378;62963;59585
838;"17.04.2008";20;"82.1";3533;63033;59500
838;"17.04.2008";21;"85.2";3483;63295;59812
838;"17.04.2008";22;"75.4";3621;62507;58886
838;"17.04.2008";23;"67.3";3447;59649;56202
838;"17.04.2008";24;"55.1";3445;55239;51794
839;"18.04.2008";1;"61.3";3159;51495;48336
839;"18.04.2008";2;"55.2";2793;49546;46753
839;"18.04.2008";3;"51.6";2733;48699;45966
839;"18.04.2008";4;49;2652;49036;46384
839;"18.04.2008";5;51;2634;50842;48208
839;"18.04.2008";6;"59.3";2677;53920;51243
839;"18.04.2008";7;"70.9";2615;59811;57196
839;"18.04.2008";8;"93.9";2562;64182;61620
839;"18.04.2008";9;"101.4";2741;67099;64358
839;"18.04.2008";10;110;3095;67232;64137
839;"18.04.2008";11;"116.6";3041;67747;64706
839;"18.04.2008";12;"119.9";3010;68102;65092
839;"18.04.2008";13;100;3232;66718;63486
839;"18.04.2008";14;"89.1";3743;65306;61563
839;"18.04.2008";15;81;4489;63614;59125
839;"18.04.2008";16;74;4985;62643;57658
839;"18.04.2008";17;"65.9";5289;61589;56300
839;"18.04.2008";18;"65.9";5574;61469;55895
839;"18.04.2008";19;"68.1";5648;61630;55982
839;"18.04.2008";20;62;5641;61326;55685
839;"18.04.2008";21;68;5372;60868;55496
839;"18.04.2008";22;"67.7";5916;60452;54536
839;"18.04.2008";23;"59.2";6688;58113;51425
839;"18.04.2008";24;"49.7";6863;54556;47693
840;"19.04.2008";1;"54.7";6952;51134;44182
840;"19.04.2008";2;"52.3";6906;49279;42373
840;"19.04.2008";3;"45.9";6886;47988;41102
840;"19.04.2008";4;"43.6";6651;47823;41172
840;"19.04.2008";5;44;6615;48197;41582
840;"19.04.2008";6;"44.1";6649;48094;41445
840;"19.04.2008";7;"43.6";6734;48093;41359
840;"19.04.2008";8;"43.2";6527;50266;43739
840;"19.04.2008";9;"54.1";6643;54429;47786
840;"19.04.2008";10;"66.1";7500;58149;50649
840;"19.04.2008";11;"69.5";7907;60198;52291
840;"19.04.2008";12;"70.8";7932;60711;52779
840;"19.04.2008";13;"70.1";7579;58882;51303
840;"19.04.2008";14;62;6974;56645;49671
840;"19.04.2008";15;"54.7";6767;54863;48096
840;"19.04.2008";16;"53.6";6386;53971;47585
840;"19.04.2008";17;"51.5";6092;53210;47118
840;"19.04.2008";18;"53.8";5307;53642;48335
840;"19.04.2008";19;"57.9";4511;54243;49732
840;"19.04.2008";20;"56.5";3673;53866;50193
840;"19.04.2008";21;"61.8";2918;53572;50654
840;"19.04.2008";22;"62.3";2529;52994;50465
840;"19.04.2008";23;"67.9";2326;52307;49981
840;"19.04.2008";24;"53.8";2195;48745;46550
841;"20.04.2008";1;"40.7";2029;45329;43300
841;"20.04.2008";2;36;1902;43390;41488
841;"20.04.2008";3;"30.9";1734;42283;40549
841;"20.04.2008";4;"30.8";1741;42342;40601
841;"20.04.2008";5;"32.4";1858;42945;41087
841;"20.04.2008";6;"32.9";2048;42702;40654
841;"20.04.2008";7;"26.1";2122;40589;38467
841;"20.04.2008";8;"30.6";1939;41909;39970
841;"20.04.2008";9;"45.1";1828;45009;43181
841;"20.04.2008";10;"45.1";1953;46889;44936
841;"20.04.2008";11;"53.7";2350;49319;46969
841;"20.04.2008";12;"61.2";2580;51267;48687
841;"20.04.2008";13;"57.2";2931;49908;46977
841;"20.04.2008";14;"48.1";2993;47193;44200
841;"20.04.2008";15;46;2870;44846;41976
841;"20.04.2008";16;"43.3";2940;43603;40663
841;"20.04.2008";17;"38.5";3115;43366;40251
841;"20.04.2008";18;"43.8";3456;44889;41433
841;"20.04.2008";19;"48.3";3754;47693;43939
841;"20.04.2008";20;"57.8";3890;49185;45295
841;"20.04.2008";21;"62.5";3784;50703;46919
841;"20.04.2008";22;"60.3";4490;52249;47759
841;"20.04.2008";23;"62.3";4829;52200;47371
841;"20.04.2008";24;"51.4";4673;48433;43760
842;"21.04.2008";1;45;4739;46004;41265
842;"21.04.2008";2;"34.4";5283;44512;39229
842;"21.04.2008";3;"30.3";5898;44071;38173
842;"21.04.2008";4;"30.7";6107;44970;38863
842;"21.04.2008";5;"38.7";5990;46920;40930
842;"21.04.2008";6;"45.1";5989;50436;44447
842;"21.04.2008";7;"62.8";6230;56891;50661
842;"21.04.2008";8;"92.3";5622;62474;56852
842;"21.04.2008";9;"93.9";4779;65621;60842
842;"21.04.2008";10;90;5499;65925;60426
842;"21.04.2008";11;"94.3";8016;67869;59853
842;"21.04.2008";12;100;10029;69758;59729
842;"21.04.2008";13;"89.1";11142;69379;58237
842;"21.04.2008";14;"79.8";11436;69209;57773
842;"21.04.2008";15;"78.2";12072;68478;56406
842;"21.04.2008";16;"74.9";12499;67505;55006
842;"21.04.2008";17;"65.2";12616;65957;53341
842;"21.04.2008";18;"62.6";12577;65714;53137
842;"21.04.2008";19;"64.1";12201;65726;53525
842;"21.04.2008";20;"68.7";11140;65281;54141
842;"21.04.2008";21;81;9897;64317;54420
842;"21.04.2008";22;"68.3";9117;63235;54118
842;"21.04.2008";23;55;9125;60069;50944
842;"21.04.2008";24;"48.2";8873;55323;46450
843;"22.04.2008";1;"38.6";8805;52112;43307
843;"22.04.2008";2;"30.6";8672;49803;41131
843;"22.04.2008";3;"29.5";8484;48861;40377
843;"22.04.2008";4;"30.3";8439;49257;40818
843;"22.04.2008";5;"30.7";8396;50916;42520
843;"22.04.2008";6;"45.4";8164;54183;46019
843;"22.04.2008";7;"55.9";7720;60070;52350
843;"22.04.2008";8;80;7275;65266;57991
843;"22.04.2008";9;78;6790;67952;61162
843;"22.04.2008";10;"82.5";6871;68309;61438
843;"22.04.2008";11;"83.5";7755;69700;61945
843;"22.04.2008";12;"89.7";9118;71540;62422
843;"22.04.2008";13;87;9980;71038;61058
843;"22.04.2008";14;82;10032;70650;60618
843;"22.04.2008";15;75;9753;69509;59756
843;"22.04.2008";16;"64.2";9100;68210;59110
843;"22.04.2008";17;"58.6";8334;66486;58152
843;"22.04.2008";18;"55.5";7738;65646;57908
843;"22.04.2008";19;64;6961;65362;58401
843;"22.04.2008";20;68;6154;64574;58420
843;"22.04.2008";21;"73.4";5661;63863;58202
843;"22.04.2008";22;"67.9";5691;62665;56974
843;"22.04.2008";23;61;4810;58895;54085
843;"22.04.2008";24;"51.4";4168;54273;50105
844;"23.04.2008";1;"49.2";3613;50010;46397
844;"23.04.2008";2;"43.7";3229;47599;44370
844;"23.04.2008";3;33;3096;46881;43785
844;"23.04.2008";4;"30.2";2988;48045;45057
844;"23.04.2008";5;"32.5";2631;49699;47068
844;"23.04.2008";6;"52.2";2237;52510;50273
844;"23.04.2008";7;"56.3";1939;58400;56461
844;"23.04.2008";8;"69.7";1530;63310;61780
844;"23.04.2008";9;"81.5";937;65700;64763
844;"23.04.2008";10;"87.5";673;65374;64701
844;"23.04.2008";11;"92.6";655;66223;65568
844;"23.04.2008";12;"102.1";773;67102;66329
844;"23.04.2008";13;"86.1";908;66152;65244
844;"23.04.2008";14;"85.1";1025;65766;64741
844;"23.04.2008";15;"80.9";1017;64900;63883
844;"23.04.2008";16;"75.9";949;63688;62739
844;"23.04.2008";17;"71.8";880;62107;61227
844;"23.04.2008";18;"68.9";794;61466;60672
844;"23.04.2008";19;"67.6";823;61621;60798
844;"23.04.2008";20;68;1074;61444;60370
844;"23.04.2008";21;"74.3";1557;61457;59900
844;"23.04.2008";22;"68.9";2232;61208;58976
844;"23.04.2008";23;"60.1";2801;57894;55093
844;"23.04.2008";24;52;2823;53137;50314
845;"24.04.2008";1;"54.4";2816;49142;46326
845;"24.04.2008";2;"51.5";2633;47017;44384
845;"24.04.2008";3;45;2341;45973;43632
845;"24.04.2008";4;"40.6";2039;46453;44414
845;"24.04.2008";5;"47.2";1735;48109;46374
845;"24.04.2008";6;"55.2";1502;51785;50283
845;"24.04.2008";7;"69.6";1278;58216;56938
845;"24.04.2008";8;"85.9";1005;62884;61879
845;"24.04.2008";9;"92.9";691;65532;64841
845;"24.04.2008";10;93;466;65704;65238
845;"24.04.2008";11;"92.1";428;66244;65816
845;"24.04.2008";12;96;609;67506;66897
845;"24.04.2008";13;"89.7";732;66734;66002
845;"24.04.2008";14;"83.9";759;65952;65193
845;"24.04.2008";15;"79.4";834;64524;63690
845;"24.04.2008";16;"72.9";931;63567;62636
845;"24.04.2008";17;"66.3";872;62086;61214
845;"24.04.2008";18;65;863;61668;60805
845;"24.04.2008";19;"67.8";846;62075;61229
845;"24.04.2008";20;"68.3";868;62087;61219
845;"24.04.2008";21;"72.6";1185;61747;60562
845;"24.04.2008";22;69;2254;61484;59230
845;"24.04.2008";23;"62.7";2583;57962;55379
845;"24.04.2008";24;"54.5";2668;53091;50423
846;"25.04.2008";1;54;2781;48863;46082
846;"25.04.2008";2;"48.5";2868;46687;43819
846;"25.04.2008";3;"43.9";2836;45891;43055
846;"25.04.2008";4;"36.5";3190;46456;43266
846;"25.04.2008";5;"36.1";3627;48927;45300
846;"25.04.2008";6;44;3177;51918;48741
846;"25.04.2008";7;"54.1";3232;57353;54121
846;"25.04.2008";8;69;2987;62720;59733
846;"25.04.2008";9;74;2613;66143;63530
846;"25.04.2008";10;"78.1";2595;66275;63680
846;"25.04.2008";11;80;2844;66928;64084
846;"25.04.2008";12;"81.9";3167;67681;64514
846;"25.04.2008";13;76;3553;66455;62902
846;"25.04.2008";14;"68.1";4077;64916;60839
846;"25.04.2008";15;"64.1";4029;63142;59113
846;"25.04.2008";16;"57.7";4167;61865;57698
846;"25.04.2008";17;"56.1";3873;60757;56884
846;"25.04.2008";18;"56.1";3258;60780;57522
846;"25.04.2008";19;"59.3";3001;60579;57578
846;"25.04.2008";20;"59.8";1911;60136;58225
846;"25.04.2008";21;62;1481;59097;57616
846;"25.04.2008";22;64;1110;59146;58036
846;"25.04.2008";23;"63.3";1104;56672;55568
846;"25.04.2008";24;"54.6";1155;52187;51032
847;"26.04.2008";1;"59.2";1018;48959;47941
847;"26.04.2008";2;"51.2";964;46489;45525
847;"26.04.2008";3;"41.3";903;45474;44571
847;"26.04.2008";4;"43.1";829;45614;44785
847;"26.04.2008";5;"41.9";730;46306;45576
847;"26.04.2008";6;"47.6";584;46312;45728
847;"26.04.2008";7;44;623;46118;45495
847;"26.04.2008";8;"55.9";642;48335;47693
847;"26.04.2008";9;"58.2";576;52258;51682
847;"26.04.2008";10;70;396;54727;54331
847;"26.04.2008";11;70;456;55666;55210
847;"26.04.2008";12;75;607;56112;55505
847;"26.04.2008";13;"71.4";757;54482;53725
847;"26.04.2008";14;60;807;52029;51222
847;"26.04.2008";15;"53.8";809;50063;49254
847;"26.04.2008";16;"51.2";724;49057;48333
847;"26.04.2008";17;"51.2";635;48624;47989
847;"26.04.2008";18;"51.9";502;49513;49011
847;"26.04.2008";19;"56.3";418;50663;50245
847;"26.04.2008";20;55;391;50600;50209
847;"26.04.2008";21;54;480;50327;49847
847;"26.04.2008";22;"54.9";738;51043;50305
847;"26.04.2008";23;"56.3";1073;50167;49094
847;"26.04.2008";24;49;1631;46515;44884
848;"27.04.2008";1;"49.1";1978;42640;40662
848;"27.04.2008";2;"35.9";2258;40617;38359
848;"27.04.2008";3;"29.4";2209;39569;37360
848;"27.04.2008";4;29;2133;39107;36974
848;"27.04.2008";5;"30.6";2216;39821;37605
848;"27.04.2008";6;"30.9";2215;39870;37655
848;"27.04.2008";7;"16.7";2209;38804;36595
848;"27.04.2008";8;"26.4";2155;40629;38474
848;"27.04.2008";9;"40.3";1458;43660;42202
848;"27.04.2008";10;"49.1";954;45451;44497
848;"27.04.2008";11;56;1153;46948;45795
848;"27.04.2008";12;61;1547;48835;47288
848;"27.04.2008";13;"59.9";1755;47418;45663
848;"27.04.2008";14;48;1760;44896;43136
848;"27.04.2008";15;"38.6";1826;43024;41198
848;"27.04.2008";16;"35.4";1929;42300;40371
848;"27.04.2008";17;32;2102;42322;40220
848;"27.04.2008";18;"35.4";2219;44016;41797
848;"27.04.2008";19;"43.2";2202;46465;44263
848;"27.04.2008";20;"48.5";2259;47597;45338
848;"27.04.2008";21;"55.3";2604;48869;46265
848;"27.04.2008";22;58;3480;51109;47629
848;"27.04.2008";23;"60.6";4463;50570;46107
848;"27.04.2008";24;47;5448;46747;41299
849;"28.04.2008";1;"38.7";5954;44243;38289
849;"28.04.2008";2;"28.3";5955;42796;36841
849;"28.04.2008";3;18;5837;42130;36293
849;"28.04.2008";4;15;5514;42502;36988
849;"28.04.2008";5;"25.1";5408;44398;38990
849;"28.04.2008";6;"39.6";5464;48144;42680
849;"28.04.2008";7;"51.5";5426;55378;49952
849;"28.04.2008";8;"72.1";4600;61360;56760
849;"28.04.2008";9;"77.2";3175;64457;61282
849;"28.04.2008";10;"79.9";2756;64988;62232
849;"28.04.2008";11;"84.7";3218;66103;62885
849;"28.04.2008";12;95;3959;67823;63864
849;"28.04.2008";13;"86.9";4856;67580;62724
849;"28.04.2008";14;85;4753;67146;62393
849;"28.04.2008";15;"80.1";4260;66213;61953
849;"28.04.2008";16;"81.2";3953;65527;61574
849;"28.04.2008";17;"72.3";3984;64133;60149
849;"28.04.2008";18;"75.9";3918;64165;60247
849;"28.04.2008";19;"77.2";3884;64148;60264
849;"28.04.2008";20;"78.3";3886;63489;59603
849;"28.04.2008";21;"83.6";3995;62457;58462
849;"28.04.2008";22;"78.3";3592;61571;57979
849;"28.04.2008";23;"64.4";3171;57822;54651
849;"28.04.2008";24;"53.2";2415;52646;50231
850;"29.04.2008";1;"50.2";1965;48547;46582
850;"29.04.2008";2;45;1835;46681;44846
850;"29.04.2008";3;"38.7";1751;45841;44090
850;"29.04.2008";4;36;1541;46409;44868
850;"29.04.2008";5;"38.8";1384;47742;46358
850;"29.04.2008";6;"49.3";1390;50969;49579
850;"29.04.2008";7;"63.9";1515;57531;56016
850;"29.04.2008";8;80;1438;63144;61706
850;"29.04.2008";9;"85.5";1372;66160;64788
850;"29.04.2008";10;"90.6";1581;66448;64867
850;"29.04.2008";11;95;1900;67746;65846
850;"29.04.2008";12;"104.9";2067;68829;66762
850;"29.04.2008";13;"90.9";2191;67990;65799
850;"29.04.2008";14;"89.9";2091;67128;65037
850;"29.04.2008";15;"85.2";1971;65869;63898
850;"29.04.2008";16;"77.3";1730;64482;62752
850;"29.04.2008";17;"73.1";1671;62649;60978
850;"29.04.2008";18;"72.2";1559;61796;60237
850;"29.04.2008";19;70;1345;61717;60372
850;"29.04.2008";20;"63.1";1173;61174;60001
850;"29.04.2008";21;"72.1";1211;60465;59254
850;"29.04.2008";22;"70.7";1523;60586;59063
850;"29.04.2008";23;"62.2";2083;57270;55187
850;"29.04.2008";24;"51.5";2454;52422;49968
851;"30.04.2008";1;"43.4";2497;48671;46174
851;"30.04.2008";2;"32.1";2475;46454;43979
851;"30.04.2008";3;"23.2";2489;45659;43170
851;"30.04.2008";4;"16.1";2482;46236;43754
851;"30.04.2008";5;24;2506;48058;45552
851;"30.04.2008";6;"33.7";2574;51408;48834
851;"30.04.2008";7;"52.1";2809;57153;54344
851;"30.04.2008";8;72;2618;62135;59517
851;"30.04.2008";9;84;2252;64666;62414
851;"30.04.2008";10;"85.1";2111;64356;62245
851;"30.04.2008";11;"90.1";2770;64423;61653
851;"30.04.2008";12;"90.1";3460;65227;61767
851;"30.04.2008";13;"84.5";4351;64586;60235
851;"30.04.2008";14;76;4784;64231;59447
851;"30.04.2008";15;71;5046;63263;58217
851;"30.04.2008";16;"65.3";5256;62436;57180
851;"30.04.2008";17;"59.9";5100;61278;56178
851;"30.04.2008";18;"60.9";4732;60769;56037
851;"30.04.2008";19;"61.2";4358;60342;55984
851;"30.04.2008";20;61;4009;59562;55553
851;"30.04.2008";21;68;3870;58142;54272
851;"30.04.2008";22;"69.1";3348;56868;53520
851;"30.04.2008";23;"63.1";3692;53867;50175
851;"30.04.2008";24;"53.7";4215;49951;45736
852;"01.05.2008";1;"38.2";4271;46154;41883
852;"01.05.2008";2;"34.3";4005;43728;39723
852;"01.05.2008";3;"29.9";3805;42002;38197
852;"01.05.2008";4;27;3695;41442;37747
852;"01.05.2008";5;"16.1";3447;41502;38055
852;"01.05.2008";6;"13.3";3448;40202;36754
852;"01.05.2008";7;"4.2";3481;38054;34573
852;"01.05.2008";8;"13.5";3212;39902;36690
852;"01.05.2008";9;18;2978;42780;39802
852;"01.05.2008";10;"30.1";2943;43965;41022
852;"01.05.2008";11;"30.1";2644;45200;42556
852;"01.05.2008";12;30;2601;46679;44078
852;"01.05.2008";13;38;2898;45823;42925
852;"01.05.2008";14;30;2806;43822;41016
852;"01.05.2008";15;"26.2";2604;42465;39861
852;"01.05.2008";16;"20.1";2658;41839;39181
852;"01.05.2008";17;"21.1";2242;41502;39260
852;"01.05.2008";18;"26.3";2092;42774;40682
852;"01.05.2008";19;"30.1";1764;44055;42291
852;"01.05.2008";20;"32.1";1720;44779;43059
852;"01.05.2008";21;"33.5";1378;45001;43623
852;"01.05.2008";22;"46.2";1129;47182;46053
852;"01.05.2008";23;"50.1";1192;46253;45061
852;"01.05.2008";24;"39.2";1018;42177;41159
853;"02.05.2008";1;"21.6";957;39220;38263
853;"02.05.2008";2;"5.4";987;37547;36560
853;"02.05.2008";3;"4.9";987;37114;36127
853;"02.05.2008";4;5;1149;37512;36363
853;"02.05.2008";5;"15.1";1160;39125;37965
853;"02.05.2008";6;"29.6";1122;41348;40226
853;"02.05.2008";7;"29.5";1045;45861;44816
853;"02.05.2008";8;"46.4";913;50856;49943
853;"02.05.2008";9;58;484;54393;53909
853;"02.05.2008";10;"62.2";391;55747;55356
853;"02.05.2008";11;68;445;56454;56009
853;"02.05.2008";12;72;605;57760;57155
853;"02.05.2008";13;"67.9";697;57443;56746
853;"02.05.2008";14;"62.5";996;56061;55065
853;"02.05.2008";15;"56.9";1463;54913;53450
853;"02.05.2008";16;"54.7";1376;53873;52497
853;"02.05.2008";17;"53.4";1737;53311;51574
853;"02.05.2008";18;"55.5";1744;53701;51957
853;"02.05.2008";19;"56.6";1294;54163;52869
853;"02.05.2008";20;54;1024;53624;52600
853;"02.05.2008";21;"55.5";631;52173;51542
853;"02.05.2008";22;55;570;53083;52513
853;"02.05.2008";23;"50.6";656;50992;50336
853;"02.05.2008";24;"35.7";771;46741;45970
854;"03.05.2008";1;64;662;43386;42724
854;"03.05.2008";2;58;710;41945;41235
854;"03.05.2008";3;"49.2";765;40790;40025
854;"03.05.2008";4;"46.8";774;41114;40340
854;"03.05.2008";5;"43.1";802;41769;40967
854;"03.05.2008";6;"45.1";937;42128;41191
854;"03.05.2008";7;"45.9";829;42149;41320
854;"03.05.2008";8;"58.9";587;44920;44333
854;"03.05.2008";9;"65.4";221;48687;48466
854;"03.05.2008";10;"72.2";168;51072;50904
854;"03.05.2008";11;"72.2";199;51823;51624
854;"03.05.2008";12;"73.9";270;52549;52279
854;"03.05.2008";13;70;317;51428;51111
854;"03.05.2008";14;"66.2";383;49433;49050
854;"03.05.2008";15;"59.9";441;47853;47412
854;"03.05.2008";16;"57.8";585;46887;46302
854;"03.05.2008";17;56;610;46327;45717
854;"03.05.2008";18;"56.1";654;47495;46841
854;"03.05.2008";19;"58.7";698;48559;47861
854;"03.05.2008";20;60;779;48581;47802
854;"03.05.2008";21;"58.9";991;47547;46556
854;"03.05.2008";22;"64.2";1438;48701;47263
854;"03.05.2008";23;"66.6";1718;47349;45631
854;"03.05.2008";24;"57.9";1812;43536;41724
855;"04.05.2008";1;"38.2";1954;40433;38479
855;"04.05.2008";2;"29.7";1954;38523;36569
855;"04.05.2008";3;"23.2";1818;37432;35614
855;"04.05.2008";4;"25.1";1713;37794;36081
855;"04.05.2008";5;"28.5";1649;38223;36574
855;"04.05.2008";6;"29.4";1618;38063;36445
855;"04.05.2008";7;18;1652;37238;35586
855;"04.05.2008";8;"27.1";1484;39250;37766
855;"04.05.2008";9;"38.2";718;42445;41727
855;"04.05.2008";10;"45.5";447;44061;43614
855;"04.05.2008";11;"53.4";668;45719;45051
855;"04.05.2008";12;"57.5";958;47651;46693
855;"04.05.2008";13;"50.5";1052;46464;45412
855;"04.05.2008";14;"43.1";1041;43900;42859
855;"04.05.2008";15;"37.2";1083;42024;40941
855;"04.05.2008";16;35;1093;41098;40005
855;"04.05.2008";17;"33.4";1340;41337;39997
855;"04.05.2008";18;"39.5";1396;43286;41890
855;"04.05.2008";19;"46.5";1464;45438;43974
855;"04.05.2008";20;52;1552;46615;45063
855;"04.05.2008";21;"58.6";1840;47142;45302
855;"04.05.2008";22;63;2414;49256;46842
855;"04.05.2008";23;"63.1";2837;48554;45717
855;"04.05.2008";24;"47.5";3151;44610;41459
856;"05.05.2008";1;38;3209;42620;39411
856;"05.05.2008";2;"29.8";2896;41252;38356
856;"05.05.2008";3;"27.1";2317;40334;38017
856;"05.05.2008";4;"27.1";1912;40872;38960
856;"05.05.2008";5;30;1571;42721;41150
856;"05.05.2008";6;"45.1";1380;46213;44833
856;"05.05.2008";7;"58.7";1397;53783;52386
856;"05.05.2008";8;85;1067;60210;59143
856;"05.05.2008";9;"85.1";426;63169;62743
856;"05.05.2008";10;"84.9";257;63339;63082
856;"05.05.2008";11;"85.1";458;63922;63464
856;"05.05.2008";12;"90.1";878;65213;64335
856;"05.05.2008";13;90;1041;64900;63859
856;"05.05.2008";14;"85.1";1209;64417;63208
856;"05.05.2008";15;"82.6";1337;63435;62098
856;"05.05.2008";16;"79.8";1568;62603;61035
856;"05.05.2008";17;"75.9";1686;61163;59477
856;"05.05.2008";18;"73.3";1965;60975;59010
856;"05.05.2008";19;"75.1";2005;61207;59202
856;"05.05.2008";20;"71.3";2010;60713;58703
856;"05.05.2008";21;"74.1";1950;59119;57169
856;"05.05.2008";22;"69.9";2325;59572;57247
856;"05.05.2008";23;"63.1";2937;56003;53066
856;"05.05.2008";24;"53.7";3210;51055;47845
857;"06.05.2008";1;"48.4";3175;47204;44029
857;"06.05.2008";2;"40.1";2836;45240;42404
857;"06.05.2008";3;"30.8";2456;44424;41968
857;"06.05.2008";4;27;2195;44582;42387
857;"06.05.2008";5;"30.8";2166;46033;43867
857;"06.05.2008";6;"49.1";2225;49697;47472
857;"06.05.2008";7;"60.1";2090;55903;53813
857;"06.05.2008";8;"83.4";1546;61431;59885
857;"06.05.2008";9;90;709;64179;63470
857;"06.05.2008";10;"87.6";612;64249;63637
857;"06.05.2008";11;88;794;65032;64238
857;"06.05.2008";12;"89.3";1090;66281;65191
857;"06.05.2008";13;86;1163;65483;64320
857;"06.05.2008";14;"84.2";1159;64874;63715
857;"06.05.2008";15;"82.2";1179;63709;62530
857;"06.05.2008";16;"80.6";1288;63000;61712
857;"06.05.2008";17;"74.1";1369;61540;60171
857;"06.05.2008";18;"70.3";1441;61492;60051
857;"06.05.2008";19;"69.6";1484;61420;59936
857;"06.05.2008";20;"66.9";1622;61156;59534
857;"06.05.2008";21;69;1604;59353;57749
857;"06.05.2008";22;"67.5";2012;59462;57450
857;"06.05.2008";23;"64.1";2206;55888;53682
857;"06.05.2008";24;"55.8";2252;50823;48571
858;"07.05.2008";1;"48.8";2037;47461;45424
858;"07.05.2008";2;"42.5";1631;45488;43857
858;"07.05.2008";3;"31.6";1340;44521;43181
858;"07.05.2008";4;30;1070;44700;43630
858;"07.05.2008";5;"31.1";881;46121;45240
858;"07.05.2008";6;"49.1";795;49461;48666
858;"07.05.2008";7;"60.1";773;56061;55288
858;"07.05.2008";8;74;638;61618;60980
858;"07.05.2008";9;85;358;64267;63909
858;"07.05.2008";10;"85.1";241;64206;63965
858;"07.05.2008";11;"86.7";263;64976;64713
858;"07.05.2008";12;"89.1";292;66144;65852
858;"07.05.2008";13;89;360;65242;64882
858;"07.05.2008";14;"86.7";394;64653;64259
858;"07.05.2008";15;"85.2";434;63334;62900
858;"07.05.2008";16;"81.1";502;62133;61631
858;"07.05.2008";17;"73.8";631;61063;60432
858;"07.05.2008";18;"69.9";763;60923;60160
858;"07.05.2008";19;"69.1";796;61297;60501
858;"07.05.2008";20;"67.9";849;60831;59982
858;"07.05.2008";21;69;936;59181;58245
858;"07.05.2008";22;"68.9";1313;59302;57989
858;"07.05.2008";23;"64.1";1624;55843;54219
858;"07.05.2008";24;"54.2";1608;51022;49414
859;"08.05.2008";1;"54.1";1589;47274;45685
859;"08.05.2008";2;"44.9";1402;45048;43646
859;"08.05.2008";3;"38.8";1147;43994;42847
859;"08.05.2008";4;"30.4";884;44053;43169
859;"08.05.2008";5;"34.8";784;45205;44421
859;"08.05.2008";6;"49.1";718;48753;48035
859;"08.05.2008";7;"56.2";635;55620;54985
859;"08.05.2008";8;"78.3";516;61098;60582
859;"08.05.2008";9;"85.4";233;63529;63296
859;"08.05.2008";10;"85.1";192;63609;63417
859;"08.05.2008";11;"86.4";317;64480;64163
859;"08.05.2008";12;"92.1";466;65495;65029
859;"08.05.2008";13;"86.4";507;64744;64237
859;"08.05.2008";14;"83.6";498;63879;63381
859;"08.05.2008";15;"79.2";609;62681;62072
859;"08.05.2008";16;78;667;61918;61251
859;"08.05.2008";17;"70.1";768;60971;60203
859;"08.05.2008";18;68;808;60720;59912
859;"08.05.2008";19;"65.6";935;60936;60001
859;"08.05.2008";20;65;1102;60650;59548
859;"08.05.2008";21;69;1388;58935;57547
859;"08.05.2008";22;"69.4";2079;59114;57035
859;"08.05.2008";23;"57.8";2722;56090;53368
859;"08.05.2008";24;"40.1";2964;50970;48006
860;"09.05.2008";1;48;1826;47614;45788
860;"09.05.2008";2;"38.9";1756;45585;43829
860;"09.05.2008";3;30;2653;44482;41829
860;"09.05.2008";4;14;2390;44368;41978
860;"09.05.2008";5;"26.1";2202;45657;43455
860;"09.05.2008";6;"33.5";2055;48803;46748
860;"09.05.2008";7;"55.5";1957;55802;53845
860;"09.05.2008";8;"71.9";1487;60777;59290
860;"09.05.2008";9;"72.3";707;63553;62846
860;"09.05.2008";10;"76.5";463;64010;63547
860;"09.05.2008";11;"79.3";695;64580;63885
860;"09.05.2008";12;"82.9";1143;65236;64093
860;"09.05.2008";13;"74.9";1430;64166;62736
860;"09.05.2008";14;"69.9";1370;62540;61170
860;"09.05.2008";15;"65.4";1402;60967;59565
860;"09.05.2008";16;"61.6";1449;59624;58175
860;"09.05.2008";17;60;1623;58837;57214
860;"09.05.2008";18;"59.1";1912;59081;57169
860;"09.05.2008";19;"59.3";2209;58894;56685
860;"09.05.2008";20;"54.1";2303;58126;55823
860;"09.05.2008";21;58;2580;55703;53123
860;"09.05.2008";22;"55.6";3391;56035;52644
860;"09.05.2008";23;"53.9";4092;53797;49705
860;"09.05.2008";24;"34.2";4360;49543;45183
861;"10.05.2008";1;"37.1";4359;45739;41380
861;"10.05.2008";2;"33.5";3875;43680;39805
861;"10.05.2008";3;"32.1";3418;42735;39317
861;"10.05.2008";4;"28.4";3098;42461;39363
861;"10.05.2008";5;"20.5";2797;42416;39619
861;"10.05.2008";6;"28.1";2610;42305;39695
861;"10.05.2008";7;"13.4";2301;43409;41108
861;"10.05.2008";8;"32.1";1903;46917;45014
861;"10.05.2008";9;39;1108;50409;49301
861;"10.05.2008";10;"54.3";857;52564;51707
861;"10.05.2008";11;"56.5";1470;53175;51705
861;"10.05.2008";12;"60.5";2649;53517;50868
861;"10.05.2008";13;"54.3";3023;51822;48799
861;"10.05.2008";14;50;2876;49397;46521
861;"10.05.2008";15;"49.4";2891;47895;45004
861;"10.05.2008";16;"46.3";2865;47618;44753
861;"10.05.2008";17;45;2842;47324;44482
861;"10.05.2008";18;"46.2";2881;48286;45405
861;"10.05.2008";19;"48.5";2788;48903;46115
861;"10.05.2008";20;"48.5";2629;48569;45940
861;"10.05.2008";21;"47.8";2530;46998;44468
861;"10.05.2008";22;"46.3";2936;47586;44650
861;"10.05.2008";23;39;3350;46473;43123
861;"10.05.2008";24;38;3484;42527;39043
862;"11.05.2008";1;"19.5";3456;39401;35945
862;"11.05.2008";2;3;3096;37340;34244
862;"11.05.2008";3;"2.1";2756;36342;33586
862;"11.05.2008";4;"2.1";2473;35731;33258
862;"11.05.2008";5;2;2197;35532;33335
862;"11.05.2008";6;2;1946;35049;33103
862;"11.05.2008";7;0;1702;35494;33792
862;"11.05.2008";8;"1.1";1336;37998;36662
862;"11.05.2008";9;"29.9";689;40551;39862
862;"11.05.2008";10;"31.9";582;42418;41836
862;"11.05.2008";11;"30.6";1154;43483;42329
862;"11.05.2008";12;"38.7";2049;44730;42681
862;"11.05.2008";13;32;2603;43540;40937
862;"11.05.2008";14;"30.6";2856;41002;38146
862;"11.05.2008";15;"28.2";2819;39646;36827
862;"11.05.2008";16;"22.7";2740;38652;35912
862;"11.05.2008";17;"22.7";2622;38508;35886
862;"11.05.2008";18;"28.6";2463;39896;37433
862;"11.05.2008";19;"35.4";2275;41868;39593
862;"11.05.2008";20;"39.6";1964;42487;40523
862;"11.05.2008";21;"38.9";1747;42442;40695
862;"11.05.2008";22;40;2096;44304;42208
862;"11.05.2008";23;"38.1";2274;43808;41534
862;"11.05.2008";24;"30.5";2202;40101;37899
863;"12.05.2008";1;7;2081;37360;35279
863;"12.05.2008";2;"2.8";1875;36084;34209
863;"12.05.2008";3;"1.8";1691;35252;33561
863;"12.05.2008";4;1;1517;34837;33320
863;"12.05.2008";5;"2.1";1307;35072;33765
863;"12.05.2008";6;"5.1";1266;35159;33893
863;"12.05.2008";7;"2.5";1172;35658;34486
863;"12.05.2008";8;"21.2";952;37994;37042
863;"12.05.2008";9;"45.1";516;40491;39975
863;"12.05.2008";10;"48.6";308;42435;42127
863;"12.05.2008";11;"53.2";363;43743;43380
863;"12.05.2008";12;58;632;45250;44618
863;"12.05.2008";13;"58.9";1046;44303;43257
863;"12.05.2008";14;"49.9";1226;42387;41161
863;"12.05.2008";15;"42.6";1189;41078;39889
863;"12.05.2008";16;"38.9";1233;40524;39291
863;"12.05.2008";17;"38.9";1286;40588;39302
863;"12.05.2008";18;"45.1";1473;42373;40900
863;"12.05.2008";19;"52.9";1745;44466;42721
863;"12.05.2008";20;"54.9";1993;45087;43094
863;"12.05.2008";21;"51.5";2151;45080;42929
863;"12.05.2008";22;"55.8";2809;47051;44242
863;"12.05.2008";23;"55.9";3469;46898;43429
863;"12.05.2008";24;"39.2";3817;43059;39242
864;"13.05.2008";1;"33.5";3559;41245;37686
864;"13.05.2008";2;"24.3";3084;39404;36320
864;"13.05.2008";3;12;2818;38465;35647
864;"13.05.2008";4;"12.3";2573;38301;35728
864;"13.05.2008";5;"23.1";2500;39830;37330
864;"13.05.2008";6;"35.9";2648;43174;40526
864;"13.05.2008";7;50;2637;50940;48303
864;"13.05.2008";8;78;2232;58021;55789
864;"13.05.2008";9;"72.5";1938;61712;59774
864;"13.05.2008";10;"73.1";1771;62825;61054
864;"13.05.2008";11;"78.9";1710;64046;62336
864;"13.05.2008";12;"85.1";1932;65397;63465
864;"13.05.2008";13;"79.9";2164;64544;62380
864;"13.05.2008";14;"79.2";2367;63844;61477
864;"13.05.2008";15;"74.9";2505;63044;60539
864;"13.05.2008";16;"69.1";2611;62224;59613
864;"13.05.2008";17;"65.1";2716;60896;58180
864;"13.05.2008";18;"60.3";2906;60827;57921
864;"13.05.2008";19;"60.3";2916;60610;57694
864;"13.05.2008";20;"57.3";2944;59900;56956
864;"13.05.2008";21;"65.2";3087;57906;54819
864;"13.05.2008";22;"64.4";3573;58124;54551
864;"13.05.2008";23;59;3939;55308;51369
864;"13.05.2008";24;"45.5";3786;50208;46422
865;"14.05.2008";1;"46.3";3403;46911;43508
865;"14.05.2008";2;"38.8";2987;45093;42106
865;"14.05.2008";3;"32.4";2770;44047;41277
865;"14.05.2008";4;31;2623;44215;41592
865;"14.05.2008";5;"30.6";2415;45283;42868
865;"14.05.2008";6;"46.3";2271;47900;45629
865;"14.05.2008";7;"60.4";1901;54120;52219
865;"14.05.2008";8;77;1184;60106;58922
865;"14.05.2008";9;"80.1";792;63128;62336
865;"14.05.2008";10;84;604;63286;62682
865;"14.05.2008";11;"87.7";603;64395;63792
865;"14.05.2008";12;"93.9";650;65747;65097
865;"14.05.2008";13;"92.9";623;64685;64062
865;"14.05.2008";14;"89.9";606;64364;63758
865;"14.05.2008";15;84;540;63485;62945
865;"14.05.2008";16;"80.1";513;62568;62055
865;"14.05.2008";17;"75.9";568;61334;60766
865;"14.05.2008";18;"73.3";637;61175;60538
865;"14.05.2008";19;"74.9";747;61192;60445
865;"14.05.2008";20;70;853;60479;59626
865;"14.05.2008";21;"67.9";1089;58691;57602
865;"14.05.2008";22;"69.1";1454;58538;57084
865;"14.05.2008";23;"67.5";1694;55724;54030
865;"14.05.2008";24;"56.3";1689;51028;49339
866;"15.05.2008";1;56;1436;47632;46196
866;"15.05.2008";2;48;1171;45663;44492
866;"15.05.2008";3;"39.1";1006;44489;43483
866;"15.05.2008";4;"35.2";846;44382;43536
866;"15.05.2008";5;"35.4";782;45432;44650
866;"15.05.2008";6;"46.6";780;47877;47097
866;"15.05.2008";7;"57.5";800;54813;54013
866;"15.05.2008";8;"79.9";610;60593;59983
866;"15.05.2008";9;86;397;63631;63234
866;"15.05.2008";10;"87.2";364;64279;63915
866;"15.05.2008";11;"90.6";364;65158;64794
866;"15.05.2008";12;96;486;66507;66021
866;"15.05.2008";13;"91.3";489;65522;65033
866;"15.05.2008";14;88;750;64839;64089
866;"15.05.2008";15;"86.4";860;63996;63136
866;"15.05.2008";16;84;1076;63345;62269
866;"15.05.2008";17;"76.9";1026;62131;61105
866;"15.05.2008";18;"72.4";1191;62254;61063
866;"15.05.2008";19;"73.7";1293;62187;60894
866;"15.05.2008";20;"71.9";1241;61409;60168
866;"15.05.2008";21;"69.5";1041;59616;58575
866;"15.05.2008";22;"70.7";1026;58769;57743
866;"15.05.2008";23;66;827;55294;54467
866;"15.05.2008";24;"58.9";809;51378;50569
867;"16.05.2008";1;"48.1";721;46926;46205
867;"16.05.2008";2;"47.8";782;45648;44866
867;"16.05.2008";3;"34.1";716;44376;43660
867;"16.05.2008";4;"28.1";784;44309;43525
867;"16.05.2008";5;30;973;45542;44569
867;"16.05.2008";6;"44.3";1079;48182;47103
867;"16.05.2008";7;"60.2";958;55229;54271
867;"16.05.2008";8;75;731;61196;60465
867;"16.05.2008";9;"82.1";666;64309;63643
867;"16.05.2008";10;"84.1";706;64972;64266
867;"16.05.2008";11;"87.5";737;66323;65586
867;"16.05.2008";12;"92.4";858;67407;66549
867;"16.05.2008";13;"88.1";1044;66241;65197
867;"16.05.2008";14;84;998;64449;63451
867;"16.05.2008";15;"78.1";1103;62852;61749
867;"16.05.2008";16;"68.1";1128;61479;60351
867;"16.05.2008";17;"64.9";1349;60574;59225
867;"16.05.2008";18;64;1180;60485;59305
867;"16.05.2008";19;"65.9";1198;60140;58942
867;"16.05.2008";20;64;1109;59024;57915
867;"16.05.2008";21;"64.4";932;56862;55930
867;"16.05.2008";22;"64.5";908;56612;55704
867;"16.05.2008";23;"66.8";930;54073;53143
867;"16.05.2008";24;"57.5";978;49805;48827
868;"17.05.2008";1;"57.4";957;47402;46445
868;"17.05.2008";2;"49.2";879;45158;44279
868;"17.05.2008";3;"38.8";798;43908;43110
868;"17.05.2008";4;34;729;43529;42800
868;"17.05.2008";5;"30.6";756;43491;42735
868;"17.05.2008";6;"31.4";874;43494;42620
868;"17.05.2008";7;"38.8";1014;45558;44544
868;"17.05.2008";8;"53.9";968;48824;47856
868;"17.05.2008";9;"61.9";1109;52497;51388
868;"17.05.2008";10;"67.5";1301;55044;53743
868;"17.05.2008";11;"70.1";1390;56654;55264
868;"17.05.2008";12;72;1423;57382;55959
868;"17.05.2008";13;"75.5";1522;56030;54508
868;"17.05.2008";14;"65.1";1736;53468;51732
868;"17.05.2008";15;"62.1";2180;52068;49888
868;"17.05.2008";16;"60.1";2421;51199;48778
868;"17.05.2008";17;"56.5";2614;50680;48066
868;"17.05.2008";18;"52.3";2891;51499;48608
868;"17.05.2008";19;54;2807;52420;49613
868;"17.05.2008";20;46;2437;51833;49396
868;"17.05.2008";21;"48.9";2376;50083;47707
868;"17.05.2008";22;55;2223;49525;47302
868;"17.05.2008";23;"60.7";1974;48283;46309
868;"17.05.2008";24;"48.9";1683;45171;43488
869;"18.05.2008";1;"36.7";1478;42094;40616
869;"18.05.2008";2;"24.9";1404;39690;38286
869;"18.05.2008";3;"18.7";1339;38399;37060
869;"18.05.2008";4;16;1342;38003;36661
869;"18.05.2008";5;"16.3";1303;38077;36774
869;"18.05.2008";6;"9.1";1185;37740;36555
869;"18.05.2008";7;"2.7";1001;37837;36836
869;"18.05.2008";8;"19.9";682;39970;39288
869;"18.05.2008";9;"35.1";567;42554;41987
869;"18.05.2008";10;"44.7";662;45364;44702
869;"18.05.2008";11;"53.1";673;47580;46907
869;"18.05.2008";12;"58.4";850;50622;49772
869;"18.05.2008";13;"54.2";988;49592;48604
869;"18.05.2008";14;"47.5";1186;47243;46057
869;"18.05.2008";15;40;1361;45410;44049
869;"18.05.2008";16;"38.4";1359;44540;43181
869;"18.05.2008";17;"34.8";1506;44396;42890
869;"18.05.2008";18;"38.9";1491;45771;44280
869;"18.05.2008";19;"49.2";1395;47729;46334
869;"18.05.2008";20;"52.1";1260;48124;46864
869;"18.05.2008";21;"53.5";1067;47597;46530
869;"18.05.2008";22;"60.7";1108;48410;47302
869;"18.05.2008";23;"58.4";1198;48748;47550
869;"18.05.2008";24;"49.1";1204;45171;43967
870;"19.05.2008";1;39;1174;42716;41542
870;"19.05.2008";2;"30.6";1069;41385;40316
870;"19.05.2008";3;"28.4";908;40328;39420
870;"19.05.2008";4;27;935;40983;40048
870;"19.05.2008";5;"30.5";920;42722;41802
870;"19.05.2008";6;41;881;45385;44504
870;"19.05.2008";7;"54.3";855;53182;52327
870;"19.05.2008";8;76;686;59857;59171
870;"19.05.2008";9;"85.1";622;63677;63055
870;"19.05.2008";10;"88.8";856;64763;63907
870;"19.05.2008";11;"95.1";1008;65989;64981
870;"19.05.2008";12;"106.8";1094;67024;65930
870;"19.05.2008";13;"96.5";1248;66339;65091
870;"19.05.2008";14;94;1282;65851;64569
870;"19.05.2008";15;"86.8";1519;64891;63372
870;"19.05.2008";16;"82.6";1695;63592;61897
870;"19.05.2008";17;"79.9";1643;61921;60278
870;"19.05.2008";18;75;1710;61451;59741
870;"19.05.2008";19;"73.9";1733;61001;59268
870;"19.05.2008";20;"71.9";1848;60475;58627
870;"19.05.2008";21;"68.1";1744;58291;56547
870;"19.05.2008";22;"69.1";1723;57490;55767
870;"19.05.2008";23;"62.6";1996;55240;53244
870;"19.05.2008";24;"51.4";2102;50493;48391
871;"20.05.2008";1;"41.9";2040;47268;45228
871;"20.05.2008";2;"33.7";1906;45394;43488
871;"20.05.2008";3;"30.7";1672;44647;42975
871;"20.05.2008";4;30;1467;44770;43303
871;"20.05.2008";5;"27.1";1482;46037;44555
871;"20.05.2008";6;"35.5";1496;48461;46965
871;"20.05.2008";7;"58.8";1345;54698;53353
871;"20.05.2008";8;"74.4";911;60169;59258
871;"20.05.2008";9;"86.1";636;63571;62935
871;"20.05.2008";10;92;780;63811;63031
871;"20.05.2008";11;"95.1";884;64656;63772
871;"20.05.2008";12;"119.3";972;66027;65055
871;"20.05.2008";13;"89.4";1236;65351;64115
871;"20.05.2008";14;"86.1";1427;64693;63266
871;"20.05.2008";15;"82.4";1539;63554;62015
871;"20.05.2008";16;78;1688;62584;60896
871;"20.05.2008";17;"72.3";1911;61217;59306
871;"20.05.2008";18;"69.2";2099;61037;58938
871;"20.05.2008";19;"71.6";2208;61066;58858
871;"20.05.2008";20;"69.1";2285;60265;57980
871;"20.05.2008";21;"71.9";2209;57991;55782
871;"20.05.2008";22;"69.5";2422;57434;55012
871;"20.05.2008";23;"65.1";2790;55083;52293
871;"20.05.2008";24;"53.1";2916;50503;47587
872;"21.05.2008";1;"56.1";2907;47461;44554
872;"21.05.2008";2;48;2639;45401;42762
872;"21.05.2008";3;"37.9";2258;44572;42314
872;"21.05.2008";4;"30.3";2081;44600;42519
872;"21.05.2008";5;"35.9";1947;45837;43890
872;"21.05.2008";6;40;1823;48234;46411
872;"21.05.2008";7;"54.7";1837;55027;53190
872;"21.05.2008";8;75;1210;60347;59137
872;"21.05.2008";9;86;757;63870;63113
872;"21.05.2008";10;"89.3";866;64357;63491
872;"21.05.2008";11;"90.6";1092;65590;64498
872;"21.05.2008";12;"104.4";1273;66887;65614
872;"21.05.2008";13;"90.1";1089;66043;64954
872;"21.05.2008";14;"83.8";1064;65397;64333
872;"21.05.2008";15;"83.1";1048;64138;63090
872;"21.05.2008";16;"79.9";1174;63012;61838
872;"21.05.2008";17;"73.7";1318;61378;60060
872;"21.05.2008";18;"69.1";1433;60980;59547
872;"21.05.2008";19;72;1587;60759;59172
872;"21.05.2008";20;"68.9";1736;59584;57848
872;"21.05.2008";21;69;1763;57329;55566
872;"21.05.2008";22;69;2043;56274;54231
872;"21.05.2008";23;"59.9";2352;54181;51829
872;"21.05.2008";24;"56.6";2479;50397;47918
873;"22.05.2008";1;"54.5";2509;47209;44700
873;"22.05.2008";2;"49.3";2124;44913;42789
873;"22.05.2008";3;"40.2";1753;43435;41682
873;"22.05.2008";4;39;1766;43240;41474
873;"22.05.2008";5;"39.9";1616;43427;41811
873;"22.05.2008";6;"49.2";1487;43038;41551
873;"22.05.2008";7;"49.2";1320;43543;42223
873;"22.05.2008";8;"54.8";804;46450;45646
873;"22.05.2008";9;59;464;49265;48801
873;"22.05.2008";10;68;492;50861;50369
873;"22.05.2008";11;"82.5";619;52625;52006
873;"22.05.2008";12;"92.1";827;54700;53873
873;"22.05.2008";13;88;856;54346;53490
873;"22.05.2008";14;"71.8";861;52506;51645
873;"22.05.2008";15;"63.9";906;51262;50356
873;"22.05.2008";16;63;950;50292;49342
873;"22.05.2008";17;"61.3";1022;49937;48915
873;"22.05.2008";18;"61.2";1121;50717;49596
873;"22.05.2008";19;"64.9";1215;51539;50324
873;"22.05.2008";20;"64.8";1424;51390;49966
873;"22.05.2008";21;"67.2";1542;50203;48661
873;"22.05.2008";22;"63.4";1640;50121;48481
873;"22.05.2008";23;"64.9";1874;49458;47584
873;"22.05.2008";24;57;2063;46399;44336
874;"23.05.2008";1;"49.3";2038;43517;41479
874;"23.05.2008";2;"43.3";1761;41342;39581
874;"23.05.2008";3;27;1718;40246;38528
874;"23.05.2008";4;"22.3";1590;40395;38805
874;"23.05.2008";5;"26.1";1486;41767;40281
874;"23.05.2008";6;41;1307;44214;42907
874;"23.05.2008";7;"56.7";1191;49903;48712
874;"23.05.2008";8;"77.3";781;54946;54165
874;"23.05.2008";9;83;495;58194;57699
874;"23.05.2008";10;"87.5";573;59200;58627
874;"23.05.2008";11;"88.3";852;59702;58850
874;"23.05.2008";12;"98.9";1086;61135;60049
874;"23.05.2008";13;"98.4";1152;60800;59648
874;"23.05.2008";14;"86.1";1289;59353;58064
874;"23.05.2008";15;"83.4";1454;57949;56495
874;"23.05.2008";16;76;1600;56652;55052
874;"23.05.2008";17;"68.6";1855;55746;53891
874;"23.05.2008";18;"64.5";1874;55896;54022
874;"23.05.2008";19;"64.3";2006;55941;53935
874;"23.05.2008";20;"63.4";2225;55142;52917
874;"23.05.2008";21;63;2085;52988;50903
874;"23.05.2008";22;"63.4";2171;52426;50255
874;"23.05.2008";23;"65.2";2416;51141;48725
874;"23.05.2008";24;"57.9";2733;47374;44641
875;"24.05.2008";1;"62.1";3017;44143;41126
875;"24.05.2008";2;"58.6";3015;42978;39963
875;"24.05.2008";3;"55.9";2801;41839;39038
875;"24.05.2008";4;"51.9";2732;41340;38608
875;"24.05.2008";5;"49.3";2514;41776;39262
875;"24.05.2008";6;"45.9";2443;41603;39160
875;"24.05.2008";7;"42.2";2073;42456;40383
875;"24.05.2008";8;"50.1";1475;45342;43867
875;"24.05.2008";9;"60.8";1127;49054;47927
875;"24.05.2008";10;"67.9";1261;51456;50195
875;"24.05.2008";11;"72.3";2048;52731;50683
875;"24.05.2008";12;"76.3";2894;53504;50610
875;"24.05.2008";13;"76.1";3158;52220;49062
875;"24.05.2008";14;"66.2";3402;50287;46885
875;"24.05.2008";15;"57.9";3712;49072;45360
875;"24.05.2008";16;"55.1";3937;48391;44454
875;"24.05.2008";17;"54.1";4050;47977;43927
875;"24.05.2008";18;"56.9";4267;49277;45010
875;"24.05.2008";19;"59.7";4390;50095;45705
875;"24.05.2008";20;"59.9";4662;49781;45119
875;"24.05.2008";21;"61.9";4469;48013;43544
875;"24.05.2008";22;"61.1";4606;47860;43254
875;"24.05.2008";23;"58.8";5123;47372;42249
875;"24.05.2008";24;"41.5";5504;44080;38576
876;"25.05.2008";1;"42.1";5313;42145;36832
876;"25.05.2008";2;"34.7";4973;40381;35408
876;"25.05.2008";3;"29.1";4639;39140;34501
876;"25.05.2008";4;"23.1";4452;38371;33919
876;"25.05.2008";5;"20.1";4317;38044;33727
876;"25.05.2008";6;"13.7";4133;37819;33686
876;"25.05.2008";7;7;3638;37990;34352
876;"25.05.2008";8;11;3250;39338;36088
876;"25.05.2008";9;"33.9";3425;42105;38680
876;"25.05.2008";10;49;3431;44564;41133
876;"25.05.2008";11;"53.8";3556;46646;43090
876;"25.05.2008";12;"58.5";3653;49183;45530
876;"25.05.2008";13;"55.6";3533;48317;44784
876;"25.05.2008";14;"47.6";3508;45945;42437
876;"25.05.2008";15;"42.8";3331;44418;41087
876;"25.05.2008";16;"37.4";3142;43361;40219
876;"25.05.2008";17;"38.5";3135;43395;40260
876;"25.05.2008";18;"45.8";3384;44700;41316
876;"25.05.2008";19;"53.8";3524;46632;43108
876;"25.05.2008";20;"54.7";3809;47314;43505
876;"25.05.2008";21;"50.1";3865;46897;43032
876;"25.05.2008";22;"52.1";4197;48116;43919
876;"25.05.2008";23;"52.9";4458;48775;44317
876;"25.05.2008";24;"41.1";4565;45294;40729
877;"26.05.2008";1;"38.6";4534;42711;38177
877;"26.05.2008";2;"28.1";4570;41872;37302
877;"26.05.2008";3;"15.5";4483;41424;36941
877;"26.05.2008";4;"12.1";4191;41432;37241
877;"26.05.2008";5;"23.1";3932;42982;39050
877;"26.05.2008";6;"35.2";4135;45651;41516
877;"26.05.2008";7;"53.4";4083;53901;49818
877;"26.05.2008";8;"72.7";3738;60862;57124
877;"26.05.2008";9;"77.9";3371;64517;61146
877;"26.05.2008";10;80;3140;65924;62784
877;"26.05.2008";11;"82.1";3082;67329;64247
877;"26.05.2008";12;92;2899;68630;65731
877;"26.05.2008";13;92;2627;67978;65351
877;"26.05.2008";14;"83.4";2408;67253;64845
877;"26.05.2008";15;"80.2";2292;66046;63754
877;"26.05.2008";16;"76.1";2408;64377;61969
877;"26.05.2008";17;"70.7";2153;62325;60172
877;"26.05.2008";18;"69.4";2126;62194;60068
877;"26.05.2008";19;69;2157;61819;59662
877;"26.05.2008";20;"63.3";2221;60700;58479
877;"26.05.2008";21;67;2454;58561;56107
877;"26.05.2008";22;"66.1";2888;57679;54791
877;"26.05.2008";23;"61.5";3362;55512;52150
877;"26.05.2008";24;"50.6";3447;50699;47252
878;"27.05.2008";1;"53.1";3144;48091;44947
878;"27.05.2008";2;"38.5";3092;46025;42933
878;"27.05.2008";3;"33.5";3277;44972;41695
878;"27.05.2008";4;"20.2";3540;45223;41683
878;"27.05.2008";5;15;3690;46367;42677
878;"27.05.2008";6;"29.8";4065;48843;44778
878;"27.05.2008";7;53;4250;55716;51466
878;"27.05.2008";8;"75.1";4320;61702;57382
878;"27.05.2008";9;81;4177;64743;60566
878;"27.05.2008";10;"89.9";4395;65075;60680
878;"27.05.2008";11;"92.1";4555;66102;61547
878;"27.05.2008";12;"104.9";4804;67539;62735
878;"27.05.2008";13;"85.1";5259;67106;61847
878;"27.05.2008";14;"88.6";5376;66353;60977
878;"27.05.2008";15;"85.2";5310;65457;60147
878;"27.05.2008";16;"73.8";5467;64295;58828
878;"27.05.2008";17;"64.6";5683;62635;56952
878;"27.05.2008";18;63;5667;62505;56838
878;"27.05.2008";19;"59.6";6193;62324;56131
878;"27.05.2008";20;56;6400;61058;54658
878;"27.05.2008";21;"56.3";7053;58728;51675
878;"27.05.2008";22;"56.6";7607;57658;50051
878;"27.05.2008";23;"55.5";8561;55709;47148
878;"27.05.2008";24;"45.6";9277;51731;42454
879;"28.05.2008";1;"50.2";9610;49247;39637
879;"28.05.2008";2;"29.8";9902;47579;37677
879;"28.05.2008";3;"13.8";10151;46850;36699
879;"28.05.2008";4;"12.1";10176;47318;37142
879;"28.05.2008";5;"15.6";9948;47946;37998
879;"28.05.2008";6;"35.1";10201;50838;40637
879;"28.05.2008";7;46;9931;57866;47935
879;"28.05.2008";8;"73.9";9250;62847;53597
879;"28.05.2008";9;"72.4";9312;66209;56897
879;"28.05.2008";10;"85.1";9479;67586;58107
879;"28.05.2008";11;89;9530;68848;59318
879;"28.05.2008";12;"101.9";9838;69892;60054
879;"28.05.2008";13;"98.6";9300;69109;59809
879;"28.05.2008";14;"89.1";8484;68057;59573
879;"28.05.2008";15;84;7821;66703;58882
879;"28.05.2008";16;"76.1";7423;65697;58274
879;"28.05.2008";17;"71.9";6951;64163;57212
879;"28.05.2008";18;"70.2";6017;63611;57594
879;"28.05.2008";19;72;4811;62859;58048
879;"28.05.2008";20;"69.3";4038;61772;57734
879;"28.05.2008";21;"67.9";3596;59322;55726
879;"28.05.2008";22;"65.9";3681;58060;54379
879;"28.05.2008";23;"67.8";3776;55905;52129
879;"28.05.2008";24;"55.2";3822;51697;47875
880;"29.05.2008";1;"53.7";3835;49174;45339
880;"29.05.2008";2;"48.1";3592;46955;43363
880;"29.05.2008";3;"38.5";3242;45790;42548
880;"29.05.2008";4;"30.8";3101;45586;42485
880;"29.05.2008";5;"32.2";3115;46642;43527
880;"29.05.2008";6;"44.8";3126;49111;45985
880;"29.05.2008";7;"62.8";2992;55817;52825
880;"29.05.2008";8;"82.3";2260;61260;59000
880;"29.05.2008";9;"85.1";1742;64683;62941
880;"29.05.2008";10;"96.1";1824;65357;63533
880;"29.05.2008";11;"116.9";2178;66385;64207
880;"29.05.2008";12;"151.8";3198;67808;64610
880;"29.05.2008";13;98;3938;67073;63135
880;"29.05.2008";14;"88.7";4418;66687;62269
880;"29.05.2008";15;"90.1";4580;65791;61211
880;"29.05.2008";16;84;5056;64853;59797
880;"29.05.2008";17;"73.4";5491;63582;58091
880;"29.05.2008";18;"69.5";6005;63358;57353
880;"29.05.2008";19;"67.1";6280;63089;56809
880;"29.05.2008";20;"62.9";6242;62397;56155
880;"29.05.2008";21;"62.8";5817;59745;53928
880;"29.05.2008";22;60;5831;58520;52689
880;"29.05.2008";23;62;5848;56415;50567
880;"29.05.2008";24;"50.3";5779;52466;46687
881;"30.05.2008";1;"44.8";5362;49683;44321
881;"30.05.2008";2;"27.7";4979;47757;42778
881;"30.05.2008";3;"19.6";4444;46674;42230
881;"30.05.2008";4;"15.1";4082;46489;42407
881;"30.05.2008";5;"15.1";3945;47446;43501
881;"30.05.2008";6;31;3828;49730;45902
881;"30.05.2008";7;"53.1";3231;56285;53054
881;"30.05.2008";8;"69.6";2627;62232;59605
881;"30.05.2008";9;"79.1";2065;65705;63640
881;"30.05.2008";10;"89.3";2032;66493;64461
881;"30.05.2008";11;"104.7";2279;67221;64942
881;"30.05.2008";12;"150.1";2513;68014;65501
881;"30.05.2008";13;"90.1";2886;66966;64080
881;"30.05.2008";14;"81.5";3103;65921;62818
881;"30.05.2008";15;"80.6";3188;64533;61345
881;"30.05.2008";16;"77.9";3164;63544;60380
881;"30.05.2008";17;"72.3";3032;62721;59689
881;"30.05.2008";18;"71.9";3112;62559;59447
881;"30.05.2008";19;"68.9";3247;62074;58827
881;"30.05.2008";20;"64.1";3406;60674;57268
881;"30.05.2008";21;"69.5";3576;57974;54398
881;"30.05.2008";22;"67.5";4283;56918;52635
881;"30.05.2008";23;"68.5";3788;54630;50842
881;"30.05.2008";24;"56.4";3009;50769;47760
882;"31.05.2008";1;"54.8";2774;47610;44836
882;"31.05.2008";2;"39.9";2856;45833;42977
882;"31.05.2008";3;"28.1";2627;44905;42278
882;"31.05.2008";4;"16.2";2144;44393;42249
882;"31.05.2008";5;"30.7";1747;44613;42866
882;"31.05.2008";6;28;1937;44218;42281
882;"31.05.2008";7;24;1820;46570;44750
882;"31.05.2008";8;"59.1";1045;49768;48723
882;"31.05.2008";9;61;647;52878;52231
882;"31.05.2008";10;"65.1";612;55503;54891
882;"31.05.2008";11;76;821;57021;56200
882;"31.05.2008";12;"83.1";1051;57567;56516
882;"31.05.2008";13;"84.9";1183;56022;54839
882;"31.05.2008";14;"66.1";1280;53637;52357
882;"31.05.2008";15;"65.1";1488;51485;49997
882;"31.05.2008";16;"61.2";1868;51006;49138
882;"31.05.2008";17;"61.9";2163;50457;48294
882;"31.05.2008";18;"61.2";2850;51104;48254
882;"31.05.2008";19;"59.2";3254;52038;48784
882;"31.05.2008";20;60;3273;51680;48407
882;"31.05.2008";21;"53.8";2773;49469;46696
882;"31.05.2008";22;"46.8";2511;48692;46181
882;"31.05.2008";23;60;2720;48523;45803
882;"31.05.2008";24;"58.7";2441;45340;42899
883;"01.06.2008";1;"36.6";2701;42173;39472
883;"01.06.2008";2;"26.1";2635;40978;38343
883;"01.06.2008";3;"19.9";2432;39669;37237
883;"01.06.2008";4;12;2215;38958;36743
883;"01.06.2008";5;"10.1";1708;38647;36939
883;"01.06.2008";6;"21.8";1467;38105;36638
883;"01.06.2008";7;"9.7";1184;38719;37535
883;"01.06.2008";8;"21.9";791;40902;40111
883;"01.06.2008";9;"37.1";531;43529;42998
883;"01.06.2008";10;"50.9";435;45143;44708
883;"01.06.2008";11;"58.6";504;46577;46073
883;"01.06.2008";12;60;763;48966;48203
883;"01.06.2008";13;"55.4";1065;48061;46996
883;"01.06.2008";14;"54.3";1148;45797;44649
883;"01.06.2008";15;"45.7";1321;44415;43094
883;"01.06.2008";16;"43.3";1358;43684;42326
883;"01.06.2008";17;41;1252;43832;42580
883;"01.06.2008";18;"44.7";1135;45267;44132
883;"01.06.2008";19;"54.9";1164;46830;45666
883;"01.06.2008";20;"54.9";1311;47355;46044
883;"01.06.2008";21;"58.7";1296;47220;45924
883;"01.06.2008";22;"65.6";1525;47723;46198
883;"01.06.2008";23;"73.9";1664;49116;47452
883;"01.06.2008";24;62;1570;45746;44176
884;"02.06.2008";1;"45.6";1521;43519;41998
884;"02.06.2008";2;36;1599;42613;41014
884;"02.06.2008";3;"26.7";1469;41670;40201
884;"02.06.2008";4;21;1437;41680;40243
884;"02.06.2008";5;"27.1";1274;42363;41089
884;"02.06.2008";6;"36.4";1248;45382;44134
884;"02.06.2008";7;"59.5";1219;53341;52122
884;"02.06.2008";8;89;787;60683;59896
884;"02.06.2008";9;"83.1";437;64120;63683
884;"02.06.2008";10;"95.9";390;64806;64416
884;"02.06.2008";11;"105.4";593;65821;65228
884;"02.06.2008";12;160;871;67049;66178
884;"02.06.2008";13;"109.9";1000;66438;65438
884;"02.06.2008";14;"99.5";1031;66012;64981
884;"02.06.2008";15;"93.4";1130;65370;64240
884;"02.06.2008";16;"87.7";1318;64551;63233
884;"02.06.2008";17;"81.9";1489;63374;61885
884;"02.06.2008";18;"78.1";1686;63054;61368
884;"02.06.2008";19;"75.2";2113;62777;60664
884;"02.06.2008";20;"72.6";2305;62199;59894
884;"02.06.2008";21;"76.1";2694;59704;57010
884;"02.06.2008";22;"73.9";3095;57704;54609
884;"02.06.2008";23;72;3664;55383;51719
884;"02.06.2008";24;57;3849;51064;47215
885;"03.06.2008";1;62;3801;48269;44468
885;"03.06.2008";2;"51.1";3707;46778;43071
885;"03.06.2008";3;"39.9";3297;45559;42262
885;"03.06.2008";4;"31.5";3068;45520;42452
885;"03.06.2008";5;"39.9";2695;46027;43332
885;"03.06.2008";6;"53.8";2246;48520;46274
885;"03.06.2008";7;"71.2";1915;55530;53615
885;"03.06.2008";8;"103.4";1422;61236;59814
885;"03.06.2008";9;"106.3";1117;64201;63084
885;"03.06.2008";10;"120.1";1245;64584;63339
885;"03.06.2008";11;"149.2";1833;65839;64006
885;"03.06.2008";12;172;2444;66645;64201
885;"03.06.2008";13;"154.9";2921;66127;63206
885;"03.06.2008";14;"140.1";3458;65755;62297
885;"03.06.2008";15;"128.1";3200;64677;61477
885;"03.06.2008";16;111;3508;63955;60447
885;"03.06.2008";17;"94.2";3739;62812;59073
885;"03.06.2008";18;84;3706;62633;58927
885;"03.06.2008";19;80;3544;61966;58422
885;"03.06.2008";20;72;3422;60990;57568
885;"03.06.2008";21;80;3144;58772;55628
885;"03.06.2008";22;"76.9";2606;57230;54624
885;"03.06.2008";23;78;2523;55551;53028
885;"03.06.2008";24;62;2626;51280;48654
886;"04.06.2008";1;62;2621;48152;45531
886;"04.06.2008";2;48;2509;46344;43835
886;"04.06.2008";3;"44.9";2310;45211;42901
886;"04.06.2008";4;"42.5";2257;45242;42985
886;"04.06.2008";5;"33.8";2095;46228;44133
886;"04.06.2008";6;"42.1";2055;48653;46598
886;"04.06.2008";7;"63.7";1706;55567;53861
886;"04.06.2008";8;96;1390;61304;59914
886;"04.06.2008";9;"96.4";1254;64152;62898
886;"04.06.2008";10;"200.8";1204;64612;63408
886;"04.06.2008";11;"199.5";1404;65504;64100
886;"04.06.2008";12;200;1786;66867;65081
886;"04.06.2008";13;"147.9";2083;66402;64319
886;"04.06.2008";14;"106.9";2327;66232;63905
886;"04.06.2008";15;"138.7";2544;65433;62889
886;"04.06.2008";16;104;2785;64498;61713
886;"04.06.2008";17;"98.9";2913;63416;60503
886;"04.06.2008";18;"88.4";3002;63198;60196
886;"04.06.2008";19;"87.5";3239;62940;59701
886;"04.06.2008";20;"79.9";3281;62341;59060
886;"04.06.2008";21;"75.9";3134;59574;56440
886;"04.06.2008";22;"69.6";3205;57748;54543
886;"04.06.2008";23;"74.9";3353;55496;52143
886;"04.06.2008";24;"62.7";3412;51404;47992
887;"05.06.2008";1;"54.2";3229;48763;45534
887;"05.06.2008";2;40;3032;46739;43707
887;"05.06.2008";3;"31.6";2635;45584;42949
887;"05.06.2008";4;"25.3";2607;45589;42982
887;"05.06.2008";5;"28.4";2487;46155;43668
887;"05.06.2008";6;33;2266;48626;46360
887;"05.06.2008";7;"55.5";1843;56042;54199
887;"05.06.2008";8;"79.4";1243;61531;60288
887;"05.06.2008";9;94;1123;64454;63331
887;"05.06.2008";10;"109.6";1498;64885;63387
887;"05.06.2008";11;"129.8";2367;66407;64040
887;"05.06.2008";12;"129.1";3285;67567;64282
887;"05.06.2008";13;"129.5";3746;66399;62653
887;"05.06.2008";14;"105.7";3772;65877;62105
887;"05.06.2008";15;"98.6";3941;64840;60899
887;"05.06.2008";16;"105.4";4293;64008;59715
887;"05.06.2008";17;"91.8";4675;62800;58125
887;"05.06.2008";18;"84.1";4775;62659;57884
887;"05.06.2008";19;"82.1";4723;62189;57466
887;"05.06.2008";20;"77.9";4458;61372;56914
887;"05.06.2008";21;"72.9";3882;58803;54921
887;"05.06.2008";22;"69.7";3681;56912;53231
887;"05.06.2008";23;"71.9";3857;55078;51221
887;"05.06.2008";24;"62.3";3755;51160;47405
888;"06.06.2008";1;"59.3";3786;48485;44699
888;"06.06.2008";2;"51.2";3633;46437;42804
888;"06.06.2008";3;"47.6";3476;44906;41430
888;"06.06.2008";4;"38.6";3279;44925;41646
888;"06.06.2008";5;"45.4";3031;45971;42940
888;"06.06.2008";6;"48.1";2844;48169;45325
888;"06.06.2008";7;71;2567;55160;52593
888;"06.06.2008";8;"86.5";1650;60804;59154
888;"06.06.2008";9;88;865;63628;62763
888;"06.06.2008";10;"100.1";1229;64228;62999
888;"06.06.2008";11;"124.1";2531;65216;62685
888;"06.06.2008";12;160;3757;66060;62303
888;"06.06.2008";13;"108.1";3938;65154;61216
888;"06.06.2008";14;99;3858;63797;59939
888;"06.06.2008";15;"87.2";3609;62437;58828
888;"06.06.2008";16;"78.9";3632;61329;57697
888;"06.06.2008";17;"78.2";3338;60342;57004
888;"06.06.2008";18;"75.2";3059;60536;57477
888;"06.06.2008";19;73;2739;59961;57222
888;"06.06.2008";20;"74.7";2291;58872;56581
888;"06.06.2008";21;"71.3";1936;56009;54073
888;"06.06.2008";22;"70.9";2092;54453;52361
888;"06.06.2008";23;"75.9";2529;53404;50875
888;"06.06.2008";24;64;2622;49681;47059
889;"07.06.2008";1;"63.9";2296;46563;44267
889;"07.06.2008";2;60;2050;45430;43380
889;"07.06.2008";3;"55.9";1862;44187;42325
889;"07.06.2008";4;"47.7";1609;43618;42009
889;"07.06.2008";5;44;1392;43516;42124
889;"07.06.2008";6;"40.8";1251;43305;42054
889;"07.06.2008";7;"46.5";1153;45534;44381
889;"07.06.2008";8;"57.2";855;48224;47369
889;"07.06.2008";9;"77.2";552;51697;51145
889;"07.06.2008";10;88;519;54364;53845
889;"07.06.2008";11;"94.9";711;55821;55110
889;"07.06.2008";12;100;1211;56731;55520
889;"07.06.2008";13;"94.1";1561;55037;53476
889;"07.06.2008";14;"75.8";1782;52577;50795
889;"07.06.2008";15;"68.1";1943;50749;48806
889;"07.06.2008";16;"62.3";2569;50110;47541
889;"07.06.2008";17;60;2573;49743;47170
889;"07.06.2008";18;"60.1";2478;50801;48323
889;"07.06.2008";19;"70.4";2253;50885;48632
889;"07.06.2008";20;72;1907;50103;48196
889;"07.06.2008";21;72;1781;48159;46378
889;"07.06.2008";22;"71.9";1909;47341;45432
889;"07.06.2008";23;"82.9";2115;47188;45073
889;"07.06.2008";24;"62.2";2575;44138;41563
890;"08.06.2008";1;"49.2";2610;41505;38895
890;"08.06.2008";2;"36.1";2354;40167;37813
890;"08.06.2008";3;"29.4";2012;38895;36883
890;"08.06.2008";4;"24.9";1709;38130;36421
890;"08.06.2008";5;25;1442;37838;36396
890;"08.06.2008";6;"22.1";1325;37355;36030
890;"08.06.2008";7;"20.1";1240;38019;36779
890;"08.06.2008";8;"31.1";703;39802;39099
890;"08.06.2008";9;"42.4";332;42571;42239
890;"08.06.2008";10;"56.2";275;44904;44629
890;"08.06.2008";11;"63.7";405;46684;46279
890;"08.06.2008";12;"74.2";604;48796;48192
890;"08.06.2008";13;"67.8";854;47825;46971
890;"08.06.2008";14;59;1029;45525;44496
890;"08.06.2008";15;"51.2";1302;43952;42650
890;"08.06.2008";16;"46.6";1624;43118;41494
890;"08.06.2008";17;"45.6";1864;43275;41411
890;"08.06.2008";18;"49.3";1941;44994;43053
890;"08.06.2008";19;57;2096;47089;44993
890;"08.06.2008";20;"62.2";1974;47204;45230
890;"08.06.2008";21;"60.9";1840;46589;44749
890;"08.06.2008";22;"62.8";1794;46334;44540
890;"08.06.2008";23;"75.1";1965;47769;45804
890;"08.06.2008";24;"59.1";1876;45017;43141
891;"09.06.2008";1;"51.3";1642;42548;40906
891;"09.06.2008";2;"41.1";1389;41367;39978
891;"09.06.2008";3;"35.9";1123;40894;39771
891;"09.06.2008";4;"32.2";1116;40965;39849
891;"09.06.2008";5;36;1137;42067;40930
891;"09.06.2008";6;"40.8";1011;45235;44224
891;"09.06.2008";7;"63.7";854;53091;52237
891;"09.06.2008";8;"84.2";543;59283;58740
891;"09.06.2008";9;100;278;62636;62358
891;"09.06.2008";10;"111.5";257;63310;63053
891;"09.06.2008";11;"149.9";329;64443;64114
891;"09.06.2008";12;"182.4";467;65810;65343
891;"09.06.2008";13;"150.6";646;65265;64619
891;"09.06.2008";14;"128.8";803;64946;64143
891;"09.06.2008";15;"104.2";1003;64257;63254
891;"09.06.2008";16;"98.1";1111;62964;61853
891;"09.06.2008";17;"90.2";1398;60934;59536
891;"09.06.2008";18;"87.1";1483;62189;60706
891;"09.06.2008";19;"83.9";1386;62275;60889
891;"09.06.2008";20;"81.5";1423;61151;59728
891;"09.06.2008";21;"79.3";1353;58547;57194
891;"09.06.2008";22;"75.5";1444;56214;54770
891;"09.06.2008";23;72;1561;54852;53291
891;"09.06.2008";24;"59.8";1464;50703;49239
892;"10.06.2008";1;"67.2";1096;47730;46634
892;"10.06.2008";2;"56.2";1023;46022;44999
892;"10.06.2008";3;"49.2";1008;44820;43812
892;"10.06.2008";4;"47.4";845;44951;44106
892;"10.06.2008";5;"47.5";873;45746;44873
892;"10.06.2008";6;"51.6";1031;47960;46929
892;"10.06.2008";7;"67.2";1073;54897;53824
892;"10.06.2008";8;"85.3";933;60384;59451
892;"10.06.2008";9;86;1000;63103;62103
892;"10.06.2008";10;"105.1";1547;63515;61968
892;"10.06.2008";11;"105.3";2313;64679;62366
892;"10.06.2008";12;107;2992;66176;63184
892;"10.06.2008";13;"96.3";3596;65613;62017
892;"10.06.2008";14;"94.8";4409;65193;60784
892;"10.06.2008";15;100;5011;64617;59606
892;"10.06.2008";16;"91.7";5674;63804;58130
892;"10.06.2008";17;"91.2";6364;62733;56369
892;"10.06.2008";18;"84.1";6266;62435;56169
892;"10.06.2008";19;"79.1";6185;62418;56233
892;"10.06.2008";20;"71.9";5469;61465;55996
892;"10.06.2008";21;"79.2";4607;58881;54274
892;"10.06.2008";22;"77.8";3894;56869;52975
892;"10.06.2008";23;"73.5";3495;55281;51786
892;"10.06.2008";24;"62.9";3461;51162;47701
893;"11.06.2008";1;"55.6";3242;47883;44641
893;"11.06.2008";2;"55.7";3205;46174;42969
893;"11.06.2008";3;47;3354;45041;41687
893;"11.06.2008";4;"36.5";3373;45126;41753
893;"11.06.2008";5;"40.8";3431;46073;42642
893;"11.06.2008";6;44;3371;48314;44943
893;"11.06.2008";7;"63.7";3097;55198;52101
893;"11.06.2008";8;"83.9";2972;60638;57666
893;"11.06.2008";9;90;3761;63624;59863
893;"11.06.2008";10;100;4773;64351;59578
893;"11.06.2008";11;"101.2";5207;65231;60024
893;"11.06.2008";12;"117.2";5429;66574;61145
893;"11.06.2008";13;"100.2";5622;65810;60188
893;"11.06.2008";14;"99.9";6110;64968;58858
893;"11.06.2008";15;"95.2";6988;63970;56982
893;"11.06.2008";16;"87.5";7564;62545;54981
893;"11.06.2008";17;"84.5";7836;60550;52714
893;"11.06.2008";18;"79.4";7722;60751;53029
893;"11.06.2008";19;76;7449;61745;54296
893;"11.06.2008";20;"74.3";6425;60058;53633
893;"11.06.2008";21;70;5301;57491;52190
893;"11.06.2008";22;"70.6";4146;55502;51356
893;"11.06.2008";23;"70.3";3646;53978;50332
893;"11.06.2008";24;"62.7";3455;50265;46810
894;"12.06.2008";1;"61.1";3370;47844;44474
894;"12.06.2008";2;"49.1";3423;46168;42745
894;"12.06.2008";3;"32.6";3461;45160;41699
894;"12.06.2008";4;"40.7";3458;45404;41946
894;"12.06.2008";5;"40.7";3225;46201;42976
894;"12.06.2008";6;"57.7";3148;48546;45398
894;"12.06.2008";7;"63.2";2634;54980;52346
894;"12.06.2008";8;"83.1";2401;60189;57788
894;"12.06.2008";9;"93.3";2439;62625;60186
894;"12.06.2008";10;"104.9";2633;63096;60463
894;"12.06.2008";11;"134.9";2588;64481;61893
894;"12.06.2008";12;"172.9";2413;65910;63497
894;"12.06.2008";13;129;2276;65434;63158
894;"12.06.2008";14;"106.7";2378;64910;62532
894;"12.06.2008";15;"102.5";2489;64115;61626
894;"12.06.2008";16;102;2311;63189;60878
894;"12.06.2008";17;"86.6";2149;62285;60136
894;"12.06.2008";18;"85.3";1998;62119;60121
894;"12.06.2008";19;"81.5";1922;60748;58826
894;"12.06.2008";20;76;1868;58644;56776
894;"12.06.2008";21;"77.9";1580;57764;56184
894;"12.06.2008";22;75;1270;56262;54992
894;"12.06.2008";23;"75.8";1163;53993;52830
894;"12.06.2008";24;"62.5";1132;50097;48965
895;"13.06.2008";1;"63.7";1433;46800;45367
895;"13.06.2008";2;"39.1";1533;45156;43623
895;"13.06.2008";3;"31.9";1790;43782;41992
895;"13.06.2008";4;"24.1";1839;44154;42315
895;"13.06.2008";5;"24.1";2083;45241;43158
895;"13.06.2008";6;"32.1";2203;47521;45318
895;"13.06.2008";7;"58.6";2164;54942;52778
895;"13.06.2008";8;"78.6";2101;60430;58329
895;"13.06.2008";9;"85.3";2007;63661;61654
895;"13.06.2008";10;"94.3";2367;64063;61696
895;"13.06.2008";11;"109.6";3039;65241;62202
895;"13.06.2008";12;125;3741;66235;62494
895;"13.06.2008";13;"105.5";4279;64970;60691
895;"13.06.2008";14;"88.7";4594;63489;58895
895;"13.06.2008";15;"81.2";4591;61988;57397
895;"13.06.2008";16;"75.4";4783;60822;56039
895;"13.06.2008";17;74;4827;59877;55050
895;"13.06.2008";18;69;4928;60037;55109
895;"13.06.2008";19;"67.2";4708;59727;55019
895;"13.06.2008";20;64;3507;58089;54582
895;"13.06.2008";21;"66.8";2701;55732;53031
895;"13.06.2008";22;64;2317;53757;51440
895;"13.06.2008";23;"66.2";2656;52972;50316
895;"13.06.2008";24;64;2780;49106;46326
896;"14.06.2008";1;"73.1";2960;46089;43129
896;"14.06.2008";2;"63.1";3040;44096;41056
896;"14.06.2008";3;55;3118;43212;40094
896;"14.06.2008";4;"47.1";3045;42805;39760
896;"14.06.2008";5;"40.9";3109;42725;39616
896;"14.06.2008";6;"40.9";2815;42233;39418
896;"14.06.2008";7;"29.4";2226;43464;41238
896;"14.06.2008";8;"40.3";1643;46138;44495
896;"14.06.2008";9;54;1505;49814;48309
896;"14.06.2008";10;"69.1";1808;52466;50658
896;"14.06.2008";11;"72.2";2167;53793;51626
896;"14.06.2008";12;81;2469;55173;52704
896;"14.06.2008";13;78;2564;53627;51063
896;"14.06.2008";14;"65.1";2699;51391;48692
896;"14.06.2008";15;"62.9";3093;49226;46133
896;"14.06.2008";16;"59.7";3114;48490;45376
896;"14.06.2008";17;"59.9";3002;48457;45455
896;"14.06.2008";18;63;2658;49372;46714
896;"14.06.2008";19;63;2306;49765;47459
896;"14.06.2008";20;61;1835;49235;47400
896;"14.06.2008";21;"51.1";1142;47333;46191
896;"14.06.2008";22;49;1147;46062;44915
896;"14.06.2008";23;49;1305;46054;44749
896;"14.06.2008";24;"49.1";1598;42820;41222
897;"15.06.2008";1;"48.7";1939;40531;38592
897;"15.06.2008";2;37;2190;39058;36868
897;"15.06.2008";3;"32.2";2273;38034;35761
897;"15.06.2008";4;21;2178;37602;35424
897;"15.06.2008";5;"16.3";1949;37453;35504
897;"15.06.2008";6;"18.1";1733;36868;35135
897;"15.06.2008";7;"5.3";1486;37349;35863
897;"15.06.2008";8;"19.4";980;38763;37783
897;"15.06.2008";9;"40.9";907;41188;40281
897;"15.06.2008";10;"55.1";1200;43798;42598
897;"15.06.2008";11;"62.9";1609;46045;44436
897;"15.06.2008";12;"67.5";1890;48691;46801
897;"15.06.2008";13;"64.7";2364;47733;45369
897;"15.06.2008";14;"60.9";2354;45431;43077
897;"15.06.2008";15;"51.4";2888;43628;40740
897;"15.06.2008";16;"50.2";2669;42959;40290
897;"15.06.2008";17;"49.3";2578;43333;40755
897;"15.06.2008";18;"59.5";2241;44812;42571
897;"15.06.2008";19;"64.4";2252;46839;44587
897;"15.06.2008";20;"67.3";1817;47129;45312
897;"15.06.2008";21;"63.4";1531;46768;45237
897;"15.06.2008";22;66;1131;46533;45402
897;"15.06.2008";23;"68.3";1192;47472;46280
897;"15.06.2008";24;60;1209;44280;43071
898;"16.06.2008";1;"55.4";1324;41872;40548
898;"16.06.2008";2;43;1298;40803;39505
898;"16.06.2008";3;"39.9";1328;40350;39022
898;"16.06.2008";4;37;1495;40862;39367
898;"16.06.2008";5;"39.7";1632;41853;40221
898;"16.06.2008";6;"43.7";1629;44460;42831
898;"16.06.2008";7;"59.1";1381;52647;51266
898;"16.06.2008";8;"83.4";951;59406;58455
898;"16.06.2008";9;"94.5";825;62874;62049
898;"16.06.2008";10;"106.1";1092;63546;62454
898;"16.06.2008";11;"120.2";1253;64564;63311
898;"16.06.2008";12;"154.4";1508;66228;64720
898;"16.06.2008";13;"120.2";1761;65436;63675
898;"16.06.2008";14;"115.1";1902;64493;62591
898;"16.06.2008";15;"103.1";1994;63485;61491
898;"16.06.2008";16;"101.2";2258;62745;60487
898;"16.06.2008";17;"95.2";2185;61191;59006
898;"16.06.2008";18;90;2087;60840;58753
898;"16.06.2008";19;86;1902;60786;58884
898;"16.06.2008";20;"82.6";1626;59665;58039
898;"16.06.2008";21;80;1319;56523;55204
898;"16.06.2008";22;"78.1";1228;53698;52470
898;"16.06.2008";23;72;1164;53316;52152
898;"16.06.2008";24;59;1163;51023;49860
899;"17.06.2008";1;59;1058;47581;46523
899;"17.06.2008";2;47;1043;45746;44703
899;"17.06.2008";3;"44.2";1084;44859;43775
899;"17.06.2008";4;"41.6";1015;44877;43862
899;"17.06.2008";5;"44.4";1007;45679;44672
899;"17.06.2008";6;"52.8";985;47637;46652
899;"17.06.2008";7;"58.7";690;54952;54262
899;"17.06.2008";8;"86.2";307;60265;59958
899;"17.06.2008";9;"85.7";210;62751;62541
899;"17.06.2008";10;"99.1";291;63293;63002
899;"17.06.2008";11;"111.1";357;64551;64194
899;"17.06.2008";12;"127.7";381;65755;65374
899;"17.06.2008";13;"105.7";357;64599;64242
899;"17.06.2008";14;"102.3";341;64284;63943
899;"17.06.2008";15;"100.9";305;63593;63288
899;"17.06.2008";16;"90.1";308;63076;62768
899;"17.06.2008";17;"90.1";274;61941;61667
899;"17.06.2008";18;86;230;61472;61242
899;"17.06.2008";19;"78.7";193;61106;60913
899;"17.06.2008";20;74;183;60389;60206
899;"17.06.2008";21;78;212;58161;57949
899;"17.06.2008";22;"74.6";302;56242;55940
899;"17.06.2008";23;"75.7";416;54723;54307
899;"17.06.2008";24;65;497;50858;50361
900;"18.06.2008";1;"62.9";547;47707;47160
900;"18.06.2008";2;"54.6";589;45853;45264
900;"18.06.2008";3;"45.1";631;44961;44330
900;"18.06.2008";4;43;714;44969;44255
900;"18.06.2008";5;"39.6";814;45883;45069
900;"18.06.2008";6;"49.3";1065;48415;47350
900;"18.06.2008";7;64;1266;55108;53842
900;"18.06.2008";8;80;1235;60889;59654
900;"18.06.2008";9;"86.9";779;63825;63046
900;"18.06.2008";10;"91.5";788;64234;63446
900;"18.06.2008";11;"93.5";1465;65086;63621
900;"18.06.2008";12;"102.5";2400;66392;63992
900;"18.06.2008";13;"90.1";3247;65622;62375
900;"18.06.2008";14;"86.9";3579;64904;61325
900;"18.06.2008";15;84;3766;63923;60157
900;"18.06.2008";16;"81.4";3417;62658;59241
900;"18.06.2008";17;"78.9";3011;61295;58284
900;"18.06.2008";18;"77.8";2277;61192;58915
900;"18.06.2008";19;"76.7";1625;60907;59282
900;"18.06.2008";20;"74.9";1077;60272;59195
900;"18.06.2008";21;"75.3";705;58154;57449
900;"18.06.2008";22;"73.7";553;56494;55941
900;"18.06.2008";23;"75.7";508;54987;54479
900;"18.06.2008";24;65;576;50796;50220
901;"19.06.2008";1;"59.9";836;46851;46015
901;"19.06.2008";2;"45.9";1254;45261;44007
901;"19.06.2008";3;"40.1";1642;44839;43197
901;"19.06.2008";4;"30.1";2111;44871;42760
901;"19.06.2008";5;"36.6";2622;45664;43042
901;"19.06.2008";6;"45.9";3151;48249;45098
901;"19.06.2008";7;"69.5";3420;54971;51551
901;"19.06.2008";8;"92.7";3237;60372;57135
901;"19.06.2008";9;"87.8";3280;63419;60139
901;"19.06.2008";10;"95.9";4390;63658;59268
901;"19.06.2008";11;"101.6";6076;64807;58731
901;"19.06.2008";12;"110.1";7545;66106;58561
901;"19.06.2008";13;90;8483;65410;56927
901;"19.06.2008";14;"84.9";9305;64756;55451
901;"19.06.2008";15;"83.5";9668;64300;54632
901;"19.06.2008";16;"78.8";9350;63499;54149
901;"19.06.2008";17;"75.4";8677;62235;53558
901;"19.06.2008";18;75;7545;61773;54228
901;"19.06.2008";19;"75.2";5977;61846;55869
901;"19.06.2008";20;"72.7";4535;60536;56001
901;"19.06.2008";21;"75.4";3473;56894;53421
901;"19.06.2008";22;"69.5";2698;54077;51379
901;"19.06.2008";23;"73.4";2691;53643;50952
901;"19.06.2008";24;"62.3";2695;51219;48524
902;"20.06.2008";1;58;2803;47984;45181
902;"20.06.2008";2;46;2984;46054;43070
902;"20.06.2008";3;"32.4";3253;45043;41790
902;"20.06.2008";4;30;3155;44882;41727
902;"20.06.2008";5;"18.1";3199;45768;42569
902;"20.06.2008";6;"33.5";3181;47904;44723
902;"20.06.2008";7;"55.1";2791;54782;51991
902;"20.06.2008";8;"79.1";2129;60009;57880
902;"20.06.2008";9;86;2036;62820;60784
902;"20.06.2008";10;100;2326;63503;61177
902;"20.06.2008";11;"104.8";2994;64354;61360
902;"20.06.2008";12;"107.8";3755;65414;61659
902;"20.06.2008";13;"100.6";4541;64544;60003
902;"20.06.2008";14;"83.3";4966;62831;57865
902;"20.06.2008";15;"82.7";5188;61565;56377
902;"20.06.2008";16;"77.6";5102;60267;55165
902;"20.06.2008";17;76;4926;59425;54499
902;"20.06.2008";18;78;4473;59776;55303
902;"20.06.2008";19;"79.9";4062;59566;55504
902;"20.06.2008";20;"74.1";3366;58324;54958
902;"20.06.2008";21;"78.7";2315;55314;52999
902;"20.06.2008";22;"75.9";1799;53392;51593
902;"20.06.2008";23;79;1653;52443;50790
902;"20.06.2008";24;"70.6";1578;49074;47496
903;"21.06.2008";1;"64.5";1544;45859;44315
903;"21.06.2008";2;60;1628;43606;41978
903;"21.06.2008";3;49;1748;42430;40682
903;"21.06.2008";4;"41.1";1905;42011;40106
903;"21.06.2008";5;45;2188;42593;40405
903;"21.06.2008";6;"38.1";2240;42556;40316
903;"21.06.2008";7;49;1888;44638;42750
903;"21.06.2008";8;"63.7";1439;47094;45655
903;"21.06.2008";9;"68.5";1360;50051;48691
903;"21.06.2008";10;"78.4";1728;52964;51236
903;"21.06.2008";11;86;1874;54236;52362
903;"21.06.2008";12;90;1941;55115;53174
903;"21.06.2008";13;"83.2";2039;53858;51819
903;"21.06.2008";14;"74.3";1959;51578;49619
903;"21.06.2008";15;72;1740;49589;47849
903;"21.06.2008";16;"69.1";1459;48713;47254
903;"21.06.2008";17;"64.9";1275;48030;46755
903;"21.06.2008";18;"67.5";1008;48763;47755
903;"21.06.2008";19;"73.8";750;49650;48900
903;"21.06.2008";20;74;483;49139;48656
903;"21.06.2008";21;"67.9";271;47302;47031
903;"21.06.2008";22;"69.9";410;46354;45944
903;"21.06.2008";23;"76.1";786;46741;45955
903;"21.06.2008";24;"66.8";1320;44191;42871
904;"22.06.2008";1;"66.3";1898;41467;39569
904;"22.06.2008";2;"62.3";2422;40846;38424
904;"22.06.2008";3;"43.1";2913;39549;36636
904;"22.06.2008";4;"33.9";3115;38709;35594
904;"22.06.2008";5;"30.1";3394;38275;34881
904;"22.06.2008";6;"22.4";3773;37358;33585
904;"22.06.2008";7;"20.2";3810;38633;34823
904;"22.06.2008";8;"40.5";3154;40590;37436
904;"22.06.2008";9;"49.6";2668;42575;39907
904;"22.06.2008";10;61;2619;44325;41706
904;"22.06.2008";11;"66.2";2826;46272;43446
904;"22.06.2008";12;"68.9";3218;48266;45048
904;"22.06.2008";13;"65.2";3969;47533;43564
904;"22.06.2008";14;58;5209;45911;40702
904;"22.06.2008";15;51;6194;44976;38782
904;"22.06.2008";16;"49.3";6188;44370;38182
904;"22.06.2008";17;"49.2";6000;44538;38538
904;"22.06.2008";18;"55.1";5599;45986;40387
904;"22.06.2008";19;"62.8";6146;47977;41831
904;"22.06.2008";20;"64.3";6128;48506;42378
904;"22.06.2008";21;"63.8";5928;47924;41996
904;"22.06.2008";22;68;5750;47631;41881
904;"22.06.2008";23;"76.4";5867;48964;43097
904;"22.06.2008";24;"66.2";6008;46243;40235
905;"23.06.2008";1;"55.3";5343;43247;37904
905;"23.06.2008";2;49;4867;41858;36991
905;"23.06.2008";3;"40.9";5412;41403;35991
905;"23.06.2008";4;"37.8";5869;42037;36168
905;"23.06.2008";5;"40.9";6264;42833;36569
905;"23.06.2008";6;"47.7";6998;45078;38080
905;"23.06.2008";7;"65.2";7336;53013;45677
905;"23.06.2008";8;"86.1";7681;60315;52634
905;"23.06.2008";9;93;9152;64193;55041
905;"23.06.2008";10;"99.3";10379;65486;55107
905;"23.06.2008";11;"99.9";11205;67314;56109
905;"23.06.2008";12;"126.4";11575;68823;57248
905;"23.06.2008";13;"99.9";11490;67957;56467
905;"23.06.2008";14;92;10887;67114;56227
905;"23.06.2008";15;90;10477;66271;55794
905;"23.06.2008";16;"85.9";10312;65631;55319
905;"23.06.2008";17;"84.8";9899;64372;54473
905;"23.06.2008";18;"82.2";8956;63271;54315
905;"23.06.2008";19;"79.3";7916;62385;54469
905;"23.06.2008";20;"75.4";6521;61188;54667
905;"23.06.2008";21;"76.1";5058;58681;53623
905;"23.06.2008";22;"70.1";3797;55872;52075
905;"23.06.2008";23;"69.5";3232;54765;51533
905;"23.06.2008";24;61;2888;50950;48062
906;"24.06.2008";1;"57.1";2729;46673;43944
906;"24.06.2008";2;55;2280;45203;42923
906;"24.06.2008";3;"48.5";2031;44393;42362
906;"24.06.2008";4;"41.1";1884;44737;42853
906;"24.06.2008";5;42;1856;45439;43583
906;"24.06.2008";6;"54.1";1772;47436;45664
906;"24.06.2008";7;65;1484;54118;52634
906;"24.06.2008";8;"83.1";1080;59634;58554
906;"24.06.2008";9;"101.4";1220;63076;61856
906;"24.06.2008";10;"117.1";1276;64092;62816
906;"24.06.2008";11;"161.1";1107;65070;63963
906;"24.06.2008";12;179;978;66460;65482
906;"24.06.2008";13;154;903;65326;64423
906;"24.06.2008";14;159;951;64235;63284
906;"24.06.2008";15;"147.7";941;63155;62214
906;"24.06.2008";16;"126.1";965;62484;61519
906;"24.06.2008";17;99;890;61224;60334
906;"24.06.2008";18;"87.1";922;61172;60250
906;"24.06.2008";19;"87.1";871;60928;60057
906;"24.06.2008";20;"82.2";834;60284;59450
906;"24.06.2008";21;"80.4";978;57952;56974
906;"24.06.2008";22;"78.2";1472;56179;54707
906;"24.06.2008";23;"79.9";1985;55076;53091
906;"24.06.2008";24;"67.9";2155;51352;49197
907;"25.06.2008";1;"67.4";2319;48273;45954
907;"25.06.2008";2;"61.9";2508;46675;44167
907;"25.06.2008";3;"47.6";2647;45888;43241
907;"25.06.2008";4;"42.4";2715;45854;43139
907;"25.06.2008";5;"36.6";2655;46672;44017
907;"25.06.2008";6;"49.9";2575;49012;46437
907;"25.06.2008";7;"69.5";2234;55568;53334
907;"25.06.2008";8;"90.3";1590;60757;59167
907;"25.06.2008";9;"95.1";1250;63674;62424
907;"25.06.2008";10;"114.1";1232;64832;63600
907;"25.06.2008";11;161;1092;66020;64928
907;"25.06.2008";12;"213.1";979;67513;66534
907;"25.06.2008";13;"120.4";1090;66684;65594
907;"25.06.2008";14;"140.1";1041;65912;64871
907;"25.06.2008";15;"140.1";995;65289;64294
907;"25.06.2008";16;"120.2";1241;64278;63037
907;"25.06.2008";17;"92.9";1818;63043;61225
907;"25.06.2008";18;92;2310;62689;60379
907;"25.06.2008";19;"87.1";3162;62076;58914
907;"25.06.2008";20;"79.1";3558;59974;56416
907;"25.06.2008";21;"79.6";3647;54820;51173
907;"25.06.2008";22;"74.9";4034;52049;48015
907;"25.06.2008";23;"72.1";4147;52460;48313
907;"25.06.2008";24;"64.5";4652;51471;46819
908;"26.06.2008";1;63;4411;49410;44999
908;"26.06.2008";2;"52.8";4329;47439;43110
908;"26.06.2008";3;46;4529;46121;41592
908;"26.06.2008";4;42;4717;45759;41042
908;"26.06.2008";5;"44.8";4610;46266;41656
908;"26.06.2008";6;"50.4";4020;48311;44291
908;"26.06.2008";7;"65.4";3312;54416;51104
908;"26.06.2008";8;"91.2";2559;59626;57067
908;"26.06.2008";9;"92.4";2320;62730;60410
908;"26.06.2008";10;"121.6";2157;63671;61514
908;"26.06.2008";11;"134.7";2319;64450;62131
908;"26.06.2008";12;"199.7";2793;65856;63063
908;"26.06.2008";13;"130.2";3017;65061;62044
908;"26.06.2008";14;"127.4";3187;64279;61092
908;"26.06.2008";15;140;3150;63644;60494
908;"26.06.2008";16;100;2875;62876;60001
908;"26.06.2008";17;"93.9";2456;61764;59308
908;"26.06.2008";18;"92.9";2185;61475;59290
908;"26.06.2008";19;"99.5";1848;61194;59346
908;"26.06.2008";20;"98.9";1407;60257;58850
908;"26.06.2008";21;85;1001;58179;57178
908;"26.06.2008";22;"78.8";825;56197;55372
908;"26.06.2008";23;"82.6";870;55228;54358
908;"26.06.2008";24;"71.9";835;51191;50356
909;"27.06.2008";1;"67.7";864;48452;47588
909;"27.06.2008";2;60;982;46548;45566
909;"27.06.2008";3;53;1520;45736;44216
909;"27.06.2008";4;"46.4";2158;45595;43437
909;"27.06.2008";5;"41.7";2877;46348;43471
909;"27.06.2008";6;"49.5";3688;48739;45051
909;"27.06.2008";7;"66.6";4522;55180;50658
909;"27.06.2008";8;85;4941;60772;55831
909;"27.06.2008";9;"95.2";5291;64114;58823
909;"27.06.2008";10;"103.7";6467;65140;58673
909;"27.06.2008";11;"106.6";8382;66192;57810
909;"27.06.2008";12;"127.4";9587;67557;57970
909;"27.06.2008";13;104;11164;66541;55377
909;"27.06.2008";14;"89.8";12543;65213;52670
909;"27.06.2008";15;85;12793;63749;50956
909;"27.06.2008";16;"78.8";13135;63020;49885
909;"27.06.2008";17;"81.7";12516;62428;49912
909;"27.06.2008";18;"83.2";11272;62401;51129
909;"27.06.2008";19;"84.6";9806;61333;51527
909;"27.06.2008";20;"72.5";7740;59281;51541
909;"27.06.2008";21;"75.3";5204;56019;50815
909;"27.06.2008";22;72;3425;53428;50003
909;"27.06.2008";23;"78.5";2902;52811;49909
909;"27.06.2008";24;"68.2";2854;49352;46498
910;"28.06.2008";1;"66.3";3062;46826;43764
910;"28.06.2008";2;"61.8";3476;44687;41211
910;"28.06.2008";3;"52.9";3610;43882;40272
910;"28.06.2008";4;"41.7";3937;43782;39845
910;"28.06.2008";5;"26.6";4362;43740;39378
910;"28.06.2008";6;"19.7";4743;43430;38687
910;"28.06.2008";7;"22.4";4720;45251;40531
910;"28.06.2008";8;"40.1";5154;47836;42682
910;"28.06.2008";9;"61.1";5610;51198;45588
910;"28.06.2008";10;"67.6";6192;53682;47490
910;"28.06.2008";11;"78.2";6809;55299;48490
910;"28.06.2008";12;"82.1";7381;56397;49016
910;"28.06.2008";13;"79.8";7633;55040;47407
910;"28.06.2008";14;"66.5";8182;53008;44826
910;"28.06.2008";15;"64.2";8612;51348;42736
910;"28.06.2008";16;64;8895;50625;41730
910;"28.06.2008";17;57;8602;49906;41304
910;"28.06.2008";18;"60.1";7909;50822;42913
910;"28.06.2008";19;66;6728;50888;44160
910;"28.06.2008";20;"63.5";4739;49762;45023
910;"28.06.2008";21;"62.9";3489;47746;44257
910;"28.06.2008";22;"62.9";2708;46399;43691
910;"28.06.2008";23;71;2546;46804;44258
910;"28.06.2008";24;64;2437;44094;41657
911;"29.06.2008";1;56;2125;41534;39409
911;"29.06.2008";2;"50.2";2029;40539;38510
911;"29.06.2008";3;"39.7";2108;39306;37198
911;"29.06.2008";4;"30.7";2365;38732;36367
911;"29.06.2008";5;26;2476;38734;36258
911;"29.06.2008";6;"18.2";2340;37934;35594
911;"29.06.2008";7;"16.9";2017;38589;36572
911;"29.06.2008";8;"35.7";1700;40946;39246
911;"29.06.2008";9;"47.3";1729;42610;40881
911;"29.06.2008";10;"56.6";2106;44015;41909
911;"29.06.2008";11;63;2555;46143;43588
911;"29.06.2008";12;"68.3";2957;48626;45669
911;"29.06.2008";13;"70.3";3099;47516;44417
911;"29.06.2008";14;"64.3";3189;45397;42208
911;"29.06.2008";15;"59.7";3210;43844;40634
911;"29.06.2008";16;"56.6";2885;42845;39960
911;"29.06.2008";17;"50.3";2748;43098;40350
911;"29.06.2008";18;"58.6";2607;44701;42094
911;"29.06.2008";19;"64.1";2233;46323;44090
911;"29.06.2008";20;67;1837;46445;44608
911;"29.06.2008";21;66;1362;45314;43952
911;"29.06.2008";22;"69.2";1203;44143;42940
911;"29.06.2008";23;"75.3";1345;45301;43956
911;"29.06.2008";24;"65.2";1424;44546;43122
912;"30.06.2008";1;55;1885;42270;40385
912;"30.06.2008";2;"42.1";2421;40794;38373
912;"30.06.2008";3;40;3074;40970;37896
912;"30.06.2008";4;35;3500;41040;37540
912;"30.06.2008";5;"34.7";3704;42104;38400
912;"30.06.2008";6;"41.5";3481;44315;40834
912;"30.06.2008";7;"63.8";2998;51899;48901
912;"30.06.2008";8;"89.5";2469;58625;56156
912;"30.06.2008";9;"102.2";2988;62327;59339
912;"30.06.2008";10;"123.6";3420;63082;59662
912;"30.06.2008";11;"131.2";3735;64498;60763
912;"30.06.2008";12;199;3937;65988;62051
912;"30.06.2008";13;"142.6";4050;65092;61042
912;"30.06.2008";14;"140.2";4211;64337;60126
912;"30.06.2008";15;"117.4";4132;63414;59282
912;"30.06.2008";16;"109.2";3944;62460;58516
912;"30.06.2008";17;"100.1";3445;61308;57863
912;"30.06.2008";18;"95.1";3052;60927;57875
912;"30.06.2008";19;"88.4";2500;60763;58263
912;"30.06.2008";20;"84.4";1828;59951;58123
912;"30.06.2008";21;"80.9";1133;57700;56567
912;"30.06.2008";22;"78.5";774;55647;54873
912;"30.06.2008";23;"79.1";774;54664;53890
912;"30.06.2008";24;"67.1";746;50951;50205
913;"01.07.2008";1;"64.1";646;48041;47395
913;"01.07.2008";2;"55.6";638;46319;45681
913;"01.07.2008";3;"45.6";608;45097;44489
913;"01.07.2008";4;"40.1";633;45330;44697
913;"01.07.2008";5;"41.9";694;46194;45500
913;"01.07.2008";6;"50.7";572;48248;47676
913;"01.07.2008";7;"58.7";444;54338;53894
913;"01.07.2008";8;"88.2";357;60078;59721
913;"01.07.2008";9;"89.1";202;62878;62676
913;"01.07.2008";10;99;157;63529;63372
913;"01.07.2008";11;107;179;64759;64580
913;"01.07.2008";12;"111.2";227;66004;65777
913;"01.07.2008";13;"96.9";247;65325;65078
913;"01.07.2008";14;"96.6";257;64549;64292
913;"01.07.2008";15;"136.4";278;63527;63249
913;"01.07.2008";16;"122.2";337;62267;61930
913;"01.07.2008";17;"115.8";381;61357;60976
913;"01.07.2008";18;"98.9";530;61430;60900
913;"01.07.2008";19;"88.1";749;61563;60814
913;"01.07.2008";20;"80.1";922;60783;59861
913;"01.07.2008";21;84;1385;58736;57351
913;"01.07.2008";22;"75.6";2226;57212;54986
913;"01.07.2008";23;"80.7";3499;56982;53483
913;"01.07.2008";24;66;4154;52549;48395
914;"02.07.2008";1;"64.1";4551;49857;45306
914;"02.07.2008";2;52;4394;47696;43302
914;"02.07.2008";3;48;4251;46652;42401
914;"02.07.2008";4;"39.5";4178;46585;42407
914;"02.07.2008";5;"41.4";4107;47254;43147
914;"02.07.2008";6;52;3932;49297;45365
914;"02.07.2008";7;"60.7";3516;55612;52096
914;"02.07.2008";8;"88.1";2422;60908;58486
914;"02.07.2008";9;100;1534;63648;62114
914;"02.07.2008";10;"151.9";1316;64222;62906
914;"02.07.2008";11;"163.9";1298;65215;63917
914;"02.07.2008";12;160;1711;66326;64615
914;"02.07.2008";13;"129.7";2226;65909;63683
914;"02.07.2008";14;"131.9";2240;65249;63009
914;"02.07.2008";15;"163.9";1963;64176;62213
914;"02.07.2008";16;"133.6";1740;63329;61589
914;"02.07.2008";17;"119.9";1797;62068;60271
914;"02.07.2008";18;103;2088;62412;60324
914;"02.07.2008";19;"94.1";2609;62412;59803
914;"02.07.2008";20;"83.4";3075;62107;59032
914;"02.07.2008";21;"83.1";3728;59598;55870
914;"02.07.2008";22;"79.2";4626;57846;53220
914;"02.07.2008";23;"80.1";5368;56338;50970
914;"02.07.2008";24;67;5322;52188;46866
915;"03.07.2008";1;66;4989;49791;44802
915;"03.07.2008";2;"66.8";4273;47956;43683
915;"03.07.2008";3;"61.1";3954;47051;43097
915;"03.07.2008";4;"49.3";3200;46908;43708
915;"03.07.2008";5;50;2839;47481;44642
915;"03.07.2008";6;"64.6";2316;49571;47255
915;"03.07.2008";7;"75.7";1776;55666;53890
915;"03.07.2008";8;"93.3";1234;60787;59553
915;"03.07.2008";9;"141.1";778;63738;62960
915;"03.07.2008";10;"151.9";634;64657;64023
915;"03.07.2008";11;"172.6";691;65895;65204
915;"03.07.2008";12;275;937;67196;66259
915;"03.07.2008";13;156;1182;66658;65476
915;"03.07.2008";14;128;1279;66113;64834
915;"03.07.2008";15;"129.8";1411;64927;63516
915;"03.07.2008";16;"114.4";1734;64103;62369
915;"03.07.2008";17;94;2404;63528;61124
915;"03.07.2008";18;"90.8";3776;63798;60022
915;"03.07.2008";19;"85.8";3993;63899;59906
915;"03.07.2008";20;"78.2";4210;62604;58394
915;"03.07.2008";21;"81.6";3998;60183;56185
915;"03.07.2008";22;"76.2";3617;57288;53671
915;"03.07.2008";23;"83.7";3040;55437;52397
915;"03.07.2008";24;"67.9";3042;51422;48380
916;"04.07.2008";1;60;3266;48837;45571
916;"04.07.2008";2;"48.7";3358;47016;43658
916;"04.07.2008";3;"35.1";3696;46097;42401
916;"04.07.2008";4;"30.1";4426;46421;41995
916;"04.07.2008";5;31;4596;47477;42881
916;"04.07.2008";6;"38.1";4767;49949;45182
916;"04.07.2008";7;"57.4";5397;56205;50808
916;"04.07.2008";8;84;4956;61005;56049
916;"04.07.2008";9;"85.1";4982;63880;58898
916;"04.07.2008";10;95;4983;64427;59444
916;"04.07.2008";11;112;4713;65371;60658
916;"04.07.2008";12;"122.5";5037;66214;61177
916;"04.07.2008";13;"100.1";4897;65055;60158
916;"04.07.2008";14;"92.7";4534;63169;58635
916;"04.07.2008";15;"91.2";4586;61817;57231
916;"04.07.2008";16;"87.5";4531;60932;56401
916;"04.07.2008";17;"84.4";4369;59824;55455
916;"04.07.2008";18;"83.3";4022;60048;56026
916;"04.07.2008";19;84;3669;59499;55830
916;"04.07.2008";20;"83.6";2754;58169;55415
916;"04.07.2008";21;81;2182;55179;52997
916;"04.07.2008";22;76;1818;53286;51468
916;"04.07.2008";23;"83.9";1440;52518;51078
916;"04.07.2008";24;"68.1";1486;49011;47525
917;"05.07.2008";1;60;1424;45701;44277
917;"05.07.2008";2;"55.9";1451;44384;42933
917;"05.07.2008";3;"54.9";1383;43886;42503
917;"05.07.2008";4;"47.6";1358;43495;42137
917;"05.07.2008";5;"47.2";1111;43255;42144
917;"05.07.2008";6;"37.4";974;42568;41594
917;"05.07.2008";7;"41.8";797;44693;43896
917;"05.07.2008";8;"58.3";588;46853;46265
917;"05.07.2008";9;72;545;49845;49300
917;"05.07.2008";10;80;601;52083;51482
917;"05.07.2008";11;"83.2";673;53332;52659
917;"05.07.2008";12;"85.7";838;53799;52961
917;"05.07.2008";13;"85.9";778;52347;51569
917;"05.07.2008";14;80;721;50093;49372
917;"05.07.2008";15;"74.1";737;48399;47662
917;"05.07.2008";16;"69.8";608;47631;47023
917;"05.07.2008";17;"68.9";568;47729;47161
917;"05.07.2008";18;68;588;48469;47881
917;"05.07.2008";19;"68.5";503;49044;48541
917;"05.07.2008";20;"66.1";425;48673;48248
917;"05.07.2008";21;"62.1";403;46892;46489
917;"05.07.2008";22;"60.1";590;46168;45578
917;"05.07.2008";23;"69.1";854;46303;45449
917;"05.07.2008";24;"61.9";909;43431;42522
918;"06.07.2008";1;"52.1";895;41250;40355
918;"06.07.2008";2;"39.9";887;39638;38751
918;"06.07.2008";3;"33.3";853;39004;38151
918;"06.07.2008";4;"28.6";828;38415;37587
918;"06.07.2008";5;"19.3";724;37950;37226
918;"06.07.2008";6;"14.1";721;37377;36656
918;"06.07.2008";7;"5.8";682;38055;37373
918;"06.07.2008";8;"26.7";446;40064;39618
918;"06.07.2008";9;"49.9";297;41879;41582
918;"06.07.2008";10;"55.9";387;43657;43270
918;"06.07.2008";11;"60.2";711;45704;44993
918;"06.07.2008";12;"69.2";968;47837;46869
918;"06.07.2008";13;62;1486;47212;45726
918;"06.07.2008";14;"56.9";1948;45503;43555
918;"06.07.2008";15;"48.9";2431;44622;42191
918;"06.07.2008";16;"45.6";2675;44032;41357
918;"06.07.2008";17;"48.7";2945;44154;41209
918;"06.07.2008";18;"54.2";2801;45169;42368
918;"06.07.2008";19;"64.1";2938;46449;43511
918;"06.07.2008";20;66;2453;46646;44193
918;"06.07.2008";21;59;2221;46229;44008
918;"06.07.2008";22;"60.1";2251;46352;44101
918;"06.07.2008";23;"65.6";2450;47542;45092
918;"06.07.2008";24;"55.6";2527;44233;41706
919;"07.07.2008";1;"48.4";2615;42109;39494
919;"07.07.2008";2;40;2648;41515;38867
919;"07.07.2008";3;"35.9";3060;40850;37790
919;"07.07.2008";4;"30.5";3258;41066;37808
919;"07.07.2008";5;"30.8";3371;42051;38680
919;"07.07.2008";6;"39.9";3601;44178;40577
919;"07.07.2008";7;"57.8";3746;51962;48216
919;"07.07.2008";8;"82.3";3269;58542;55273
919;"07.07.2008";9;"92.1";3543;62208;58665
919;"07.07.2008";10;"96.3";4053;63416;59363
919;"07.07.2008";11;"103.2";4457;64501;60044
919;"07.07.2008";12;"139.8";4699;65234;60535
919;"07.07.2008";13;"108.5";5318;64166;58848
919;"07.07.2008";14;"101.1";5731;63501;57770
919;"07.07.2008";15;"99.9";6133;63089;56956
919;"07.07.2008";16;"92.2";6123;62055;55932
919;"07.07.2008";17;"87.2";6352;61209;54857
919;"07.07.2008";18;"86.5";6102;60982;54880
919;"07.07.2008";19;"82.9";5417;60367;54950
919;"07.07.2008";20;"81.3";4699;59099;54400
919;"07.07.2008";21;"82.3";4687;57124;52437
919;"07.07.2008";22;"76.4";4707;55452;50745
919;"07.07.2008";23;"73.8";4774;53578;48804
919;"07.07.2008";24;"62.1";4987;49714;44727
920;"08.07.2008";1;"56.1";5592;47701;42109
920;"08.07.2008";2;"42.8";6322;46154;39832
920;"08.07.2008";3;"33.2";6772;45159;38387
920;"08.07.2008";4;26;6935;45253;38318
920;"08.07.2008";5;20;6789;46121;39332
920;"08.07.2008";6;"41.8";6548;48577;42029
920;"08.07.2008";7;"59.1";6170;54243;48073
920;"08.07.2008";8;78;6323;59770;53447
920;"08.07.2008";9;"77.3";6727;62895;56168
920;"08.07.2008";10;"85.9";7556;63990;56434
920;"08.07.2008";11;92;8439;65723;57284
920;"08.07.2008";12;98;8591;67269;58678
920;"08.07.2008";13;"90.1";8838;66169;57331
920;"08.07.2008";14;92;8748;65041;56293
920;"08.07.2008";15;"85.5";8549;63850;55301
920;"08.07.2008";16;"85.2";8377;63176;54799
920;"08.07.2008";17;"82.9";7421;61452;54031
920;"08.07.2008";18;"80.5";7053;61257;54204
920;"08.07.2008";19;"77.9";6278;61009;54731
920;"08.07.2008";20;"74.9";5283;59858;54575
920;"08.07.2008";21;"74.9";4852;57296;52444
920;"08.07.2008";22;76;5169;55458;50289
920;"08.07.2008";23;"75.7";5022;53864;48842
920;"08.07.2008";24;"66.9";5342;50275;44933
921;"09.07.2008";1;60;5673;47114;41441
921;"09.07.2008";2;"56.1";5721;45851;40130
921;"09.07.2008";3;"41.8";5805;44823;39018
921;"09.07.2008";4;"41.7";5794;44956;39162
921;"09.07.2008";5;"41.8";5731;46040;40309
921;"09.07.2008";6;"50.8";5433;47996;42563
921;"09.07.2008";7;"68.4";5506;54757;49251
921;"09.07.2008";8;85;5579;60203;54624
921;"09.07.2008";9;87;5787;63273;57486
921;"09.07.2008";10;"95.5";6405;64083;57678
921;"09.07.2008";11;95;7135;65203;58068
921;"09.07.2008";12;"104.7";7314;66702;59388
921;"09.07.2008";13;"94.1";7028;65423;58395
921;"09.07.2008";14;95;7459;64440;56981
921;"09.07.2008";15;89;7423;63478;56055
921;"09.07.2008";16;"85.8";7829;62699;54870
921;"09.07.2008";17;79;7510;61580;54070
921;"09.07.2008";18;"77.8";6597;61373;54776
921;"09.07.2008";19;"81.2";5469;60890;55421
921;"09.07.2008";20;79;3988;60104;56116
921;"09.07.2008";21;75;2950;57672;54722
921;"09.07.2008";22;73;2438;55984;53546
921;"09.07.2008";23;"78.8";2230;54083;51853
921;"09.07.2008";24;70;2171;50259;48088
922;"10.07.2008";1;65;2273;47614;45341
922;"10.07.2008";2;"61.7";2450;45882;43432
922;"10.07.2008";3;52;2359;44779;42420
922;"10.07.2008";4;"41.8";2210;44763;42553
922;"10.07.2008";5;40;2124;45833;43709
922;"10.07.2008";6;"56.1";2158;48204;46046
922;"10.07.2008";7;"69.3";2068;54363;52295
922;"10.07.2008";8;"90.3";1717;59582;57865
922;"10.07.2008";9;88;1616;62711;61095
922;"10.07.2008";10;"94.7";1882;63228;61346
922;"10.07.2008";11;"96.5";2189;64577;62388
922;"10.07.2008";12;"116.4";2477;66153;63676
922;"10.07.2008";13;"100.1";2803;65178;62375
922;"10.07.2008";14;"95.1";2918;64275;61357
922;"10.07.2008";15;95;2975;63274;60299
922;"10.07.2008";16;"89.1";2984;62870;59886
922;"10.07.2008";17;"85.9";2820;61949;59129
922;"10.07.2008";18;"85.1";2463;61634;59171
922;"10.07.2008";19;"86.6";1946;61371;59425
922;"10.07.2008";20;"80.7";1446;60352;58906
922;"10.07.2008";21;"82.7";1316;57792;56476
922;"10.07.2008";22;79;1582;56330;54748
922;"10.07.2008";23;"80.9";2293;54920;52627
922;"10.07.2008";24;"71.3";2675;50936;48261
923;"11.07.2008";1;"68.6";2493;47828;45335
923;"11.07.2008";2;"61.9";3181;46638;43457
923;"11.07.2008";3;"58.7";3092;45399;42307
923;"11.07.2008";4;"52.1";3251;45492;42241
923;"11.07.2008";5;"55.3";3172;46397;43225
923;"11.07.2008";6;"61.8";3060;48623;45563
923;"11.07.2008";7;"71.9";2945;54428;51483
923;"11.07.2008";8;"94.1";2448;59849;57401
923;"11.07.2008";9;90;2304;63051;60747
923;"11.07.2008";10;"97.9";2285;63648;61363
923;"11.07.2008";11;109;2769;65084;62315
923;"11.07.2008";12;135;3245;66071;62826
923;"11.07.2008";13;"105.8";3428;64803;61375
923;"11.07.2008";14;"93.9";3583;63434;59851
923;"11.07.2008";15;"92.1";3779;62519;58740
923;"11.07.2008";16;"85.8";3466;61752;58286
923;"11.07.2008";17;"83.3";3182;60599;57417
923;"11.07.2008";18;"83.5";2524;60651;58127
923;"11.07.2008";19;85;2253;59869;57616
923;"11.07.2008";20;"80.9";1764;59301;57537
923;"11.07.2008";21;81;1619;56300;54681
923;"11.07.2008";22;"77.8";1658;53814;52156
923;"11.07.2008";23;"83.9";1983;52432;50449
923;"11.07.2008";24;"71.8";2638;48584;45946
924;"12.07.2008";1;"68.7";3537;46092;42555
924;"12.07.2008";2;63;4012;43947;39935
924;"12.07.2008";3;"59.9";4260;43065;38805
924;"12.07.2008";4;"58.1";4289;42923;38634
924;"12.07.2008";5;"51.3";4010;43288;39278
924;"12.07.2008";6;"47.7";4015;42787;38772
924;"12.07.2008";7;"48.4";4172;44781;40609
924;"12.07.2008";8;"61.7";4402;47379;42977
924;"12.07.2008";9;"70.4";5104;50381;45277
924;"12.07.2008";10;"74.1";6257;53367;47110
924;"12.07.2008";11;"84.9";7369;55046;47677
924;"12.07.2008";12;"89.1";7856;55909;48053
924;"12.07.2008";13;85;8306;55264;46958
924;"12.07.2008";14;"76.1";8042;53437;45395
924;"12.07.2008";15;74;7678;51121;43443
924;"12.07.2008";16;"70.1";6892;49777;42885
924;"12.07.2008";17;"69.1";5891;48899;43008
924;"12.07.2008";18;"71.4";4513;49317;44804
924;"12.07.2008";19;"79.9";3332;49390;46058
924;"12.07.2008";20;78;2241;48763;46522
924;"12.07.2008";21;"70.5";1346;46687;45341
924;"12.07.2008";22;"69.8";1093;45639;44546
924;"12.07.2008";23;80;1213;45792;44579
924;"12.07.2008";24;"65.5";1184;43162;41978
925;"13.07.2008";1;"53.6";1235;40886;39651
925;"13.07.2008";2;"45.6";1396;39574;38178
925;"13.07.2008";3;39;1301;38332;37031
925;"13.07.2008";4;"35.5";1239;37890;36651
925;"13.07.2008";5;"29.7";1248;37822;36574
925;"13.07.2008";6;"18.3";1223;37223;36000
925;"13.07.2008";7;"16.8";1156;37719;36563
925;"13.07.2008";8;"39.3";730;39702;38972
925;"13.07.2008";9;53;581;41640;41059
925;"13.07.2008";10;"62.5";691;43843;43152
925;"13.07.2008";11;68;978;46041;45063
925;"13.07.2008";12;74;1198;48579;47381
925;"13.07.2008";13;"70.4";1295;47678;46383
925;"13.07.2008";14;"65.5";1261;45402;44141
925;"13.07.2008";15;60;1224;43811;42587
925;"13.07.2008";16;"58.4";1381;42708;41327
925;"13.07.2008";17;"56.1";1473;42622;41149
925;"13.07.2008";18;"60.3";1455;43740;42285
925;"13.07.2008";19;"67.9";1302;45390;44088
925;"13.07.2008";20;"69.7";1270;45867;44597
925;"13.07.2008";21;67;1175;45289;44114
925;"13.07.2008";22;"68.9";1097;45488;44391
925;"13.07.2008";23;"78.9";1353;46745;45392
925;"13.07.2008";24;66;1637;43492;41855
926;"14.07.2008";1;"52.1";1782;41579;39797
926;"14.07.2008";2;43;1842;40641;38799
926;"14.07.2008";3;"35.3";1950;40219;38269
926;"14.07.2008";4;"31.1";1995;40317;38322
926;"14.07.2008";5;"37.6";2163;41853;39690
926;"14.07.2008";6;"41.6";2153;43704;41551
926;"14.07.2008";7;"62.7";1962;50645;48683
926;"14.07.2008";8;"87.8";1345;57485;56140
926;"14.07.2008";9;"83.1";1345;61239;59894
926;"14.07.2008";10;"85.9";1675;62377;60702
926;"14.07.2008";11;"93.7";1937;63564;61627
926;"14.07.2008";12;"106.5";2073;65161;63088
926;"14.07.2008";13;"96.3";2388;64496;62108
926;"14.07.2008";14;92;2797;63909;61112
926;"14.07.2008";15;86;3277;62904;59627
926;"14.07.2008";16;"84.6";3539;62120;58581
926;"14.07.2008";17;"78.7";4105;60811;56706
926;"14.07.2008";18;"77.3";4196;60314;56118
926;"14.07.2008";19;"77.1";3820;59857;56037
926;"14.07.2008";20;"75.5";3039;58837;55798
926;"14.07.2008";21;"77.2";2277;56323;54046
926;"14.07.2008";22;"72.1";2120;54671;52551
926;"14.07.2008";23;"70.4";2742;53346;50604
926;"14.07.2008";24;"63.1";3347;49476;46129
927;"15.07.2008";1;"45.1";3447;46014;42567
927;"15.07.2008";2;"34.5";3586;44829;41243
927;"15.07.2008";3;"25.8";3650;43982;40332
927;"15.07.2008";4;"21.1";3670;43983;40313
927;"15.07.2008";5;"25.6";3539;44920;41381
927;"15.07.2008";6;40;3253;46705;43452
927;"15.07.2008";7;"54.1";2958;53415;50457
927;"15.07.2008";8;"78.1";2629;58798;56169
927;"15.07.2008";9;"85.3";2517;62131;59614
927;"15.07.2008";10;"94.9";3057;62587;59530
927;"15.07.2008";11;"100.9";3939;63914;59975
927;"15.07.2008";12;"122.2";4445;65461;61016
927;"15.07.2008";13;102;4791;64717;59926
927;"15.07.2008";14;"96.1";5026;63837;58811
927;"15.07.2008";15;"91.6";4912;62675;57763
927;"15.07.2008";16;"85.2";4839;61564;56725
927;"15.07.2008";17;"85.1";4635;60247;55612
927;"15.07.2008";18;"82.8";4328;60145;55817
927;"15.07.2008";19;84;4002;59903;55901
927;"15.07.2008";20;"77.9";3443;58753;55310
927;"15.07.2008";21;77;3024;56578;53554
927;"15.07.2008";22;69;2724;55473;52749
927;"15.07.2008";23;72;2662;53709;51047
927;"15.07.2008";24;"63.5";2658;49819;47161
928;"16.07.2008";1;56;2855;46716;43861
928;"16.07.2008";2;"50.2";2795;45787;42992
928;"16.07.2008";3;31;2611;44896;42285
928;"16.07.2008";4;30;2340;44747;42407
928;"16.07.2008";5;"31.5";2173;45681;43508
928;"16.07.2008";6;"38.6";2173;47988;45815
928;"16.07.2008";7;"57.6";2162;54102;51940
928;"16.07.2008";8;"72.2";1845;59440;57595
928;"16.07.2008";9;84;1949;62648;60699
928;"16.07.2008";10;"88.7";2268;63591;61323
928;"16.07.2008";11;98;2498;64817;62319
928;"16.07.2008";12;"108.5";3217;66248;63031
928;"16.07.2008";13;"98.3";3800;65430;61630
928;"16.07.2008";14;"96.3";4200;64476;60276
928;"16.07.2008";15;"91.1";4730;63418;58688
928;"16.07.2008";16;"87.1";4997;62582;57585
928;"16.07.2008";17;"85.3";5118;60887;55769
928;"16.07.2008";18;80;4718;60466;55748
928;"16.07.2008";19;"78.9";4161;60214;56053
928;"16.07.2008";20;75;3584;59281;55697
928;"16.07.2008";21;"69.2";3147;56892;53745
928;"16.07.2008";22;"66.5";2767;55306;52539
928;"16.07.2008";23;"73.4";2681;53744;51063
928;"16.07.2008";24;"66.5";2913;49623;46710
929;"17.07.2008";1;"69.5";3107;47238;44131
929;"17.07.2008";2;"58.9";2898;45657;42759
929;"17.07.2008";3;"47.4";2899;44492;41593
929;"17.07.2008";4;"39.9";2832;44559;41727
929;"17.07.2008";5;"42.7";2633;45582;42949
929;"17.07.2008";6;60;2401;47863;45462
929;"17.07.2008";7;"67.4";2077;53647;51570
929;"17.07.2008";8;"75.8";1566;58872;57306
929;"17.07.2008";9;"87.5";1342;62296;60954
929;"17.07.2008";10;"93.1";1543;63519;61976
929;"17.07.2008";11;100;1799;65197;63398
929;"17.07.2008";12;"120.1";2040;66696;64656
929;"17.07.2008";13;"99.5";1962;65726;63764
929;"17.07.2008";14;"95.1";2119;64620;62501
929;"17.07.2008";15;"93.3";1928;63705;61777
929;"17.07.2008";16;"87.5";1724;62622;60898
929;"17.07.2008";17;85;1540;61579;60039
929;"17.07.2008";18;83;1370;61398;60028
929;"17.07.2008";19;"84.5";1278;61231;59953
929;"17.07.2008";20;"77.9";1043;59883;58840
929;"17.07.2008";21;80;999;57293;56294
929;"17.07.2008";22;"74.9";931;56023;55092
929;"17.07.2008";23;"76.9";1192;53628;52436
929;"17.07.2008";24;"67.1";1446;49569;48123
930;"18.07.2008";1;"65.3";1562;46836;45274
930;"18.07.2008";2;"59.5";1658;45417;43759
930;"18.07.2008";3;"41.2";1736;44399;42663
930;"18.07.2008";4;"30.2";1733;44447;42714
930;"18.07.2008";5;"24.1";1732;45270;43538
930;"18.07.2008";6;"48.2";1745;47681;45936
930;"18.07.2008";7;"66.3";1778;53908;52130
930;"18.07.2008";8;"83.8";1777;59456;57679
930;"18.07.2008";9;"86.9";1749;63119;61370
930;"18.07.2008";10;"96.8";1895;64162;62267
930;"18.07.2008";11;100;2242;65157;62915
930;"18.07.2008";12;"110.6";2673;66287;63614
930;"18.07.2008";13;"97.6";3030;65140;62110
930;"18.07.2008";14;"90.1";3242;63329;60087
930;"18.07.2008";15;"87.1";3064;61809;58745
930;"18.07.2008";16;"82.9";2944;59671;56727
930;"18.07.2008";17;"80.9";2632;59649;57017
930;"18.07.2008";18;"80.9";2327;59422;57095
930;"18.07.2008";19;78;2026;58656;56630
930;"18.07.2008";20;"76.1";1638;57300;55662
930;"18.07.2008";21;75;1637;54575;52938
930;"18.07.2008";22;"71.7";1684;53399;51715
930;"18.07.2008";23;"74.9";2035;51640;49605
930;"18.07.2008";24;"65.1";2264;47605;45341
931;"19.07.2008";1;"64.2";2530;44897;42367
931;"19.07.2008";2;"52.2";2584;42637;40053
931;"19.07.2008";3;"41.1";2528;41526;38998
931;"19.07.2008";4;"27.1";2583;41036;38453
931;"19.07.2008";5;28;2608;40769;38161
931;"19.07.2008";6;"41.2";2635;41614;38979
931;"19.07.2008";7;"48.1";2842;43628;40786
931;"19.07.2008";8;"53.5";3028;46461;43433
931;"19.07.2008";9;58;3327;49400;46073
931;"19.07.2008";10;"70.2";3974;52029;48055
931;"19.07.2008";11;84;4731;53468;48737
931;"19.07.2008";12;79;5781;54246;48465
931;"19.07.2008";13;80;6465;53043;46578
931;"19.07.2008";14;"67.4";7109;50823;43714
931;"19.07.2008";15;"60.1";7316;49092;41776
931;"19.07.2008";16;"58.1";7313;48211;40898
931;"19.07.2008";17;54;6784;47984;41200
931;"19.07.2008";18;"58.9";6027;48886;42859
931;"19.07.2008";19;"59.7";5628;49154;43526
931;"19.07.2008";20;60;5071;48566;43495
931;"19.07.2008";21;"55.7";4346;46570;42224
931;"19.07.2008";22;"52.5";3700;45766;42066
931;"19.07.2008";23;66;4037;45573;41536
931;"19.07.2008";24;60;4496;42293;37797
932;"20.07.2008";1;"35.9";4829;40426;35597
932;"20.07.2008";2;"10.5";5235;39201;33966
932;"20.07.2008";3;"11.8";5277;38724;33447
932;"20.07.2008";4;"8.6";5185;38126;32941
932;"20.07.2008";5;4;4876;37889;33013
932;"20.07.2008";6;"1.1";4929;37348;32419
932;"20.07.2008";7;0;4343;37886;33543
932;"20.07.2008";8;"5.1";3820;39669;35849
932;"20.07.2008";9;"32.6";3985;41685;37700
932;"20.07.2008";10;"41.1";4726;43682;38956
932;"20.07.2008";11;"49.1";5240;45935;40695
932;"20.07.2008";12;"58.2";5388;48328;42940
932;"20.07.2008";13;"47.8";5356;47380;42024
932;"20.07.2008";14;"40.5";5479;45325;39846
932;"20.07.2008";15;"35.6";5210;43987;38777
932;"20.07.2008";16;"32.6";5148;43125;37977
932;"20.07.2008";17;"27.1";4838;43079;38241
932;"20.07.2008";18;40;5047;44251;39204
932;"20.07.2008";19;"41.1";4851;45937;41086
932;"20.07.2008";20;"49.5";4188;45966;41778
932;"20.07.2008";21;"41.7";3982;45455;41473
932;"20.07.2008";22;"42.7";4240;45872;41632
932;"20.07.2008";23;"53.1";4539;46592;42053
932;"20.07.2008";24;"42.1";5205;43056;37851
933;"21.07.2008";1;40;6251;41192;34941
933;"21.07.2008";2;"16.1";7374;40585;33211
933;"21.07.2008";3;7;8041;40416;32375
933;"21.07.2008";4;3;8614;40972;32358
933;"21.07.2008";5;"3.5";9200;42175;32975
933;"21.07.2008";6;"24.1";9287;44070;34783
933;"21.07.2008";7;"41.2";9497;50886;41389
933;"21.07.2008";8;"69.2";9740;57949;48209
933;"21.07.2008";9;"72.8";10344;61698;51354
933;"21.07.2008";10;"74.7";10951;62927;51976
933;"21.07.2008";11;81;11464;64636;53172
933;"21.07.2008";12;"91.2";10939;66438;55499
933;"21.07.2008";13;"82.3";10303;65801;55498
933;"21.07.2008";14;77;9857;64654;54797
933;"21.07.2008";15;"70.7";9481;64023;54542
933;"21.07.2008";16;"69.9";8821;62340;53519
933;"21.07.2008";17;"70.4";8698;60982;52284
933;"21.07.2008";18;"69.7";7936;60570;52634
933;"21.07.2008";19;70;7327;60387;53060
933;"21.07.2008";20;"69.5";6657;59283;52626
933;"21.07.2008";21;"69.5";5966;56741;50775
933;"21.07.2008";22;"67.7";5522;55331;49809
933;"21.07.2008";23;"66.1";5409;52636;47227
933;"21.07.2008";24;55;5363;48505;43142
934;"22.07.2008";1;"42.8";5277;46219;40942
934;"22.07.2008";2;"35.6";5027;44658;39631
934;"22.07.2008";3;"27.1";4533;43534;39001
934;"22.07.2008";4;"18.2";4202;43662;39460
934;"22.07.2008";5;"20.8";4108;45030;40922
934;"22.07.2008";6;"41.2";3344;47469;44125
934;"22.07.2008";7;"54.1";2862;52552;49690
934;"22.07.2008";8;"70.2";2465;58133;55668
934;"22.07.2008";9;"72.9";2317;61855;59538
934;"22.07.2008";10;"88.1";2484;63046;60562
934;"22.07.2008";11;95;2590;64349;61759
934;"22.07.2008";12;102;2583;65596;63013
934;"22.07.2008";13;"94.1";2392;64527;62135
934;"22.07.2008";14;83;2350;63120;60770
934;"22.07.2008";15;"82.4";2343;62028;59685
934;"22.07.2008";16;"83.5";2473;61117;58644
934;"22.07.2008";17;"78.8";2629;59792;57163
934;"22.07.2008";18;75;2515;59339;56824
934;"22.07.2008";19;"72.3";2431;59044;56613
934;"22.07.2008";20;"68.9";2143;57997;55854
934;"22.07.2008";21;"70.1";1802;55868;54066
934;"22.07.2008";22;68;1614;54806;53192
934;"22.07.2008";23;72;1577;52897;51320
934;"22.07.2008";24;"60.4";1384;48701;47317
935;"23.07.2008";1;"49.3";1259;46067;44808
935;"23.07.2008";2;42;1158;43880;42722
935;"23.07.2008";3;"32.7";1095;43512;42417
935;"23.07.2008";4;"32.5";987;43624;42637
935;"23.07.2008";5;"32.5";729;44695;43966
935;"23.07.2008";6;"45.1";655;46918;46263
935;"23.07.2008";7;"61.1";535;52629;52094
935;"23.07.2008";8;"71.7";233;57966;57733
935;"23.07.2008";9;"68.3";142;61019;60877
935;"23.07.2008";10;"76.1";129;61870;61741
935;"23.07.2008";11;"89.6";137;63157;63020
935;"23.07.2008";12;96;170;64423;64253
935;"23.07.2008";13;86;249;63590;63341
935;"23.07.2008";14;86;349;62657;62308
935;"23.07.2008";15;"84.2";395;61584;61189
935;"23.07.2008";16;"79.7";457;60737;60280
935;"23.07.2008";17;"73.6";522;59456;58934
935;"23.07.2008";18;67;619;59175;58556
935;"23.07.2008";19;"66.3";714;58837;58123
935;"23.07.2008";20;"63.8";743;57841;57098
935;"23.07.2008";21;70;734;55631;54897
935;"23.07.2008";22;"69.6";1047;54776;53729
935;"23.07.2008";23;"70.1";1363;53253;51890
935;"23.07.2008";24;60;1717;48733;47016
936;"24.07.2008";1;"61.4";2012;46157;44145
936;"24.07.2008";2;"52.2";2142;44507;42365
936;"24.07.2008";3;41;2050;43440;41390
936;"24.07.2008";4;"32.6";1986;43470;41484
936;"24.07.2008";5;"32.7";1761;44703;42942
936;"24.07.2008";6;"38.6";1578;46860;45282
936;"24.07.2008";7;"58.6";1364;51985;50621
936;"24.07.2008";8;78;1002;57239;56237
936;"24.07.2008";9;"77.4";592;60431;59839
936;"24.07.2008";10;"87.4";723;61372;60649
936;"24.07.2008";11;"91.2";1079;62231;61152
936;"24.07.2008";12;"97.6";1642;63724;62082
936;"24.07.2008";13;95;2174;62772;60598
936;"24.07.2008";14;90;2742;61876;59134
936;"24.07.2008";15;87;3148;61132;57984
936;"24.07.2008";16;"83.1";3555;60456;56901
936;"24.07.2008";17;"78.4";3980;59285;55305
936;"24.07.2008";18;"78.9";4380;59559;55179
936;"24.07.2008";19;"78.3";4618;59557;54939
936;"24.07.2008";20;73;4246;58353;54107
936;"24.07.2008";21;"71.9";3579;56000;52421
936;"24.07.2008";22;"69.9";3601;55089;51488
936;"24.07.2008";23;"70.4";4218;53717;49499
936;"24.07.2008";24;"63.1";4465;49582;45117
937;"25.07.2008";1;58;4379;46969;42590
937;"25.07.2008";2;"52.1";3861;45072;41211
937;"25.07.2008";3;"43.2";3274;43815;40541
937;"25.07.2008";4;"38.5";2984;43577;40593
937;"25.07.2008";5;"41.9";2720;44461;41741
937;"25.07.2008";6;"52.1";2539;47051;44512
937;"25.07.2008";7;"61.4";2389;52903;50514
937;"25.07.2008";8;"74.9";2030;57938;55908
937;"25.07.2008";9;"75.5";1547;61060;59513
937;"25.07.2008";10;"88.1";1359;62238;60879
937;"25.07.2008";11;"87.9";1446;63197;61751
937;"25.07.2008";12;"95.1";1962;64207;62245
937;"25.07.2008";13;94;2552;63146;60594
937;"25.07.2008";14;"87.8";3066;61303;58237
937;"25.07.2008";15;81;3558;59732;56174
937;"25.07.2008";16;78;3589;58824;55235
937;"25.07.2008";17;"75.5";3745;58414;54669
937;"25.07.2008";18;"74.1";3689;58634;54945
937;"25.07.2008";19;"74.1";3547;58539;54992
937;"25.07.2008";20;"70.6";3270;57546;54276
937;"25.07.2008";21;"71.8";3230;54413;51183
937;"25.07.2008";22;"70.1";3376;53435;50059
937;"25.07.2008";23;"70.1";3354;52101;48747
937;"25.07.2008";24;"60.6";3177;48129;44952
938;"26.07.2008";1;63;2972;45708;42736
938;"26.07.2008";2;54;2764;43857;41093
938;"26.07.2008";3;"54.4";2576;43440;40864
938;"26.07.2008";4;52;2564;42902;40338
938;"26.07.2008";5;"46.3";2395;42652;40257
938;"26.07.2008";6;45;2169;42372;40203
938;"26.07.2008";7;"44.5";2016;44282;42266
938;"26.07.2008";8;"54.7";1489;46617;45128
938;"26.07.2008";9;"60.1";809;49556;48747
938;"26.07.2008";10;75;590;52304;51714
938;"26.07.2008";11;"75.2";519;53675;53156
938;"26.07.2008";12;80;838;54683;53845
938;"26.07.2008";13;"81.2";1499;53495;51996
938;"26.07.2008";14;"71.9";1978;51241;49263
938;"26.07.2008";15;70;2415;49801;47386
938;"26.07.2008";16;"67.2";2794;49384;46590
938;"26.07.2008";17;"68.5";3226;49362;46136
938;"26.07.2008";18;"68.1";3466;50251;46785
938;"26.07.2008";19;71;3458;50672;47214
938;"26.07.2008";20;"71.4";3454;49950;46496
938;"26.07.2008";21;"68.7";3159;47449;44290
938;"26.07.2008";22;"67.9";3189;46847;43658
938;"26.07.2008";23;"71.1";3332;46605;43273
938;"26.07.2008";24;"62.1";3210;43424;40214
939;"27.07.2008";1;"47.2";2877;41494;38617
939;"27.07.2008";2;"41.6";2705;40116;37411
939;"27.07.2008";3;"33.6";2404;38815;36411
939;"27.07.2008";4;"30.5";2201;38167;35966
939;"27.07.2008";5;"24.8";2052;38185;36133
939;"27.07.2008";6;"21.1";2132;37513;35381
939;"27.07.2008";7;"13.8";1696;37792;36096
939;"27.07.2008";8;"27.2";1045;39859;38814
939;"27.07.2008";9;"42.9";638;42362;41724
939;"27.07.2008";10;"53.1";405;44202;43797
939;"27.07.2008";11;"56.9";460;45610;45150
939;"27.07.2008";12;"62.7";944;47668;46724
939;"27.07.2008";13;"63.3";1413;46616;45203
939;"27.07.2008";14;"56.3";1546;44731;43185
939;"27.07.2008";15;"53.1";1723;43531;41808
939;"27.07.2008";16;"47.8";1874;43060;41186
939;"27.07.2008";17;"50.2";2101;43197;41096
939;"27.07.2008";18;"53.1";2516;44629;42113
939;"27.07.2008";19;"58.4";2540;46454;43914
939;"27.07.2008";20;61;2285;47005;44720
939;"27.07.2008";21;"58.3";2062;46612;44550
939;"27.07.2008";22;"58.4";2381;47487;45106
939;"27.07.2008";23;"58.3";2752;47822;45070
939;"27.07.2008";24;"55.6";2948;44218;41270
940;"28.07.2008";1;"41.1";3109;42187;39078
940;"28.07.2008";2;"36.8";3174;41599;38425
940;"28.07.2008";3;"31.5";3211;40818;37607
940;"28.07.2008";4;"30.6";3054;40710;37656
940;"28.07.2008";5;"32.3";2786;41929;39143
940;"28.07.2008";6;"39.3";2526;44608;42082
940;"28.07.2008";7;"58.5";2362;50649;48287
940;"28.07.2008";8;"81.4";1805;57160;55355
940;"28.07.2008";9;"85.4";982;60814;59832
940;"28.07.2008";10;"86.1";698;62218;61520
940;"28.07.2008";11;"94.7";839;63387;62548
940;"28.07.2008";12;108;1655;64672;63017
940;"28.07.2008";13;"99.1";2654;63926;61272
940;"28.07.2008";14;"92.1";3123;63170;60047
940;"28.07.2008";15;"88.2";3208;62411;59203
940;"28.07.2008";16;"83.5";3179;61655;58476
940;"28.07.2008";17;"80.1";3099;60749;57650
940;"28.07.2008";18;79;3039;60722;57683
940;"28.07.2008";19;"79.2";2902;60528;57626
940;"28.07.2008";20;77;2487;59369;56882
940;"28.07.2008";21;"74.6";2400;56919;54519
940;"28.07.2008";22;"72.4";3380;56275;52895
940;"28.07.2008";23;"70.8";4120;54177;50057
940;"28.07.2008";24;60;4441;50147;45706
941;"29.07.2008";1;"63.6";4683;47736;43053
941;"29.07.2008";2;57;4961;46204;41243
941;"29.07.2008";3;51;4624;44790;40166
941;"29.07.2008";4;"46.3";4490;44378;39888
941;"29.07.2008";5;"44.6";4047;45170;41123
941;"29.07.2008";6;"58.7";3739;47800;44061
941;"29.07.2008";7;"65.8";3457;53370;49913
941;"29.07.2008";8;"80.8";2630;58744;56114
941;"29.07.2008";9;"79.9";1617;62011;60394
941;"29.07.2008";10;"90.1";1271;63232;61961
941;"29.07.2008";11;"93.1";1400;64583;63183
941;"29.07.2008";12;"105.5";1822;66051;64229
941;"29.07.2008";13;"95.1";2226;65052;62826
941;"29.07.2008";14;"92.7";2454;64076;61622
941;"29.07.2008";15;"89.9";2753;62985;60232
941;"29.07.2008";16;"86.2";3094;62068;58974
941;"29.07.2008";17;"78.1";3220;61025;57805
941;"29.07.2008";18;"73.4";3978;61430;57452
941;"29.07.2008";19;"76.9";3514;61219;57705
941;"29.07.2008";20;74;3155;59809;56654
941;"29.07.2008";21;"75.7";3108;57727;54619
941;"29.07.2008";22;75;2795;56675;53880
941;"29.07.2008";23;"74.9";2581;54012;51431
941;"29.07.2008";24;"65.9";2071;49821;47750
942;"30.07.2008";1;60;1753;47391;45638
942;"30.07.2008";2;57;1575;45660;44085
942;"30.07.2008";3;52;1159;44453;43294
942;"30.07.2008";4;44;1114;44538;43424
942;"30.07.2008";5;"48.9";1239;45437;44198
942;"30.07.2008";6;"57.2";1119;47929;46810
942;"30.07.2008";7;"62.8";887;53429;52542
942;"30.07.2008";8;77;642;58663;58021
942;"30.07.2008";9;"77.9";467;61785;61318
942;"30.07.2008";10;"88.1";363;62748;62385
942;"30.07.2008";11;95;356;63879;63523
942;"30.07.2008";12;"108.4";372;64999;64627
942;"30.07.2008";13;"101.9";411;64146;63735
942;"30.07.2008";14;"98.2";453;63269;62816
942;"30.07.2008";15;99;468;62185;61717
942;"30.07.2008";16;"94.4";555;61383;60828
942;"30.07.2008";17;"87.1";667;60474;59807
942;"30.07.2008";18;"83.1";786;60426;59640
942;"30.07.2008";19;"79.8";925;60298;59373
942;"30.07.2008";20;"75.8";1012;59245;58233
942;"30.07.2008";21;"79.5";1272;57130;55858
942;"30.07.2008";22;"77.9";1750;56366;54616
942;"30.07.2008";23;"76.6";2102;54233;52131
942;"30.07.2008";24;"67.5";2222;50108;47886
943;"31.07.2008";1;"67.4";2144;47599;45455
943;"31.07.2008";2;60;2038;45717;43679
943;"31.07.2008";3;"49.9";2063;44551;42488
943;"31.07.2008";4;"44.4";2223;44562;42339
943;"31.07.2008";5;"44.4";2220;45481;43261
943;"31.07.2008";6;"57.1";2188;47785;45597
943;"31.07.2008";7;"64.8";2169;53362;51193
943;"31.07.2008";8;"76.7";1769;58629;56860
943;"31.07.2008";9;"83.1";1170;61518;60348
943;"31.07.2008";10;89;1099;62525;61426
943;"31.07.2008";11;"96.6";1492;63667;62175
943;"31.07.2008";12;"105.8";2060;64864;62804
943;"31.07.2008";13;97;2428;63748;61320
943;"31.07.2008";14;"94.7";2549;62943;60394
943;"31.07.2008";15;"93.1";2576;61938;59362
943;"31.07.2008";16;"88.4";2546;61082;58536
943;"31.07.2008";17;83;2474;60258;57784
943;"31.07.2008";18;80;2496;60520;58024
943;"31.07.2008";19;"78.4";2242;60331;58089
943;"31.07.2008";20;"75.5";2235;59381;57146
943;"31.07.2008";21;"77.9";2601;56947;54346
943;"31.07.2008";22;"74.9";3608;56637;53029
943;"31.07.2008";23;75;4350;55010;50660
943;"31.07.2008";24;"65.9";4450;51269;46819
944;"01.08.2008";1;"52.1";4437;47490;43053
944;"01.08.2008";2;"41.2";4337;45755;41419
944;"01.08.2008";3;"37.9";4288;45049;40761
944;"01.08.2008";4;32;4204;45071;40867
944;"01.08.2008";5;"32.7";3643;45670;42027
944;"01.08.2008";6;"44.5";3255;48351;45096
944;"01.08.2008";7;"53.1";2899;53346;50447
944;"01.08.2008";8;"70.6";2246;58410;56164
944;"01.08.2008";9;"76.5";1598;61996;60398
944;"01.08.2008";10;"87.9";1362;63216;61854
944;"01.08.2008";11;95;1434;64418;62984
944;"01.08.2008";12;"95.1";1886;65818;63932
944;"01.08.2008";13;95;2156;64475;62319
944;"01.08.2008";14;"79.7";2583;62922;60339
944;"01.08.2008";15;"79.1";2917;61127;58210
944;"01.08.2008";16;"71.4";3083;59771;56688
944;"01.08.2008";17;72;3407;58886;55479
944;"01.08.2008";18;75;3326;58809;55483
944;"01.08.2008";19;"78.1";3609;58446;54837
944;"01.08.2008";20;"74.7";3141;57359;54218
944;"01.08.2008";21;"71.1";2240;54721;52481
944;"01.08.2008";22;"67.4";1690;53678;51988
944;"01.08.2008";23;75;1475;51438;49963
944;"01.08.2008";24;"58.7";1430;47538;46108
945;"02.08.2008";1;"68.4";1451;44834;43383
945;"02.08.2008";2;"57.5";1751;43076;41325
945;"02.08.2008";3;"42.8";2131;42180;40049
945;"02.08.2008";4;"37.5";2200;41581;39381
945;"02.08.2008";5;"49.9";2094;42098;40004
945;"02.08.2008";6;"44.1";1882;42486;40604
945;"02.08.2008";7;38;1869;43704;41835
945;"02.08.2008";8;"46.8";1499;45854;44356
945;"02.08.2008";9;"67.3";962;48613;47651
945;"02.08.2008";10;"72.6";1035;51011;49976
945;"02.08.2008";11;"78.3";1550;52496;50946
945;"02.08.2008";12;"81.9";2097;53378;51281
945;"02.08.2008";13;"79.2";2509;52044;49535
945;"02.08.2008";14;"73.2";2638;49940;47302
945;"02.08.2008";15;"70.7";2260;48363;46103
945;"02.08.2008";16;"67.8";2193;47896;45703
945;"02.08.2008";17;68;2013;47487;45474
945;"02.08.2008";18;"64.1";1895;48325;46430
945;"02.08.2008";19;67;1947;48704;46757
945;"02.08.2008";20;"62.3";1836;48252;46416
945;"02.08.2008";21;"59.2";1833;46804;44972
945;"02.08.2008";22;60;2313;46992;44679
945;"02.08.2008";23;68;2767;45777;43010
945;"02.08.2008";24;"59.9";3129;42833;39704
946;"03.08.2008";1;40;3173;40981;37808
946;"03.08.2008";2;"30.9";3594;39996;36402
946;"03.08.2008";3;"20.1";3809;39023;35214
946;"03.08.2008";4;"14.9";3946;38355;34409
946;"03.08.2008";5;"10.7";3872;38353;34481
946;"03.08.2008";6;7;4031;38280;34250
946;"03.08.2008";7;"6.8";4273;38576;34303
946;"03.08.2008";8;"12.7";3980;40599;36619
946;"03.08.2008";9;"28.3";4364;42900;38536
946;"03.08.2008";10;"35.9";5154;44545;39391
946;"03.08.2008";11;"39.6";5809;46584;40775
946;"03.08.2008";12;"45.6";6096;48782;42686
946;"03.08.2008";13;"45.1";6365;47793;41428
946;"03.08.2008";14;"41.9";6176;45801;39625
946;"03.08.2008";15;"36.7";5853;44284;38431
946;"03.08.2008";16;"32.5";5285;43439;38154
946;"03.08.2008";17;"33.3";4558;43241;38683
946;"03.08.2008";18;"41.6";3915;44567;40652
946;"03.08.2008";19;46;2906;46140;43234
946;"03.08.2008";20;"51.2";2215;46476;44261
946;"03.08.2008";21;"45.1";1987;46214;44227
946;"03.08.2008";22;"52.1";2216;47573;45357
946;"03.08.2008";23;"54.8";2555;47150;44595
946;"03.08.2008";24;"45.1";3026;43961;40935
947;"04.08.2008";1;"37.4";3907;42132;38225
947;"04.08.2008";2;"25.3";4632;41640;37008
947;"04.08.2008";3;15;5373;41321;35948
947;"04.08.2008";4;"10.8";6271;41765;35494
947;"04.08.2008";5;"14.6";7532;43248;35716
947;"04.08.2008";6;22;8492;46499;38007
947;"04.08.2008";7;"45.6";9198;52480;43282
947;"04.08.2008";8;"65.1";9850;58608;48758
947;"04.08.2008";9;"64.8";9847;62062;52215
947;"04.08.2008";10;68;9816;63306;53490
947;"04.08.2008";11;74;10699;64669;53970
947;"04.08.2008";12;"79.9";11816;66587;54771
947;"04.08.2008";13;75;12631;65979;53348
947;"04.08.2008";14;"71.9";13479;65204;51725
947;"04.08.2008";15;"67.7";13913;63774;49861
947;"04.08.2008";16;"69.8";14136;62799;48663
947;"04.08.2008";17;"66.3";14223;61510;47287
947;"04.08.2008";18;"64.8";13778;61028;47250
947;"04.08.2008";19;"65.2";13004;60588;47584
947;"04.08.2008";20;"62.9";11134;59406;48272
947;"04.08.2008";21;"67.4";8960;56931;47971
947;"04.08.2008";22;"66.6";8030;56301;48271
947;"04.08.2008";23;"62.9";7588;53320;45732
947;"04.08.2008";24;"53.1";7635;49301;41666
948;"05.08.2008";1;"29.6";7402;47077;39675
948;"05.08.2008";2;"7.8";7541;45238;37697
948;"05.08.2008";3;"7.9";7679;44172;36493
948;"05.08.2008";4;"2.5";7561;44148;36587
948;"05.08.2008";5;"7.4";7807;45510;37703
948;"05.08.2008";6;"16.1";7718;48643;40925
948;"05.08.2008";7;"55.7";7751;53797;46046
948;"05.08.2008";8;63;7911;58835;50924
948;"05.08.2008";9;"64.9";7898;62220;54322
948;"05.08.2008";10;69;8990;63325;54335
948;"05.08.2008";11;72;9332;64483;55151
948;"05.08.2008";12;"80.1";9202;65709;56507
948;"05.08.2008";13;"77.8";9485;64879;55394
948;"05.08.2008";14;"73.1";9104;63842;54738
948;"05.08.2008";15;"71.9";8660;62677;54017
948;"05.08.2008";16;"70.2";7823;61465;53642
948;"05.08.2008";17;"65.3";7217;60261;53044
948;"05.08.2008";18;"69.9";6293;59663;53370
948;"05.08.2008";19;"72.1";5260;59184;53924
948;"05.08.2008";20;"71.1";3821;58070;54249
948;"05.08.2008";21;"66.1";2533;55791;53258
948;"05.08.2008";22;"67.4";1935;55903;53968
948;"05.08.2008";23;"66.1";1858;53015;51157
948;"05.08.2008";24;"58.5";1733;48573;46840
949;"06.08.2008";1;"57.9";1489;45973;44484
949;"06.08.2008";2;"43.7";1327;44441;43114
949;"06.08.2008";3;42;1183;43444;42261
949;"06.08.2008";4;42;1158;43319;42162
949;"06.08.2008";5;"43.7";1144;44090;42946
949;"06.08.2008";6;"53.8";1118;46900;45782
949;"06.08.2008";7;"60.9";1209;52545;51336
949;"06.08.2008";8;"75.7";1245;57814;56570
949;"06.08.2008";9;"69.6";936;60892;59956
949;"06.08.2008";10;"77.8";769;61831;61062
949;"06.08.2008";11;81;668;63049;62381
949;"06.08.2008";12;"91.6";732;64192;63460
949;"06.08.2008";13;91;845;63364;62519
949;"06.08.2008";14;90;907;62499;61592
949;"06.08.2008";15;85;948;61545;60597
949;"06.08.2008";16;"83.8";836;60725;59889
949;"06.08.2008";17;"75.1";775;59947;59172
949;"06.08.2008";18;70;611;59741;59130
949;"06.08.2008";19;"71.1";460;59516;59056
949;"06.08.2008";20;64;411;58738;58327
949;"06.08.2008";21;"68.9";566;56518;55952
949;"06.08.2008";22;"68.9";1029;56634;55605
949;"06.08.2008";23;69;1507;54022;52515
949;"06.08.2008";24;"60.4";1817;49970;48153
950;"07.08.2008";1;"51.3";2456;47211;44755
950;"07.08.2008";2;44;2655;46214;43559
950;"07.08.2008";3;"34.9";2723;45037;42314
950;"07.08.2008";4;"33.3";2913;45010;42097
950;"07.08.2008";5;"34.9";2623;45478;42855
950;"07.08.2008";6;"35.1";2523;47689;45166
950;"07.08.2008";7;"55.6";2421;52632;50211
950;"07.08.2008";8;"68.9";2083;57767;55684
950;"07.08.2008";9;"68.9";1524;61214;59690
950;"07.08.2008";10;77;1248;62270;61022
950;"07.08.2008";11;82;1668;63520;61852
950;"07.08.2008";12;92;2275;64756;62481
950;"07.08.2008";13;"84.3";2722;64089;61367
950;"07.08.2008";14;"74.9";3223;63405;60182
950;"07.08.2008";15;"76.1";3737;62961;59224
950;"07.08.2008";16;68;4272;62330;58058
950;"07.08.2008";17;"62.7";5022;61380;56358
950;"07.08.2008";18;"59.2";5821;61149;55328
950;"07.08.2008";19;"56.3";6376;61013;54637
950;"07.08.2008";20;"52.1";6075;60557;54482
950;"07.08.2008";21;"62.7";6592;58819;52227
950;"07.08.2008";22;"65.4";7070;58186;51116
950;"07.08.2008";23;"62.5";6807;54642;47835
950;"07.08.2008";24;"50.1";5872;50636;44764
951;"08.08.2008";1;47;4982;48213;43232
951;"08.08.2008";2;"34.8";4222;46248;42026
951;"08.08.2008";3;"28.7";4227;45191;40964
951;"08.08.2008";4;"28.7";3945;45072;41127
951;"08.08.2008";5;"34.9";3517;45813;42296
951;"08.08.2008";6;"44.7";3317;48737;45420
951;"08.08.2008";7;"58.4";3156;53550;50394
951;"08.08.2008";8;"69.9";2998;58505;55507
951;"08.08.2008";9;"71.8";2883;61735;58852
951;"08.08.2008";10;73;3222;63035;59813
951;"08.08.2008";11;"76.1";3926;64277;60351
951;"08.08.2008";12;85;4515;65457;60942
951;"08.08.2008";13;"80.1";5149;64383;59234
951;"08.08.2008";14;"75.3";5605;62585;56980
951;"08.08.2008";15;"70.1";5635;60774;55139
951;"08.08.2008";16;"68.2";5394;59427;54033
951;"08.08.2008";17;"64.9";5437;58318;52881
951;"08.08.2008";18;"64.9";5679;58498;52819
951;"08.08.2008";19;"66.2";5277;58274;52997
951;"08.08.2008";20;"64.9";5144;56977;51833
951;"08.08.2008";21;"66.6";4491;54535;50044
951;"08.08.2008";22;"67.1";4531;54147;49616
951;"08.08.2008";23;"65.1";4829;51425;46596
951;"08.08.2008";24;50;5184;47956;42772
952;"09.08.2008";1;40;5402;45424;40022
952;"09.08.2008";2;"36.3";5206;43707;38501
952;"09.08.2008";3;35;5017;43290;38273
952;"09.08.2008";4;"28.5";4932;42992;38060
952;"09.08.2008";5;"23.7";4941;42937;37996
952;"09.08.2008";6;26;4812;43282;38470
952;"09.08.2008";7;"33.6";4527;44395;39868
952;"09.08.2008";8;"36.3";4097;46695;42598
952;"09.08.2008";9;"48.6";4031;49427;45396
952;"09.08.2008";10;62;4783;51987;47204
952;"09.08.2008";11;66;5272;53724;48452
952;"09.08.2008";12;70;5294;54607;49313
952;"09.08.2008";13;"66.7";5428;53166;47738
952;"09.08.2008";14;"57.4";5530;51004;45474
952;"09.08.2008";15;"52.5";5359;49354;43995
952;"09.08.2008";16;"52.6";5385;48370;42985
952;"09.08.2008";17;"52.7";4716;47837;43121
952;"09.08.2008";18;"56.1";3965;48430;44465
952;"09.08.2008";19;"61.9";3132;48950;45818
952;"09.08.2008";20;"65.6";2284;48453;46169
952;"09.08.2008";21;62;1668;47005;45337
952;"09.08.2008";22;"65.1";2203;47514;45311
952;"09.08.2008";23;"65.5";2961;45759;42798
952;"09.08.2008";24;"50.4";3401;42640;39239
953;"10.08.2008";1;"34.9";3700;41037;37337
953;"10.08.2008";2;"27.1";4259;39401;35142
953;"10.08.2008";3;"15.9";4627;38450;33823
953;"10.08.2008";4;"8.1";5049;38139;33090
953;"10.08.2008";5;"7.1";5528;38296;32768
953;"10.08.2008";6;7;5770;38161;32391
953;"10.08.2008";7;"4.7";5770;38109;32339
953;"10.08.2008";8;"7.1";5843;39898;34055
953;"10.08.2008";9;"28.4";5841;41957;36116
953;"10.08.2008";10;"31.2";6023;44053;38030
953;"10.08.2008";11;"44.7";6458;46316;39858
953;"10.08.2008";12;"57.9";6883;48706;41824
953;"10.08.2008";13;"55.5";7286;48066;40780
953;"10.08.2008";14;"43.6";7941;46044;38103
953;"10.08.2008";15;37;7978;44581;36603
953;"10.08.2008";16;"34.9";7256;43587;36331
953;"10.08.2008";17;"30.6";7130;43706;36576
953;"10.08.2008";18;"40.8";6934;45390;38456
953;"10.08.2008";19;"45.9";6599;46762;40163
953;"10.08.2008";20;"49.9";5636;47142;41506
953;"10.08.2008";21;"56.4";4317;47176;42859
953;"10.08.2008";22;60;3740;48509;44769
953;"10.08.2008";23;"62.8";4219;47461;43242
953;"10.08.2008";24;"52.9";4554;43906;39352
954;"11.08.2008";1;"36.4";4651;41857;37206
954;"11.08.2008";2;"31.7";4500;40989;36489
954;"11.08.2008";3;"28.6";4595;40926;36331
954;"11.08.2008";4;"28.6";4595;41157;36562
954;"11.08.2008";5;"28.6";4310;42159;37849
954;"11.08.2008";6;35;4234;45098;40864
954;"11.08.2008";7;57;3951;51488;47537
954;"11.08.2008";8;75;3572;57921;54349
954;"11.08.2008";9;71;3368;61532;58164
954;"11.08.2008";10;73;3821;62230;58410
954;"11.08.2008";11;"74.1";3938;63444;59506
954;"11.08.2008";12;"80.8";4008;65095;61087
954;"11.08.2008";13;"78.8";4463;64507;60044
954;"11.08.2008";14;"76.5";4473;63751;59278
954;"11.08.2008";15;76;4003;63111;59108
954;"11.08.2008";16;"72.2";3332;62305;58973
954;"11.08.2008";17;"70.4";2727;60982;58255
954;"11.08.2008";18;"68.2";1938;60974;59036
954;"11.08.2008";19;"68.2";1183;61069;59886
954;"11.08.2008";20;"66.1";655;60734;60079
954;"11.08.2008";21;72;601;58896;58295
954;"11.08.2008";22;"69.1";524;57572;57048
954;"11.08.2008";23;65;720;53413;52693
954;"11.08.2008";24;"54.6";706;49115;48409
955;"12.08.2008";1;"56.9";1067;47040;45973
955;"12.08.2008";2;"55.1";1477;45692;44215
955;"12.08.2008";3;"49.1";1439;44642;43203
955;"12.08.2008";4;"39.9";1670;44803;43133
955;"12.08.2008";5;"42.4";1914;45713;43799
955;"12.08.2008";6;"56.6";2143;48769;46626
955;"12.08.2008";7;66;2224;54899;52675
955;"12.08.2008";8;"75.6";2540;60382;57842
955;"12.08.2008";9;"75.5";2607;63634;61027
955;"12.08.2008";10;78;2958;64999;62041
955;"12.08.2008";11;"81.9";3443;66342;62899
955;"12.08.2008";12;90;4007;68096;64089
955;"12.08.2008";13;"85.2";4816;67036;62220
955;"12.08.2008";14;"81.6";5397;66075;60678
955;"12.08.2008";15;70;5798;65090;59292
955;"12.08.2008";16;"63.3";6136;63867;57731
955;"12.08.2008";17;"62.4";6105;62699;56594
955;"12.08.2008";18;"61.4";6735;62348;55613
955;"12.08.2008";19;"55.7";6777;61787;55010
955;"12.08.2008";20;"54.1";6104;60746;54642
955;"12.08.2008";21;"55.6";5752;58870;53118
955;"12.08.2008";22;"62.1";5416;57814;52398
955;"12.08.2008";23;"57.7";5579;53941;48362
955;"12.08.2008";24;"40.3";5970;49644;43674
956;"13.08.2008";1;"28.6";6545;47292;40747
956;"13.08.2008";2;"21.1";7019;46413;39394
956;"13.08.2008";3;"8.1";7218;45131;37913
956;"13.08.2008";4;"4.8";7943;45330;37387
956;"13.08.2008";5;"2.1";8251;46280;38030
956;"13.08.2008";6;"5.6";8375;49233;40859
956;"13.08.2008";7;46;8414;54556;46142
956;"13.08.2008";8;"58.5";8438;59194;50756
956;"13.08.2008";9;"56.7";9046;62331;53285
956;"13.08.2008";10;"62.7";11218;63607;52389
956;"13.08.2008";11;"61.7";12797;64837;52040
956;"13.08.2008";12;"66.3";13231;65961;52730
956;"13.08.2008";13;"65.3";13968;65641;51673
956;"13.08.2008";14;"62.7";14240;64665;50425
956;"13.08.2008";15;"67.2";14214;63363;49149
956;"13.08.2008";16;"67.2";14428;62653;48225
956;"13.08.2008";17;"60.8";14118;61795;47677
956;"13.08.2008";18;"57.6";13337;61816;48479
956;"13.08.2008";19;"56.7";11893;61654;49761
956;"13.08.2008";20;"58.3";10110;60086;49976
956;"13.08.2008";21;"62.9";9099;58350;49251
956;"13.08.2008";22;"63.7";9119;58432;49313
956;"13.08.2008";23;"55.7";9090;54433;45343
956;"13.08.2008";24;"38.1";10074;50470;40396
957;"14.08.2008";1;"8.4";10572;48348;37776
957;"14.08.2008";2;"1.1";10950;46942;35992
957;"14.08.2008";3;"2.1";11656;46079;34423
957;"14.08.2008";4;"2.4";11916;46441;34525
957;"14.08.2008";5;"16.1";11784;47494;35710
957;"14.08.2008";6;"52.2";11090;50375;39285
957;"14.08.2008";7;59;10161;55492;45331
957;"14.08.2008";8;78;9384;59614;50230
957;"14.08.2008";9;"62.5";8895;62814;53919
957;"14.08.2008";10;"64.1";8986;63734;54748
957;"14.08.2008";11;"64.4";8942;64343;55401
957;"14.08.2008";12;"82.2";9171;65705;56534
957;"14.08.2008";13;75;8711;64519;55808
957;"14.08.2008";14;"77.8";7811;63803;55992
957;"14.08.2008";15;"79.9";6562;62683;56121
957;"14.08.2008";16;80;5445;61406;55961
957;"14.08.2008";17;"76.9";4317;59897;55580
957;"14.08.2008";18;"77.2";3154;59441;56287
957;"14.08.2008";19;"82.8";2053;59186;57133
957;"14.08.2008";20;"77.9";1250;58564;57314
957;"14.08.2008";21;"85.3";809;57157;56348
957;"14.08.2008";22;"85.1";702;57087;56385
957;"14.08.2008";23;"70.1";722;53167;52445
957;"14.08.2008";24;"61.9";685;48695;48010
958;"15.08.2008";1;"62.4";620;46432;45812
958;"15.08.2008";2;"54.1";614;45096;44482
958;"15.08.2008";3;"49.6";617;44086;43469
958;"15.08.2008";4;40;540;44119;43579
958;"15.08.2008";5;45;592;44773;44181
958;"15.08.2008";6;"56.2";689;47248;46559
958;"15.08.2008";7;65;919;52290;51371
958;"15.08.2008";8;"77.4";767;56783;56016
958;"15.08.2008";9;"73.7";722;60316;59594
958;"15.08.2008";10;"75.9";561;61772;61211
958;"15.08.2008";11;80;519;63440;62921
958;"15.08.2008";12;"86.4";579;64724;64145
958;"15.08.2008";13;"74.3";668;63450;62782
958;"15.08.2008";14;"64.8";831;61546;60715
958;"15.08.2008";15;"62.3";974;59878;58904
958;"15.08.2008";16;"62.7";1153;58755;57603
958;"15.08.2008";17;"62.3";1179;57752;56573
958;"15.08.2008";18;59;997;57736;56739
958;"15.08.2008";19;"62.4";786;57525;56739
958;"15.08.2008";20;"57.3";660;56292;55632
958;"15.08.2008";21;"68.1";569;54556;53987
958;"15.08.2008";22;"65.3";597;54432;53835
958;"15.08.2008";23;"62.8";623;51080;50457
958;"15.08.2008";24;"42.8";610;47000;46390
959;"16.08.2008";1;"43.5";648;44661;44013
959;"16.08.2008";2;"29.8";817;43318;42501
959;"16.08.2008";3;27;859;42377;41518
959;"16.08.2008";4;"29.1";929;41989;41060
959;"16.08.2008";5;"27.1";980;41926;40946
959;"16.08.2008";6;28;999;42449;41450
959;"16.08.2008";7;"20.1";1064;43849;42785
959;"16.08.2008";8;"30.1";1090;46044;44954
959;"16.08.2008";9;"52.1";744;49263;48519
959;"16.08.2008";10;"65.9";508;51847;51339
959;"16.08.2008";11;"69.1";620;53073;52453
959;"16.08.2008";12;"74.1";926;53972;53046
959;"16.08.2008";13;"66.5";1142;52773;51631
959;"16.08.2008";14;"65.5";1206;50753;49547
959;"16.08.2008";15;"63.6";1178;49135;47957
959;"16.08.2008";16;57;1131;48212;47081
959;"16.08.2008";17;"51.4";1064;47720;46656
959;"16.08.2008";18;"54.3";1078;48470;47392
959;"16.08.2008";19;"58.7";953;49271;48318
959;"16.08.2008";20;"54.6";817;48868;48051
959;"16.08.2008";21;57;914;47925;47011
959;"16.08.2008";22;"56.4";1155;48261;47106
959;"16.08.2008";23;"54.1";1268;45756;44488
959;"16.08.2008";24;"29.9";1330;42180;40850
960;"17.08.2008";1;24;1458;40530;39072
960;"17.08.2008";2;"2.6";1429;39454;38025
960;"17.08.2008";3;"0.3";1411;38451;37040
960;"17.08.2008";4;"0.7";1400;38036;36637
960;"17.08.2008";5;"0.3";1342;37922;36581
960;"17.08.2008";6;"0.5";1283;38095;36812
960;"17.08.2008";7;"0.6";1346;37848;36502
960;"17.08.2008";8;"5.1";1263;39779;38516
960;"17.08.2008";9;"29.8";854;41953;41099
960;"17.08.2008";10;40;603;43874;43271
960;"17.08.2008";11;"50.1";617;45573;44956
960;"17.08.2008";12;"55.1";770;47611;46841
960;"17.08.2008";13;53;834;46555;45721
960;"17.08.2008";14;46;946;44125;43179
960;"17.08.2008";15;40;996;42750;41754
960;"17.08.2008";16;"35.4";939;42188;41249
960;"17.08.2008";17;"35.9";851;42370;41520
960;"17.08.2008";18;"40.7";697;43992;43295
960;"17.08.2008";19;"49.4";634;45794;45160
960;"17.08.2008";20;"53.1";629;46765;46136
960;"17.08.2008";21;"53.6";780;47558;46778
960;"17.08.2008";22;"56.1";981;48396;47415
960;"17.08.2008";23;"52.2";1312;46524;45213
960;"17.08.2008";24;40;1635;43187;41552
961;"18.08.2008";1;"32.1";1789;41425;39636
961;"18.08.2008";2;"29.5";2126;40829;38703
961;"18.08.2008";3;"25.7";2608;40205;37597
961;"18.08.2008";4;"16.1";2765;40679;37914
961;"18.08.2008";5;"23.1";2740;41919;39179
961;"18.08.2008";6;"37.6";2853;45158;42305
961;"18.08.2008";7;"47.1";2969;52095;49126
961;"18.08.2008";8;"69.1";3007;58614;55608
961;"18.08.2008";9;"73.1";2552;62082;59530
961;"18.08.2008";10;"75.9";2439;62736;60297
961;"18.08.2008";11;"80.1";2413;63783;61370
961;"18.08.2008";12;"87.6";2719;65526;62807
961;"18.08.2008";13;80;3064;64529;61465
961;"18.08.2008";14;74;3374;63742;60368
961;"18.08.2008";15;"70.9";3606;62613;59007
961;"18.08.2008";16;"70.8";3572;61695;58123
961;"18.08.2008";17;"68.5";3398;60628;57230
961;"18.08.2008";18;"69.3";2955;60469;57514
961;"18.08.2008";19;"69.5";2211;60460;58249
961;"18.08.2008";20;69;1691;59898;58207
961;"18.08.2008";21;"73.4";1489;58759;57270
961;"18.08.2008";22;"70.3";1687;57802;56115
961;"18.08.2008";23;"64.9";2036;53301;51265
961;"18.08.2008";24;"51.3";2243;48691;46448
962;"19.08.2008";1;"37.7";2674;47028;44354
962;"19.08.2008";2;"29.9";2967;45474;42507
962;"19.08.2008";3;26;3268;44666;41398
962;"19.08.2008";4;26;3301;44721;41420
962;"19.08.2008";5;"29.4";3694;45947;42253
962;"19.08.2008";6;"40.8";3788;49190;45402
962;"19.08.2008";7;"62.9";3940;55179;51239
962;"19.08.2008";8;"68.2";3712;60216;56504
962;"19.08.2008";9;"69.9";3282;63284;60002
962;"19.08.2008";10;"78.1";3631;63463;59832
962;"19.08.2008";11;"80.1";4796;65286;60490
962;"19.08.2008";12;"88.6";5848;66339;60491
962;"19.08.2008";13;"77.6";6827;65485;58658
962;"19.08.2008";14;"76.7";7530;64928;57398
962;"19.08.2008";15;"72.5";7510;63894;56384
962;"19.08.2008";16;"70.2";7004;63270;56266
962;"19.08.2008";17;69;6247;62155;55908
962;"19.08.2008";18;"67.1";5982;61955;55973
962;"19.08.2008";19;"70.1";5319;61353;56034
962;"19.08.2008";20;70;4432;60506;56074
962;"19.08.2008";21;72;4094;59411;55317
962;"19.08.2008";22;73;4201;57740;53539
962;"19.08.2008";23;"68.2";5030;53152;48122
962;"19.08.2008";24;"52.4";5629;49039;43411
963;"20.08.2008";1;49;6176;46979;40803
963;"20.08.2008";2;"36.2";6285;45474;39189
963;"20.08.2008";3;"29.7";6086;44303;38217
963;"20.08.2008";4;"21.1";5993;44379;38386
963;"20.08.2008";5;"21.1";6213;45321;39108
963;"20.08.2008";6;"37.6";6152;48746;42594
963;"20.08.2008";7;"54.4";6484;54757;48273
963;"20.08.2008";8;68;6420;59741;53321
963;"20.08.2008";9;"69.9";6552;63143;56591
963;"20.08.2008";10;"72.2";7487;64357;56870
963;"20.08.2008";11;"75.9";8558;65839;57282
963;"20.08.2008";12;"85.3";9460;67551;58091
963;"20.08.2008";13;"78.2";10053;66702;56649
963;"20.08.2008";14;80;10275;65893;55618
963;"20.08.2008";15;"76.1";10188;64360;54172
963;"20.08.2008";16;"72.1";9574;62944;53370
963;"20.08.2008";17;"69.6";8925;61620;52695
963;"20.08.2008";18;"71.6";8007;61053;53046
963;"20.08.2008";19;"73.3";6472;60573;54101
963;"20.08.2008";20;"71.3";4972;60110;55138
963;"20.08.2008";21;"72.9";4274;58872;54598
963;"20.08.2008";22;74;4355;57756;53401
963;"20.08.2008";23;"64.1";4412;53409;48997
963;"20.08.2008";24;"62.7";4683;48852;44169
964;"21.08.2008";1;61;4865;46282;41417
964;"21.08.2008";2;"44.7";4605;45356;40751
964;"21.08.2008";3;35;4566;44462;39896
964;"21.08.2008";4;"18.7";4913;44795;39882
964;"21.08.2008";5;35;4732;45556;40824
964;"21.08.2008";6;"49.1";4360;48632;44272
964;"21.08.2008";7;"65.1";4252;54621;50370
964;"21.08.2008";8;"79.1";3708;59478;55770
964;"21.08.2008";9;"80.1";3519;62383;58864
964;"21.08.2008";10;"85.7";3752;63088;59336
964;"21.08.2008";11;"89.8";4155;63997;59842
964;"21.08.2008";12;"95.9";4611;65498;60887
964;"21.08.2008";13;"90.3";5234;64829;59595
964;"21.08.2008";14;"86.6";5579;64211;58632
964;"21.08.2008";15;82;5217;63076;57859
964;"21.08.2008";16;"80.6";5204;62268;57064
964;"21.08.2008";17;"78.4";5151;61048;55897
964;"21.08.2008";18;"76.8";4521;60983;56462
964;"21.08.2008";19;79;3525;60374;56849
964;"21.08.2008";20;"79.7";2699;59547;56848
964;"21.08.2008";21;"79.8";2722;58932;56210
964;"21.08.2008";22;"79.1";3298;57882;54584
964;"21.08.2008";23;"74.1";3656;53493;49837
964;"21.08.2008";24;"62.4";3597;49190;45593
965;"22.08.2008";1;"47.6";3449;46362;42913
965;"22.08.2008";2;"47.4";3145;45367;42222
965;"22.08.2008";3;"44.3";2640;44645;42005
965;"22.08.2008";4;"42.9";2137;44561;42424
965;"22.08.2008";5;"44.4";2104;45337;43233
965;"22.08.2008";6;"55.7";1831;48814;46983
965;"22.08.2008";7;"66.9";1642;55387;53745
965;"22.08.2008";8;"78.4";1411;60024;58613
965;"22.08.2008";9;"83.9";986;63141;62155
965;"22.08.2008";10;"91.2";765;63953;63188
965;"22.08.2008";11;95;879;65098;64219
965;"22.08.2008";12;"101.9";1104;66248;65144
965;"22.08.2008";13;"93.4";1010;65296;64286
965;"22.08.2008";14;"86.1";848;63866;63018
965;"22.08.2008";15;83;791;62578;61787
965;"22.08.2008";16;"78.1";749;61492;60743
965;"22.08.2008";17;"75.7";758;60817;60059
965;"22.08.2008";18;"76.5";873;60977;60104
965;"22.08.2008";19;"78.1";832;60789;59957
965;"22.08.2008";20;"77.6";717;59588;58871
965;"22.08.2008";21;"80.2";785;58317;57532
965;"22.08.2008";22;"79.4";765;55739;54974
965;"22.08.2008";23;73;814;51459;50645
965;"22.08.2008";24;"63.5";1059;47339;46280
966;"23.08.2008";1;"66.3";1500;44627;43127
966;"23.08.2008";2;"63.9";1720;42637;40917
966;"23.08.2008";3;"67.9";2101;42111;40010
966;"23.08.2008";4;58;2827;41526;38699
966;"23.08.2008";5;56;4200;42340;38140
966;"23.08.2008";6;"56.5";4946;43643;38697
966;"23.08.2008";7;"52.9";5767;45544;39777
966;"23.08.2008";8;"62.5";6092;47939;41847
966;"23.08.2008";9;"65.8";6522;51044;44522
966;"23.08.2008";10;"71.7";7048;53872;46824
966;"23.08.2008";11;"73.8";7781;55401;47620
966;"23.08.2008";12;"77.9";8938;56413;47475
966;"23.08.2008";13;"77.6";8885;55290;46405
966;"23.08.2008";14;"73.7";8937;53028;44091
966;"23.08.2008";15;"65.1";8521;51012;42491
966;"23.08.2008";16;"65.1";7883;50548;42665
966;"23.08.2008";17;"65.1";6982;50004;43022
966;"23.08.2008";18;"66.9";6747;50676;43929
966;"23.08.2008";19;"67.9";5760;50627;44867
966;"23.08.2008";20;"72.4";4278;49455;45177
966;"23.08.2008";21;70;4196;48626;44430
966;"23.08.2008";22;"72.1";4445;47005;42560
966;"23.08.2008";23;72;4807;44470;39663
966;"23.08.2008";24;"57.6";4854;41880;37026
967;"24.08.2008";1;"51.6";4855;40123;35268
967;"24.08.2008";2;38;5007;39434;34427
967;"24.08.2008";3;"32.6";4954;38422;33468
967;"24.08.2008";4;"21.4";5141;38175;33034
967;"24.08.2008";5;19;5474;38575;33101
967;"24.08.2008";6;"19.5";5531;39196;33665
967;"24.08.2008";7;7;5648;39205;33557
967;"24.08.2008";8;"10.7";5758;41157;35399
967;"24.08.2008";9;"40.5";5836;43885;38049
967;"24.08.2008";10;"49.3";5795;45652;39857
967;"24.08.2008";11;"55.6";5848;47026;41178
967;"24.08.2008";12;"61.6";6325;49247;42922
967;"24.08.2008";13;"62.1";6188;47686;41498
967;"24.08.2008";14;"55.6";5633;45552;39919
967;"24.08.2008";15;50;5025;43597;38572
967;"24.08.2008";16;46;4362;42810;38448
967;"24.08.2008";17;45;3860;42828;38968
967;"24.08.2008";18;"49.7";3075;43766;40691
967;"24.08.2008";19;"57.9";2037;45517;43480
967;"24.08.2008";20;65;1318;46370;45052
967;"24.08.2008";21;67;1317;47835;46518
967;"24.08.2008";22;"70.9";1369;47507;46138
967;"24.08.2008";23;"67.9";1333;46031;44698
967;"24.08.2008";24;"61.2";1263;42306;41043
968;"25.08.2008";1;"52.6";1284;40969;39685
968;"25.08.2008";2;"48.7";1298;39971;38673
968;"25.08.2008";3;"39.8";1213;39905;38692
968;"25.08.2008";4;"38.4";1184;40244;39060
968;"25.08.2008";5;44;1179;40993;39814
968;"25.08.2008";6;51;1166;44706;43540
968;"25.08.2008";7;"66.1";1168;52811;51643
968;"25.08.2008";8;"81.3";1140;59344;58204
968;"25.08.2008";9;"92.5";1028;62921;61893
968;"25.08.2008";10;"93.9";951;63939;62988
968;"25.08.2008";11;"97.1";1070;65255;64185
968;"25.08.2008";12;"112.8";1263;66498;65235
968;"25.08.2008";13;101;1413;65571;64158
968;"25.08.2008";14;"96.3";1624;63776;62152
968;"25.08.2008";15;"92.2";1614;63037;61423
968;"25.08.2008";16;"87.9";1611;62521;60910
968;"25.08.2008";17;"85.2";1591;61087;59496
968;"25.08.2008";18;"85.2";1402;60762;59360
968;"25.08.2008";19;"86.8";1255;60548;59293
968;"25.08.2008";20;"83.2";1132;60165;59033
968;"25.08.2008";21;"83.9";1238;59927;58689
968;"25.08.2008";22;79;1454;58183;56729
968;"25.08.2008";23;73;1819;53481;51662
968;"25.08.2008";24;"60.6";2061;49105;47044
969;"26.08.2008";1;"62.4";2365;46822;44457
969;"26.08.2008";2;"53.3";2640;45372;42732
969;"26.08.2008";3;51;2518;44199;41681
969;"26.08.2008";4;"41.2";2332;44335;42003
969;"26.08.2008";5;"43.3";2423;45277;42854
969;"26.08.2008";6;"60.7";2477;48828;46351
969;"26.08.2008";7;"67.9";2448;55716;53268
969;"26.08.2008";8;"78.9";2395;60847;58452
969;"26.08.2008";9;"84.4";2028;63787;61759
969;"26.08.2008";10;"89.9";1879;64288;62409
969;"26.08.2008";11;"91.3";2011;65057;63046
969;"26.08.2008";12;95;2369;66118;63749
969;"26.08.2008";13;"93.2";2707;65285;62578
969;"26.08.2008";14;95;2781;64136;61355
969;"26.08.2008";15;"96.1";2771;63002;60231
969;"26.08.2008";16;"95.1";2582;62638;60056
969;"26.08.2008";17;"93.1";2358;61387;59029
969;"26.08.2008";18;"91.2";2002;61110;59108
969;"26.08.2008";19;"90.1";1818;60941;59123
969;"26.08.2008";20;"89.9";1598;60667;59069
969;"26.08.2008";21;99;1442;60583;59141
969;"26.08.2008";22;95;1350;58471;57121
969;"26.08.2008";23;84;1372;53901;52529
969;"26.08.2008";24;"70.6";1349;49275;47927
970;"27.08.2008";1;"64.5";1465;46807;45342
970;"27.08.2008";2;"65.6";1468;45365;43897
970;"27.08.2008";3;60;1543;44537;42994
970;"27.08.2008";4;"58.6";1654;44754;43100
970;"27.08.2008";5;"52.1";1815;45752;43937
970;"27.08.2008";6;"60.1";1907;49569;47662
970;"27.08.2008";7;"76.3";2075;56288;54213
970;"27.08.2008";8;"94.1";2166;60893;58727
970;"27.08.2008";9;"97.2";2209;63640;61431
970;"27.08.2008";10;"96.9";2407;64324;61917
970;"27.08.2008";11;99;2890;65063;62173
970;"27.08.2008";12;"106.2";3403;65954;62551
970;"27.08.2008";13;"100.6";3699;65085;61386
970;"27.08.2008";14;"102.6";3803;63903;60100
970;"27.08.2008";15;99;3839;63222;59383
970;"27.08.2008";16;94;3801;62627;58826
970;"27.08.2008";17;"89.9";3695;61414;57719
970;"27.08.2008";18;"85.1";3526;61251;57725
970;"27.08.2008";19;85;3526;61401;57875
970;"27.08.2008";20;"85.1";3287;61065;57778
970;"27.08.2008";21;"90.8";3091;60878;57787
970;"27.08.2008";22;"86.5";3120;59092;55972
970;"27.08.2008";23;85;3110;54247;51137
970;"27.08.2008";24;"69.9";2990;49829;46839
971;"28.08.2008";1;"66.2";2833;47457;44624
971;"28.08.2008";2;64;2677;45834;43157
971;"28.08.2008";3;"57.3";2546;44871;42325
971;"28.08.2008";4;"50.1";2398;44940;42542
971;"28.08.2008";5;"55.6";2242;46000;43758
971;"28.08.2008";6;"63.2";2130;49617;47487
971;"28.08.2008";7;"80.8";1990;56712;54722
971;"28.08.2008";8;95;1772;61802;60030
971;"28.08.2008";9;"97.1";1690;64843;63153
971;"28.08.2008";10;103;1856;65413;63557
971;"28.08.2008";11;"105.4";2001;66338;64337
971;"28.08.2008";12;"111.3";2335;67664;65329
971;"28.08.2008";13;"102.9";2985;66524;63539
971;"28.08.2008";14;"99.1";3546;65619;62073
971;"28.08.2008";15;"99.1";3829;64569;60740
971;"28.08.2008";16;"98.9";3818;63543;59725
971;"28.08.2008";17;95;3852;62200;58348
971;"28.08.2008";18;"93.8";3605;62110;58505
971;"28.08.2008";19;"92.8";3341;62190;58849
971;"28.08.2008";20;"91.1";3264;61735;58471
971;"28.08.2008";21;95;3271;61592;58321
971;"28.08.2008";22;"92.9";3504;59282;55778
971;"28.08.2008";23;84;3976;54806;50830
971;"28.08.2008";24;"77.9";4142;50373;46231
972;"29.08.2008";1;"66.4";4403;48122;43719
972;"29.08.2008";2;"54.1";4583;46593;42010
972;"29.08.2008";3;"49.8";4844;45787;40943
972;"29.08.2008";4;"45.7";5012;45769;40757
972;"29.08.2008";5;"45.7";4772;46542;41770
972;"29.08.2008";6;"55.2";4742;50018;45276
972;"29.08.2008";7;"66.1";4857;57301;52445
972;"29.08.2008";8;"87.6";4795;62430;57635
972;"29.08.2008";9;99;4499;65426;60927
972;"29.08.2008";10;105;4365;66024;61659
972;"29.08.2008";11;"109.1";4481;66885;62404
972;"29.08.2008";12;"120.2";5105;67837;62732
972;"29.08.2008";13;"114.8";5213;66361;61148
972;"29.08.2008";14;"107.6";5502;64663;59161
972;"29.08.2008";15;"104.1";5172;63041;57869
972;"29.08.2008";16;"100.6";4885;61774;56889
972;"29.08.2008";17;98;4585;60672;56087
972;"29.08.2008";18;96;4046;60670;56624
972;"29.08.2008";19;"99.2";3251;60168;56917
972;"29.08.2008";20;"96.4";2371;59145;56774
972;"29.08.2008";21;95;1769;58802;57033
972;"29.08.2008";22;93;1668;56813;55145
972;"29.08.2008";23;"90.9";1547;52710;51163
972;"29.08.2008";24;81;1345;48406;47061
973;"30.08.2008";1;76;1142;45794;44652
973;"30.08.2008";2;"69.6";923;43300;42377
973;"30.08.2008";3;64;783;42361;41578
973;"30.08.2008";4;62;680;42003;41323
973;"30.08.2008";5;"64.7";618;42913;42295
973;"30.08.2008";6;"65.4";541;43039;42498
973;"30.08.2008";7;"75.3";466;45111;44645
973;"30.08.2008";8;71;463;47316;46853
973;"30.08.2008";9;81;436;50497;50061
973;"30.08.2008";10;"91.9";352;52790;52438
973;"30.08.2008";11;95;361;53729;53368
973;"30.08.2008";12;95;362;54141;53779
973;"30.08.2008";13;95;388;52365;51977
973;"30.08.2008";14;"85.3";506;50022;49516
973;"30.08.2008";15;"87.2";623;48245;47622
973;"30.08.2008";16;"82.9";685;47543;46858
973;"30.08.2008";17;"80.1";719;47313;46594
973;"30.08.2008";18;"81.9";815;48471;47656
973;"30.08.2008";19;83;962;49377;48415
973;"30.08.2008";20;"82.1";1181;49077;47896
973;"30.08.2008";21;"89.9";1971;49473;47503
973;"30.08.2008";22;90;2999;48408;45409
973;"30.08.2008";23;"86.7";3781;45943;42162
973;"30.08.2008";24;"75.1";3958;42745;38787
974;"31.08.2008";1;"59.2";4107;40836;36729
974;"31.08.2008";2;"57.2";4114;39535;35421
974;"31.08.2008";3;"53.3";3831;38752;34921
974;"31.08.2008";4;"41.9";3523;37756;34233
974;"31.08.2008";5;40;3216;37757;34541
974;"31.08.2008";6;"40.8";3123;38322;35199
974;"31.08.2008";7;"35.9";3007;38338;35331
974;"31.08.2008";8;"44.3";2912;40010;37098
974;"31.08.2008";9;63;2160;42414;40254
974;"31.08.2008";10;"68.6";1545;43811;42266
974;"31.08.2008";11;"70.1";1845;45243;43398
974;"31.08.2008";12;"77.7";2507;46815;44308
974;"31.08.2008";13;"75.9";3007;45756;42749
974;"31.08.2008";14;"65.9";3315;43702;40387
974;"31.08.2008";15;"62.5";3566;42603;39037
974;"31.08.2008";16;"58.8";3668;42335;38667
974;"31.08.2008";17;"56.2";3617;42748;39131
974;"31.08.2008";18;64;3508;44287;40779
974;"31.08.2008";19;"67.4";3075;46235;43160
974;"31.08.2008";20;"71.8";3257;46912;43655
974;"31.08.2008";21;"78.7";4644;49619;44975
974;"31.08.2008";22;"79.9";5635;49621;43986
974;"31.08.2008";23;77;5883;47626;41743
974;"31.08.2008";24;"65.4";5823;44029;38206
975;"01.09.2008";1;55;5318;43148;37830
975;"01.09.2008";2;55;4930;42613;37683
975;"01.09.2008";3;"51.5";4486;41759;37273
975;"01.09.2008";4;"45.5";4132;41917;37785
975;"01.09.2008";5;"51.4";3924;42936;39012
975;"01.09.2008";6;"58.1";3982;46397;42415
975;"01.09.2008";7;"72.7";4157;54778;50621
975;"01.09.2008";8;"92.3";3883;61054;57171
975;"01.09.2008";9;"104.8";3174;64784;61610
975;"01.09.2008";10;108;3082;65847;62765
975;"01.09.2008";11;"116.9";3068;66966;63898
975;"01.09.2008";12;"146.6";3555;68181;64626
975;"01.09.2008";13;"119.4";3950;67179;63229
975;"01.09.2008";14;"115.1";3951;66510;62559
975;"01.09.2008";15;"108.9";3912;65136;61224
975;"01.09.2008";16;"102.8";4144;64311;60167
975;"01.09.2008";17;"98.1";3959;62609;58650
975;"01.09.2008";18;"98.1";3591;62416;58825
975;"01.09.2008";19;"97.8";2986;62889;59903
975;"01.09.2008";20;"95.1";2079;62243;60164
975;"01.09.2008";21;"96.8";1792;61940;60148
975;"01.09.2008";22;91;1912;58970;57058
975;"01.09.2008";23;"80.1";2121;54348;52227
975;"01.09.2008";24;"68.2";2262;49670;47408
976;"02.09.2008";1;"66.6";2398;47507;45109
976;"02.09.2008";2;"59.5";2616;46072;43456
976;"02.09.2008";3;"56.2";2643;45004;42361
976;"02.09.2008";4;"57.8";2602;44955;42353
976;"02.09.2008";5;"56.8";2561;46310;43749
976;"02.09.2008";6;"63.8";2659;49895;47236
976;"02.09.2008";7;"76.2";2931;56997;54066
976;"02.09.2008";8;"98.1";2951;61493;58542
976;"02.09.2008";9;"113.9";2534;64321;61787
976;"02.09.2008";10;"119.1";2109;64946;62837
976;"02.09.2008";11;"130.2";2437;66088;63651
976;"02.09.2008";12;"135.1";3259;67063;63804
976;"02.09.2008";13;103;4305;66098;61793
976;"02.09.2008";14;"98.9";5285;65381;60096
976;"02.09.2008";15;"98.1";5564;64526;58962
976;"02.09.2008";16;"95.1";5689;63646;57957
976;"02.09.2008";17;"90.5";6001;62545;56544
976;"02.09.2008";18;"90.5";5568;62048;56480
976;"02.09.2008";19;"90.6";4980;62166;57186
976;"02.09.2008";20;"88.1";4790;62334;57544
976;"02.09.2008";21;"95.1";5424;62744;57320
976;"02.09.2008";22;84;6517;59569;53052
976;"02.09.2008";23;"71.1";7311;55279;47968
976;"02.09.2008";24;"64.1";7088;50780;43692
977;"03.09.2008";1;"66.9";7347;48570;41223
977;"03.09.2008";2;"66.6";7318;47111;39793
977;"03.09.2008";3;"63.9";7499;46049;38550
977;"03.09.2008";4;"60.2";7353;46290;38937
977;"03.09.2008";5;"57.9";7039;47477;40438
977;"03.09.2008";6;"65.3";7015;50500;43485
977;"03.09.2008";7;80;7171;57558;50387
977;"03.09.2008";8;98;6622;61897;55275
977;"03.09.2008";9;105;6007;64542;58535
977;"03.09.2008";10;"105.6";6396;65332;58936
977;"03.09.2008";11;"109.1";6514;66058;59544
977;"03.09.2008";12;"121.3";6401;67070;60669
977;"03.09.2008";13;"116.9";6175;66026;59851
977;"03.09.2008";14;"120.9";5927;65264;59337
977;"03.09.2008";15;112;5432;64669;59237
977;"03.09.2008";16;"106.4";5105;64250;59145
977;"03.09.2008";17;"100.9";4985;63459;58474
977;"03.09.2008";18;"101.2";4735;63901;59166
977;"03.09.2008";19;"98.2";3981;64221;60240
977;"03.09.2008";20;"99.5";3755;63890;60135
977;"03.09.2008";21;"105.5";3580;63002;59422
977;"03.09.2008";22;97;3682;59512;55830
977;"03.09.2008";23;"88.5";3747;54566;50819
977;"03.09.2008";24;"75.1";3698;50397;46699
978;"04.09.2008";1;"69.6";4359;47735;43376
978;"04.09.2008";2;"65.2";4564;45756;41192
978;"04.09.2008";3;"62.3";4735;44831;40096
978;"04.09.2008";4;"55.2";4844;45182;40338
978;"04.09.2008";5;"55.6";4910;46406;41496
978;"04.09.2008";6;"62.9";5042;50208;45166
978;"04.09.2008";7;"80.4";5056;57227;52171
978;"04.09.2008";8;"103.9";5079;62359;57280
978;"04.09.2008";9;"109.7";4684;64926;60242
978;"04.09.2008";10;"127.8";4504;65188;60684
978;"04.09.2008";11;"129.9";4633;66074;61441
978;"04.09.2008";12;"139.7";5252;67469;62217
978;"04.09.2008";13;"119.8";6243;66540;60297
978;"04.09.2008";14;"115.1";6742;65963;59221
978;"04.09.2008";15;"113.9";7034;65494;58460
978;"04.09.2008";16;108;6933;64557;57624
978;"04.09.2008";17;"101.4";6352;63238;56886
978;"04.09.2008";18;"104.9";5378;62944;57566
978;"04.09.2008";19;"106.5";4491;62840;58349
978;"04.09.2008";20;"110.1";3651;62645;58994
978;"04.09.2008";21;"119.4";3995;62952;58957
978;"04.09.2008";22;"105.9";4651;59379;54728
978;"04.09.2008";23;"93.8";5247;54810;49563
978;"04.09.2008";24;"77.9";5315;50528;45213
979;"05.09.2008";1;"66.9";5041;48022;42981
979;"05.09.2008";2;"64.8";4800;46062;41262
979;"05.09.2008";3;"63.7";4539;44880;40341
979;"05.09.2008";4;"58.6";4301;45034;40733
979;"05.09.2008";5;"61.2";3696;46054;42358
979;"05.09.2008";6;"65.1";3021;49652;46631
979;"05.09.2008";7;"83.4";2826;57137;54311
979;"05.09.2008";8;"102.9";2577;61515;58938
979;"05.09.2008";9;112;1924;64236;62312
979;"05.09.2008";10;"123.2";1425;64503;63078
979;"05.09.2008";11;148;1243;65314;64071
979;"05.09.2008";12;"199.6";1572;66017;64445
979;"05.09.2008";13;125;1979;64757;62778
979;"05.09.2008";14;"117.8";2266;63342;61076
979;"05.09.2008";15;"107.9";2409;61764;59355
979;"05.09.2008";16;100;2512;60726;58214
979;"05.09.2008";17;"96.9";2526;60184;57658
979;"05.09.2008";18;94;2627;60797;58170
979;"05.09.2008";19;92;2958;60836;57878
979;"05.09.2008";20;"91.6";3262;61067;57805
979;"05.09.2008";21;"96.8";4067;60976;56909
979;"05.09.2008";22;86;4789;57400;52611
979;"05.09.2008";23;"79.2";5125;53251;48126
979;"05.09.2008";24;"69.3";5638;49011;43373
980;"06.09.2008";1;"64.9";5765;46690;40925
980;"06.09.2008";2;"51.5";5743;44297;38554
980;"06.09.2008";3;"51.4";5682;43769;38087
980;"06.09.2008";4;"51.4";5695;43437;37742
980;"06.09.2008";5;"44.8";5851;43751;37900
980;"06.09.2008";6;"41.3";5759;43993;38234
980;"06.09.2008";7;"31.1";5568;45548;39980
980;"06.09.2008";8;42;5553;48115;42562
980;"06.09.2008";9;"52.4";5816;51781;45965
980;"06.09.2008";10;"80.5";6136;54204;48068
980;"06.09.2008";11;"84.7";6773;55845;49072
980;"06.09.2008";12;"89.4";7345;56898;49553
980;"06.09.2008";13;84;7240;55442;48202
980;"06.09.2008";14;83;6495;53176;46681
980;"06.09.2008";15;"62.7";5861;51677;45816
980;"06.09.2008";16;58;4829;50696;45867
980;"06.09.2008";17;"58.1";4452;50413;45961
980;"06.09.2008";18;"63.5";3837;51420;47583
980;"06.09.2008";19;"79.2";2983;52225;49242
980;"06.09.2008";20;"79.4";2285;52404;50119
980;"06.09.2008";21;"82.3";2115;52104;49989
980;"06.09.2008";22;70;2294;49427;47133
980;"06.09.2008";23;58;2560;46761;44201
980;"06.09.2008";24;"50.4";2813;43225;40412
981;"07.09.2008";1;"62.1";3110;41218;38108
981;"07.09.2008";2;"59.4";2992;40097;37105
981;"07.09.2008";3;"57.4";2937;38985;36048
981;"07.09.2008";4;"53.8";2890;38564;35675
981;"07.09.2008";5;"51.5";2853;38616;35763
981;"07.09.2008";6;"53.8";3081;38807;35726
981;"07.09.2008";7;"53.2";3193;39342;36149
981;"07.09.2008";8;"54.3";3323;40247;36924
981;"07.09.2008";9;"64.4";3098;42653;39555
981;"07.09.2008";10;"66.5";3100;45157;42058
981;"07.09.2008";11;"70.1";3958;47496;43538
981;"07.09.2008";12;"77.1";4490;49920;45430
981;"07.09.2008";13;"76.1";4826;49180;44354
981;"07.09.2008";14;"66.1";4973;47135;42162
981;"07.09.2008";15;"65.2";5094;45601;40507
981;"07.09.2008";16;"64.1";4809;44853;40044
981;"07.09.2008";17;"63.9";4449;44586;40137
981;"07.09.2008";18;"65.9";3928;46060;42132
981;"07.09.2008";19;"73.9";3623;48107;44484
981;"07.09.2008";20;80;3761;49497;45736
981;"07.09.2008";21;"90.3";3917;51531;47614
981;"07.09.2008";22;"86.2";4262;49613;45351
981;"07.09.2008";23;80;4532;47890;43358
981;"07.09.2008";24;"64.6";4659;44598;39939
982;"08.09.2008";1;"62.7";4678;42999;38321
982;"08.09.2008";2;"59.6";4307;41836;37529
982;"08.09.2008";3;"54.5";4152;41019;36867
982;"08.09.2008";4;"51.1";4085;41470;37385
982;"08.09.2008";5;"51.6";4086;43195;39109
982;"08.09.2008";6;"61.4";4390;46982;42592
982;"08.09.2008";7;78;4557;55593;51036
982;"08.09.2008";8;"96.8";4257;61236;56979
982;"08.09.2008";9;"117.6";4164;63887;59723
982;"08.09.2008";10;"126.2";4564;64266;59702
982;"08.09.2008";11;142;5353;65150;59797
982;"08.09.2008";12;"178.1";5839;66530;60691
982;"08.09.2008";13;"127.6";6084;65651;59567
982;"08.09.2008";14;"127.8";5817;64951;59134
982;"08.09.2008";15;"125.1";5259;63657;58398
982;"08.09.2008";16;"116.3";5086;62779;57693
982;"08.09.2008";17;"102.5";4586;61263;56677
982;"08.09.2008";18;"100.6";3986;60949;56963
982;"08.09.2008";19;100;2951;61278;58327
982;"08.09.2008";20;"99.9";2216;61544;59328
982;"08.09.2008";21;"110.1";2115;62542;60427
982;"08.09.2008";22;"95.9";2204;59025;56821
982;"08.09.2008";23;"79.9";2385;54124;51739
982;"08.09.2008";24;"66.8";2274;49522;47248
983;"09.09.2008";1;"63.6";2161;46915;44754
983;"09.09.2008";2;"54.6";1985;45355;43370
983;"09.09.2008";3;"50.5";1839;44333;42494
983;"09.09.2008";4;"44.8";1712;44476;42764
983;"09.09.2008";5;"51.4";1775;45850;44075
983;"09.09.2008";6;65;1753;49684;47931
983;"09.09.2008";7;78;1725;57383;55659
983;"09.09.2008";8;104;1565;61506;59941
983;"09.09.2008";9;"107.9";1202;63619;62417
983;"09.09.2008";10;"110.1";614;63685;63071
983;"09.09.2008";11;"122.8";499;64571;64072
983;"09.09.2008";12;"135.1";736;65829;65093
983;"09.09.2008";13;"122.1";993;64762;63769
983;"09.09.2008";14;"120.6";981;63961;62980
983;"09.09.2008";15;"120.1";865;63008;62143
983;"09.09.2008";16;113;812;62339;61527
983;"09.09.2008";17;"104.5";784;61423;60639
983;"09.09.2008";18;"98.9";752;61432;60680
983;"09.09.2008";19;"96.4";617;61800;61183
983;"09.09.2008";20;"99.5";875;62496;61621
983;"09.09.2008";21;105;1658;63591;61933
983;"09.09.2008";22;"93.5";2779;59780;57001
983;"09.09.2008";23;"76.9";3562;54945;51383
983;"09.09.2008";24;"66.7";3911;50337;46426
984;"10.09.2008";1;"67.5";3781;48244;44463
984;"10.09.2008";2;"63.4";3602;46561;42959
984;"10.09.2008";3;"57.4";3366;45659;42293
984;"10.09.2008";4;"52.3";2990;45700;42710
984;"10.09.2008";5;"51.1";2666;46411;43745
984;"10.09.2008";6;"63.2";2508;50360;47852
984;"10.09.2008";7;"82.3";2308;58333;56025
984;"10.09.2008";8;"105.1";2180;62690;60510
984;"10.09.2008";9;120;1934;65449;63515
984;"10.09.2008";10;130;1405;65787;64382
984;"10.09.2008";11;"143.1";1392;66781;65389
984;"10.09.2008";12;"159.6";1539;67935;66396
984;"10.09.2008";13;"156.9";1753;67272;65519
984;"10.09.2008";14;"146.7";2001;66561;64560
984;"10.09.2008";15;"140.9";2101;65680;63579
984;"10.09.2008";16;122;1862;64946;63084
984;"10.09.2008";17;"104.6";1802;63930;62128
984;"10.09.2008";18;"101.7";1260;63325;62065
984;"10.09.2008";19;"104.6";760;63152;62392
984;"10.09.2008";20;"105.6";572;63543;62971
984;"10.09.2008";21;125;656;64109;63453
984;"10.09.2008";22;98;720;60023;59303
984;"10.09.2008";23;"89.9";800;55053;54253
984;"10.09.2008";24;76;916;50240;49324
985;"11.09.2008";1;74;977;47646;46669
985;"11.09.2008";2;"69.6";921;46096;45175
985;"11.09.2008";3;"64.1";942;45181;44239
985;"11.09.2008";4;"54.2";969;45226;44257
985;"11.09.2008";5;"54.4";1015;46453;45438
985;"11.09.2008";6;"65.2";978;49563;48585
985;"11.09.2008";7;"75.1";978;57281;56303
985;"11.09.2008";8;"104.6";1040;61997;60957
985;"11.09.2008";9;"120.1";1089;64160;63071
985;"11.09.2008";10;"125.1";852;64663;63811
985;"11.09.2008";11;130;613;65698;65085
985;"11.09.2008";12;144;720;66508;65788
985;"11.09.2008";13;125;916;65448;64532
985;"11.09.2008";14;"121.2";1136;65158;64022
985;"11.09.2008";15;125;1355;64488;63133
985;"11.09.2008";16;"122.3";1637;64185;62548
985;"11.09.2008";17;"119.7";2019;63438;61419
985;"11.09.2008";18;105;2819;63335;60516
985;"11.09.2008";19;"99.8";3284;63329;60045
985;"11.09.2008";20;"99.8";3682;63739;60057
985;"11.09.2008";21;"103.4";4455;63963;59508
985;"11.09.2008";22;"89.9";4888;60094;55206
985;"11.09.2008";23;"70.3";5020;55779;50759
985;"11.09.2008";24;"66.1";5134;51451;46317
986;"12.09.2008";1;"66.1";4939;48752;43813
986;"12.09.2008";2;"65.7";5113;46733;41620
986;"12.09.2008";3;54;5067;45712;40645
986;"12.09.2008";4;"56.5";5099;45733;40634
986;"12.09.2008";5;54;5064;46697;41633
986;"12.09.2008";6;"62.8";5145;50557;45412
986;"12.09.2008";7;"78.1";5309;58519;53210
986;"12.09.2008";8;"99.7";5245;63056;57811
986;"12.09.2008";9;"104.9";5168;65723;60555
986;"12.09.2008";10;"114.9";5374;66218;60844
986;"12.09.2008";11;"120.9";5952;67635;61683
986;"12.09.2008";12;"129.9";6677;68827;62150
986;"12.09.2008";13;"115.1";7448;67631;60183
986;"12.09.2008";14;"104.6";7657;66197;58540
986;"12.09.2008";15;"94.1";8097;65193;57096
986;"12.09.2008";16;"78.2";8490;63727;55237
986;"12.09.2008";17;"77.8";8526;62779;54253
986;"12.09.2008";18;"74.9";8843;62915;54072
986;"12.09.2008";19;"77.2";9143;63038;53895
986;"12.09.2008";20;"81.4";8561;63219;54658
986;"12.09.2008";21;"91.8";8468;61662;53194
986;"12.09.2008";22;75;8674;58045;49371
986;"12.09.2008";23;"77.5";8508;53887;45379
986;"12.09.2008";24;"66.9";7654;49862;42208
987;"13.09.2008";1;"62.8";7197;47171;39974
987;"13.09.2008";2;"62.8";6724;45784;39060
987;"13.09.2008";3;"62.7";6140;44176;38036
987;"13.09.2008";4;"61.4";5885;43423;37538
987;"13.09.2008";5;55;5423;43331;37908
987;"13.09.2008";6;"62.3";5097;43813;38716
987;"13.09.2008";7;"68.8";5168;46168;41000
987;"13.09.2008";8;76;5166;48557;43391
987;"13.09.2008";9;"73.6";4855;51603;46748
987;"13.09.2008";10;"69.5";5284;54568;49284
987;"13.09.2008";11;"83.7";7457;56761;49305
987;"13.09.2008";12;89;8884;57710;48826
987;"13.09.2008";13;"70.9";9830;56538;46708
987;"13.09.2008";14;"57.3";9661;54040;44379
987;"13.09.2008";15;"68.1";9131;51722;42591
987;"13.09.2008";16;68;8943;50620;41677
987;"13.09.2008";17;"68.2";8651;50023;41372
987;"13.09.2008";18;"71.1";7842;50638;42796
987;"13.09.2008";19;67;6652;51590;44938
987;"13.09.2008";20;"66.3";5244;52330;47086
987;"13.09.2008";21;"75.5";5306;52294;46988
987;"13.09.2008";22;"71.4";5062;49039;43977
987;"13.09.2008";23;"68.3";4768;46454;41686
987;"13.09.2008";24;"67.8";4460;43113;38653
988;"14.09.2008";1;"62.1";4024;39883;35859
988;"14.09.2008";2;"60.2";3867;39392;35525
988;"14.09.2008";3;"53.3";3700;38340;34640
988;"14.09.2008";4;"47.8";3657;37949;34292
988;"14.09.2008";5;48;3653;38169;34516
988;"14.09.2008";6;"49.3";3482;38590;35108
988;"14.09.2008";7;"48.6";3273;38716;35443
988;"14.09.2008";8;"48.9";3162;39907;36745
988;"14.09.2008";9;"55.7";2467;42412;39945
988;"14.09.2008";10;"62.6";1904;44221;42317
988;"14.09.2008";11;68;2429;45816;43387
988;"14.09.2008";12;"75.3";3482;48251;44769
988;"14.09.2008";13;"70.8";4023;47599;43576
988;"14.09.2008";14;66;3659;45663;42004
988;"14.09.2008";15;59;3508;44336;40828
988;"14.09.2008";16;"55.2";3342;43625;40283
988;"14.09.2008";17;"55.3";3266;44186;40921
988;"14.09.2008";18;"60.5";3000;45982;42982
988;"14.09.2008";19;65;2765;48365;45600
988;"14.09.2008";20;"75.1";2530;50295;47765
988;"14.09.2008";21;88;2638;51306;48668
988;"14.09.2008";22;76;2752;49168;46416
988;"14.09.2008";23;"75.3";2543;47346;44803
988;"14.09.2008";24;67;2359;43607;41248
989;"15.09.2008";1;"56.2";2144;41290;39146
989;"15.09.2008";2;"47.8";2011;39872;37861
989;"15.09.2008";3;45;1836;40272;38436
989;"15.09.2008";4;"45.6";1820;40596;38776
989;"15.09.2008";5;"48.2";1855;42220;40365
989;"15.09.2008";6;"57.3";1962;45832;43870
989;"15.09.2008";7;"72.2";2082;55685;53603
989;"15.09.2008";8;"99.7";2112;61580;59468
989;"15.09.2008";9;"119.3";1891;64372;62481
989;"15.09.2008";10;"122.6";1591;64966;63375
989;"15.09.2008";11;"136.7";1605;66373;64768
989;"15.09.2008";12;"163.2";2214;67792;65578
989;"15.09.2008";13;"125.1";2792;67203;64411
989;"15.09.2008";14;122;2976;66833;63857
989;"15.09.2008";15;125;3076;66005;62929
989;"15.09.2008";16;"120.4";3210;65019;61809
989;"15.09.2008";17;"107.5";2901;63725;60824
989;"15.09.2008";18;105;2579;63607;61028
989;"15.09.2008";19;"103.8";2413;63948;61535
989;"15.09.2008";20;113;2171;65099;62928
989;"15.09.2008";21;"110.4";2421;63834;61413
989;"15.09.2008";22;95;2533;59665;57132
989;"15.09.2008";23;"78.7";2527;55320;52793
989;"15.09.2008";24;65;2541;50440;47899
990;"16.09.2008";1;"68.1";2320;48253;45933
990;"16.09.2008";2;"62.9";2049;46466;44417
990;"16.09.2008";3;"58.1";1910;45903;43993
990;"16.09.2008";4;54;1642;46077;44435
990;"16.09.2008";5;"50.1";1465;47369;45904
990;"16.09.2008";6;"62.4";1392;51055;49663
990;"16.09.2008";7;"86.2";1407;58726;57319
990;"16.09.2008";8;"131.5";1332;63171;61839
990;"16.09.2008";9;"144.2";1064;65329;64265
990;"16.09.2008";10;153;922;65616;64694
990;"16.09.2008";11;160;965;66705;65740
990;"16.09.2008";12;"166.7";1050;67970;66920
990;"16.09.2008";13;145;1166;66804;65638
990;"16.09.2008";14;"133.7";1142;66345;65203
990;"16.09.2008";15;"126.4";1058;65754;64696
990;"16.09.2008";16;"120.2";1009;64733;63724
990;"16.09.2008";17;"111.6";792;63565;62773
990;"16.09.2008";18;"104.9";641;63722;63081
990;"16.09.2008";19;109;525;64183;63658
990;"16.09.2008";20;115;497;65676;65179
990;"16.09.2008";21;"120.1";604;64623;64019
990;"16.09.2008";22;"96.4";592;59953;59361
990;"16.09.2008";23;"80.1";556;55726;55170
990;"16.09.2008";24;"70.6";426;51950;51524
991;"17.09.2008";1;67;364;48687;48323
991;"17.09.2008";2;"62.2";333;47029;46696
991;"17.09.2008";3;"53.6";287;46308;46021
991;"17.09.2008";4;45;293;46691;46398
991;"17.09.2008";5;"45.5";309;48237;47928
991;"17.09.2008";6;"55.6";321;51830;51509
991;"17.09.2008";7;"67.9";319;59631;59312
991;"17.09.2008";8;100;286;64021;63735
991;"17.09.2008";9;110;247;66383;66136
991;"17.09.2008";10;115;180;66271;66091
991;"17.09.2008";11;115;236;66602;66366
991;"17.09.2008";12;"128.1";339;67544;67205
991;"17.09.2008";13;"114.3";387;66461;66075
991;"17.09.2008";14;120;468;65938;65470
991;"17.09.2008";15;"113.6";541;64954;64414
991;"17.09.2008";16;"110.6";563;63923;63360
991;"17.09.2008";17;"99.8";623;62675;62052
991;"17.09.2008";18;100;670;62765;62095
991;"17.09.2008";19;"94.6";683;63591;62908
991;"17.09.2008";20;"112.1";674;65311;64637
991;"17.09.2008";21;"109.6";881;64885;64005
991;"17.09.2008";22;"71.1";930;60682;59752
991;"17.09.2008";23;"66.1";988;56600;55613
991;"17.09.2008";24;"61.9";1002;52095;51093
992;"18.09.2008";1;"62.4";1072;48935;47863
992;"18.09.2008";2;"57.6";1043;47015;45972
992;"18.09.2008";3;"53.5";889;46591;45702
992;"18.09.2008";4;"51.5";697;47034;46337
992;"18.09.2008";5;"54.7";605;48564;47959
992;"18.09.2008";6;"70.3";595;52286;51691
992;"18.09.2008";7;"93.1";621;60252;59631
992;"18.09.2008";8;"115.4";613;64237;63624
992;"18.09.2008";9;120;597;65819;65222
992;"18.09.2008";10;"120.1";483;65594;65111
992;"18.09.2008";11;120;454;65883;65429
992;"18.09.2008";12;"123.8";580;66383;65803
992;"18.09.2008";13;"120.9";756;65242;64486
992;"18.09.2008";14;"127.7";717;64664;63947
992;"18.09.2008";15;130;751;63639;62888
992;"18.09.2008";16;"116.9";868;63208;62340
992;"18.09.2008";17;105;985;62284;61300
992;"18.09.2008";18;100;956;62684;61728
992;"18.09.2008";19;"104.9";893;63445;62552
992;"18.09.2008";20;"106.3";944;65503;64559
992;"18.09.2008";21;"110.1";1296;65116;63820
992;"18.09.2008";22;"97.9";1423;60911;59488
992;"18.09.2008";23;"86.5";1468;56834;55366
992;"18.09.2008";24;"68.2";1383;52336;50953
993;"19.09.2008";1;"73.2";1280;49370;48090
993;"19.09.2008";2;"64.7";1212;47341;46129
993;"19.09.2008";3;"61.5";1094;46478;45385
993;"19.09.2008";4;"56.8";958;47281;46323
993;"19.09.2008";5;58;860;48801;47941
993;"19.09.2008";6;"63.1";840;52470;51630
993;"19.09.2008";7;"85.1";796;59866;59070
993;"19.09.2008";8;"112.2";787;64010;63223
993;"19.09.2008";9;"139.1";619;65874;65255
993;"19.09.2008";10;"139.1";359;65579;65220
993;"19.09.2008";11;"138.2";259;65882;65623
993;"19.09.2008";12;"139.4";260;66309;66049
993;"19.09.2008";13;"123.4";285;65102;64817
993;"19.09.2008";14;"114.9";280;63388;63108
993;"19.09.2008";15;"109.6";284;61798;61514
993;"19.09.2008";16;"95.8";414;60747;60333
993;"19.09.2008";17;"89.6";592;60322;59730
993;"19.09.2008";18;"88.6";680;61025;60345
993;"19.09.2008";19;"88.5";704;61564;60861
993;"19.09.2008";20;"108.9";836;63207;62371
993;"19.09.2008";21;"99.8";1050;62175;61125
993;"19.09.2008";22;"81.9";1147;58081;56934
993;"19.09.2008";23;"74.3";1175;54587;53412
993;"19.09.2008";24;"67.6";1109;50283;49174
994;"20.09.2008";1;"73.6";973;47079;46106
994;"20.09.2008";2;"65.3";822;44654;43832
994;"20.09.2008";3;"62.1";760;43771;43011
994;"20.09.2008";4;"58.3";727;44315;43588
994;"20.09.2008";5;"57.9";722;44724;44002
994;"20.09.2008";6;"58.4";754;45124;44370
994;"20.09.2008";7;"60.1";781;45778;44997
994;"20.09.2008";8;"69.6";787;48229;47442
994;"20.09.2008";9;"72.9";723;51810;51087
994;"20.09.2008";10;"86.8";469;54072;53603
994;"20.09.2008";11;"88.4";471;55008;54537
994;"20.09.2008";12;"87.2";670;55625;54955
994;"20.09.2008";13;"86.5";867;54438;53571
994;"20.09.2008";14;"77.5";907;52292;51385
994;"20.09.2008";15;"72.2";1000;50496;49496
994;"20.09.2008";16;"68.1";1036;49641;48605
994;"20.09.2008";17;68;984;49500;48516
994;"20.09.2008";18;"68.3";839;50956;50117
994;"20.09.2008";19;"75.7";647;52437;51790
994;"20.09.2008";20;"82.8";693;54420;53727
994;"20.09.2008";21;"80.1";797;53484;52687
994;"20.09.2008";22;"68.2";856;50297;49441
994;"20.09.2008";23;"68.1";958;48619;47661
994;"20.09.2008";24;"63.1";1008;45130;44122
995;"21.09.2008";1;"63.6";1055;42302;41247
995;"21.09.2008";2;"55.1";1018;40191;39173
995;"21.09.2008";3;"53.1";1179;40251;39072
995;"21.09.2008";4;"44.8";1212;39716;38504
995;"21.09.2008";5;"46.7";1249;40122;38873
995;"21.09.2008";6;"46.7";1436;40136;38700
995;"21.09.2008";7;"40.9";1520;40214;38694
995;"21.09.2008";8;"56.2";1431;41400;39969
995;"21.09.2008";9;"58.2";1227;44132;42905
995;"21.09.2008";10;63;1020;46525;45505
995;"21.09.2008";11;"63.5";1110;48477;47367
995;"21.09.2008";12;"72.9";1035;50318;49283
995;"21.09.2008";13;"67.9";1140;49067;47927
995;"21.09.2008";14;"63.3";1339;47109;45770
995;"21.09.2008";15;"61.4";1350;45761;44411
995;"21.09.2008";16;60;1800;44970;43170
995;"21.09.2008";17;"58.5";2050;45000;42950
995;"21.09.2008";18;"62.1";2105;47155;45050
995;"21.09.2008";19;"68.1";2321;49754;47433
995;"21.09.2008";20;"79.9";2194;52575;50381
995;"21.09.2008";21;"80.6";2165;52714;50549
995;"21.09.2008";22;72;2084;50615;48531
995;"21.09.2008";23;"68.2";2093;49591;47498
995;"21.09.2008";24;"61.1";2120;46189;44069
996;"22.09.2008";1;"55.7";1963;43858;41895
996;"22.09.2008";2;"51.5";1747;42997;41250
996;"22.09.2008";3;"44.3";1714;42690;40976
996;"22.09.2008";4;"40.2";1672;42886;41214
996;"22.09.2008";5;"46.6";1563;45014;43451
996;"22.09.2008";6;59;1550;48827;47277
996;"22.09.2008";7;79;1525;58226;56701
996;"22.09.2008";8;105;1535;64233;62698
996;"22.09.2008";9;121;1328;66721;65393
996;"22.09.2008";10;"125.1";1095;67032;65937
996;"22.09.2008";11;"134.2";1030;67960;66930
996;"22.09.2008";12;144;1256;69169;67913
996;"22.09.2008";13;"125.1";1292;68350;67058
996;"22.09.2008";14;"121.1";1214;67402;66188
996;"22.09.2008";15;"117.6";1199;66735;65536
996;"22.09.2008";16;"111.1";1399;65399;64000
996;"22.09.2008";17;"104.9";1545;64243;62698
996;"22.09.2008";18;"102.9";1466;63951;62485
996;"22.09.2008";19;104;1442;64681;63239
996;"22.09.2008";20;"112.2";1492;66796;65304
996;"22.09.2008";21;105;1568;64818;63250
996;"22.09.2008";22;90;1504;60701;59197
996;"22.09.2008";23;"75.5";1436;56681;55245
996;"22.09.2008";24;"67.8";1410;52639;51229
997;"23.09.2008";1;"68.3";1326;49585;48259
997;"23.09.2008";2;"62.7";1325;47682;46357
997;"23.09.2008";3;"58.3";1354;46852;45498
997;"23.09.2008";4;"57.8";1313;47316;46003
997;"23.09.2008";5;59;1414;48854;47440
997;"23.09.2008";6;"70.1";1553;52476;50923
997;"23.09.2008";7;"94.5";1662;60431;58769
997;"23.09.2008";8;"117.1";1704;65725;64021
997;"23.09.2008";9;"125.1";1770;67989;66219
997;"23.09.2008";10;"135.6";1879;68628;66749
997;"23.09.2008";11;"130.1";2085;69467;67382
997;"23.09.2008";12;"131.9";2264;69928;67664
997;"23.09.2008";13;"118.6";2401;69245;66844
997;"23.09.2008";14;"115.4";2310;68453;66143
997;"23.09.2008";15;"117.9";2531;67261;64730
997;"23.09.2008";16;"111.1";2568;66484;63916
997;"23.09.2008";17;"109.8";2772;65561;62789
997;"23.09.2008";18;"107.7";2797;65852;63055
997;"23.09.2008";19;"104.9";2658;66906;64248
997;"23.09.2008";20;"120.4";2744;68569;65825
997;"23.09.2008";21;120;2712;65780;63068
997;"23.09.2008";22;"103.4";2878;61750;58872
997;"23.09.2008";23;"94.8";2948;57642;54695
997;"23.09.2008";24;"75.8";2760;52645;49885
998;"24.09.2008";1;"70.1";2513;49590;47077
998;"24.09.2008";2;"65.5";2100;47668;45568
998;"24.09.2008";3;"62.1";1767;46847;45080
998;"24.09.2008";4;57;1435;47411;45976
998;"24.09.2008";5;"57.2";1361;48997;47636
998;"24.09.2008";6;"67.4";1403;52622;51219
998;"24.09.2008";7;"93.6";1467;60196;58729
998;"24.09.2008";8;"135.7";1706;65113;63407
998;"24.09.2008";9;"157.9";1783;66975;65192
998;"24.09.2008";10;"154.9";1822;66834;65012
998;"24.09.2008";11;157;2238;67507;65269
998;"24.09.2008";12;"156.2";2580;68533;65953
998;"24.09.2008";13;"144.1";2972;67606;64634
998;"24.09.2008";14;"125.1";3165;66879;63714
998;"24.09.2008";15;"135.7";3227;65971;62744
998;"24.09.2008";16;120;3352;65420;62068
998;"24.09.2008";17;"109.6";3285;64337;61052
998;"24.09.2008";18;105;2957;64279;61322
998;"24.09.2008";19;"111.9";2750;65181;62431
998;"24.09.2008";20;"138.5";3142;67270;64128
998;"24.09.2008";21;"124.3";3804;65257;61453
998;"24.09.2008";22;101;4066;61288;57222
998;"24.09.2008";23;90;4075;57301;53226
998;"24.09.2008";24;"74.6";3786;52462;48676
999;"25.09.2008";1;"70.2";3314;49506;46192
999;"25.09.2008";2;"66.6";2948;47254;44306
999;"25.09.2008";3;60;2750;46313;43563
999;"25.09.2008";4;"59.1";2686;46960;44274
999;"25.09.2008";5;"59.7";2638;48719;46081
999;"25.09.2008";6;"70.2";2657;52329;49672
999;"25.09.2008";7;"88.8";2895;60259;57365
999;"25.09.2008";8;125;2752;65296;62544
999;"25.09.2008";9;"120.1";2346;67254;64908
999;"25.09.2008";10;"123.5";1858;67528;65670
999;"25.09.2008";11;"123.5";2069;68260;66191
999;"25.09.2008";12;"126.5";2854;69326;66472
999;"25.09.2008";13;"118.1";3557;68415;64858
999;"25.09.2008";14;"115.7";3939;67969;64030
999;"25.09.2008";15;"114.8";4009;66725;62716
999;"25.09.2008";16;"108.4";3821;65689;61868
999;"25.09.2008";17;"104.9";3597;64328;60731
999;"25.09.2008";18;"100.8";3032;64215;61184
999;"25.09.2008";19;"102.3";2363;64932;62569
999;"25.09.2008";20;"115.4";2351;67265;64914
999;"25.09.2008";21;117;2788;65121;62333
999;"25.09.2008";22;"99.6";3172;61181;58009
999;"25.09.2008";23;"85.2";3199;57288;54089
999;"25.09.2008";24;"73.1";2930;52509;49579
1000;"26.09.2008";1;"67.2";2620;49783;47163
1000;"26.09.2008";2;61;2245;47696;45451
1000;"26.09.2008";3;"54.4";1768;46712;44944
1000;"26.09.2008";4;"51.3";1417;47359;45942
1000;"26.09.2008";5;"54.2";1198;49108;47910
1000;"26.09.2008";6;68;1109;52757;51648
1000;"26.09.2008";7;86;946;60112;59166
1000;"26.09.2008";8;125;827;64519;63692
1000;"26.09.2008";9;"118.2";733;66228;65495
1000;"26.09.2008";10;"122.9";542;65878;65336
1000;"26.09.2008";11;"125.1";487;66048;65561
1000;"26.09.2008";12;"121.9";659;66354;65695
1000;"26.09.2008";13;"116.1";841;65321;64480
1000;"26.09.2008";14;"114.1";871;63818;62947
1000;"26.09.2008";15;"106.4";906;62433;61527
1000;"26.09.2008";16;"102.9";867;61451;60584
1000;"26.09.2008";17;"95.2";853;60594;59741
1000;"26.09.2008";18;"93.3";834;60856;60022
1000;"26.09.2008";19;"96.9";767;61697;60930
1000;"26.09.2008";20;"114.6";900;64299;63399
1000;"26.09.2008";21;"118.4";1173;62048;60875
1000;"26.09.2008";22;"94.2";1075;58246;57171
1000;"26.09.2008";23;"86.5";1008;55123;54115
1000;"26.09.2008";24;"74.9";912;50859;49948
1001;"27.09.2008";1;"70.1";853;47154;46301
1001;"27.09.2008";2;"71.1";841;45226;44385
1001;"27.09.2008";3;"67.8";753;43959;43206
1001;"27.09.2008";4;"69.5";653;44779;44126
1001;"27.09.2008";5;"69.9";546;45357;44811
1001;"27.09.2008";6;"69.9";449;45209;44760
1001;"27.09.2008";7;70;483;46459;45976
1001;"27.09.2008";8;"80.7";441;48893;48452
1001;"27.09.2008";9;"91.1";464;51821;51357
1001;"27.09.2008";10;96;371;53745;53374
1001;"27.09.2008";11;"97.4";307;54411;54104
1001;"27.09.2008";12;"100.5";324;54728;54404
1001;"27.09.2008";13;"96.8";413;53206;52793
1001;"27.09.2008";14;"91.4";496;50838;50342
1001;"27.09.2008";15;"77.3";555;49312;48757
1001;"27.09.2008";16;"73.2";540;48683;48143
1001;"27.09.2008";17;"72.3";537;48495;47958
1001;"27.09.2008";18;"76.1";555;50165;49610
1001;"27.09.2008";19;"89.5";635;52231;51596
1001;"27.09.2008";20;"106.3";864;55406;54542
1001;"27.09.2008";21;"105.3";1174;54100;52926
1001;"27.09.2008";22;"86.1";1761;51103;49342
1001;"27.09.2008";23;"87.3";2082;49802;47720
1001;"27.09.2008";24;"72.1";2345;46103;43758
1002;"28.09.2008";1;"68.6";2712;42902;40190
1002;"28.09.2008";2;"62.1";3089;40970;37881
1002;"28.09.2008";3;"55.5";3194;39841;36647
1002;"28.09.2008";4;"46.7";3507;40310;36803
1002;"28.09.2008";5;"50.6";3661;41073;37412
1002;"28.09.2008";6;"52.1";3347;41341;37994
1002;"28.09.2008";7;"41.8";3170;40750;37580
1002;"28.09.2008";8;"53.8";3081;41759;38678
1002;"28.09.2008";9;"66.8";2762;44210;41448
1002;"28.09.2008";10;71;1927;46168;44241
1002;"28.09.2008";11;"76.3";1141;47531;46390
1002;"28.09.2008";12;"85.1";1105;49291;48186
1002;"28.09.2008";13;"79.1";1332;47853;46521
1002;"28.09.2008";14;"69.8";1408;45536;44128
1002;"28.09.2008";15;"64.6";1572;43803;42231
1002;"28.09.2008";16;"62.1";1607;43354;41747
1002;"28.09.2008";17;"61.2";1507;43702;42195
1002;"28.09.2008";18;"65.6";1194;45928;44734
1002;"28.09.2008";19;"74.1";872;49453;48581
1002;"28.09.2008";20;89;916;53268;52352
1002;"28.09.2008";21;97;1104;52730;51626
1002;"28.09.2008";22;"85.2";1150;50602;49452
1002;"28.09.2008";23;81;1329;50062;48733
1002;"28.09.2008";24;"71.4";1540;46798;45258
1003;"29.09.2008";1;"67.7";1616;44344;42728
1003;"29.09.2008";2;"62.3";1732;43113;41381
1003;"29.09.2008";3;"53.7";1907;42499;40592
1003;"29.09.2008";4;"52.2";1897;43243;41346
1003;"29.09.2008";5;"54.8";1793;45275;43482
1003;"29.09.2008";6;"67.9";1660;48972;47312
1003;"29.09.2008";7;"85.6";1499;57737;56238
1003;"29.09.2008";8;"121.6";1412;62962;61550
1003;"29.09.2008";9;136;1392;65030;63638
1003;"29.09.2008";10;"130.1";1119;65427;64308
1003;"29.09.2008";11;"134.8";1117;66330;65213
1003;"29.09.2008";12;"140.1";1402;67258;65856
1003;"29.09.2008";13;"125.1";1592;66572;64980
1003;"29.09.2008";14;"125.1";1822;66081;64259
1003;"29.09.2008";15;121;1836;65213;63377
1003;"29.09.2008";16;"114.1";1898;64584;62687
1003;"29.09.2008";17;"113.8";1731;63462;61732
1003;"29.09.2008";18;"113.5";1533;63735;62202
1003;"29.09.2008";19;"118.9";1568;64831;63263
1003;"29.09.2008";20;"133.3";1928;67304;65376
1003;"29.09.2008";21;115;2273;64178;61905
1003;"29.09.2008";22;"98.8";2765;60256;57491
1003;"29.09.2008";23;"84.8";3501;56750;53249
1003;"29.09.2008";24;"69.9";3975;52481;48506
1004;"30.09.2008";1;"69.1";4235;49087;44852
1004;"30.09.2008";2;"63.9";4421;46707;42286
1004;"30.09.2008";3;"62.4";5166;46039;40873
1004;"30.09.2008";4;"57.6";6192;46674;40482
1004;"30.09.2008";5;"55.2";6539;48266;41727
1004;"30.09.2008";6;"64.4";7126;52305;45179
1004;"30.09.2008";7;"82.8";8001;59869;51868
1004;"30.09.2008";8;110;8740;65205;56465
1004;"30.09.2008";9;"116.7";9488;67378;57891
1004;"30.09.2008";10;"105.1";10094;68109;58016
1004;"30.09.2008";11;105;10389;69262;58873
1004;"30.09.2008";12;"114.1";10694;70553;59859
1004;"30.09.2008";13;"109.5";11032;69971;58939
1004;"30.09.2008";14;"114.8";11209;69681;58472
1004;"30.09.2008";15;115;11173;68781;57608
1004;"30.09.2008";16;"109.8";10568;67901;57333
1004;"30.09.2008";17;"99.5";9950;66298;56348
1004;"30.09.2008";18;92;9600;66067;56467
1004;"30.09.2008";19;"95.5";9649;67463;57814
1004;"30.09.2008";20;"120.1";10112;69255;59143
1004;"30.09.2008";21;116;10955;65769;54814
1004;"30.09.2008";22;"83.9";12029;62320;50291
1004;"30.09.2008";23;70;13079;59758;46679
1004;"30.09.2008";24;"65.5";13926;55581;41655
